Hour,Arrivals,Waiting,Treating,Available Rooms,Total Treatment Time,Average Treatment Time,Total Wait Time,Average Wait Time,Total Arrivals
1,4,0,2,23,4080,2040,0,0,4
2,5,0,2,23,15120,2160,0,0,9
3,9,0,8,17,25020,2502,0,0,18
4,13,0,14,11,52140,3067,0,0,31
5,3,0,6,19,92880,3317,0,0,34
6,3,0,4,21,116580,3532,0,0,37
7,11,0,10,15,146160,3846,0,0,48
8,10,0,11,14,165900,3529,0,0,58
9,7,0,8,17,210660,3695,0,0,65
10,10,0,9,16,241020,3651,0,0,75
11,14,0,16,9,252780,3462,0,0,89
12,9,0,11,14,312300,3589,0,0,98
13,11,0,12,13,363480,3747,0,0,109
14,13,0,13,12,395220,3625,0,0,122
15,14,0,16,9,446400,3720,1380,10,136
16,5,0,11,14,495240,3809,1380,9,141
17,6,0,7,18,549840,3927,1380,9,147
18,14,0,11,14,588660,3924,1380,8,161
19,8,0,8,17,621060,3857,1380,8,169
20,8,0,9,16,646680,3849,1380,7,177
21,6,0,8,17,667140,3812,1380,7,183
22,5,0,5,20,700920,3830,1380,7,188
23,5,0,4,21,723960,3830,1380,7,193
24,2,0,3,22,734580,3825,1380,7,195
25,8,0,8,17,746880,3830,1380,6,203
26,1,0,4,21,771720,3858,1380,6,204
27,7,0,5,20,792120,3845,1380,6,211
28,2,0,2,23,807240,3825,1380,6,213
29,10,0,9,16,822120,3841,1380,6,223
30,4,0,8,17,836160,3818,1380,6,227
31,8,0,7,18,875160,3838,1380,5,235
32,8,0,9,16,891960,3811,1380,5,243
33,6,0,7,18,917280,3790,1380,5,249
34,5,0,6,19,946320,3815,1380,5,254
35,13,0,13,12,968640,3813,1380,5,267
36,12,0,16,9,995880,3786,1380,4,279
37,10,0,9,16,1060020,3785,1380,4,289
38,13,0,12,13,1100760,3795,1380,4,302
39,5,0,10,15,1131900,3811,1380,4,307
40,10,0,10,15,1175760,3829,1380,4,317
41,10,0,12,13,1210980,3844,1380,4,327
42,5,0,7,18,1243020,3824,1380,4,332
43,9,0,11,14,1260540,3819,1380,4,341
44,14,0,13,12,1287000,3763,1380,3,355
45,6,0,10,15,1332660,3796,1380,3,361
46,5,0,10,15,1362060,3826,1380,3,366
47,10,0,11,14,1397400,3828,1380,3,376
48,6,0,6,19,1445520,3844,1380,3,382
49,7,0,9,16,1467120,3860,1380,3,389
50,6,0,9,16,1490460,3861,1380,3,395
51,8,0,8,17,1533060,3881,1380,3,403
52,10,0,8,17,1554960,3839,1380,3,413
53,9,0,6,19,1590720,3823,1380,3,422
54,7,0,10,15,1598280,3814,1380,3,429
55,5,0,8,17,1641060,3852,1380,3,434
56,10,0,10,15,1666800,3840,1380,3,444
57,6,0,9,16,1701780,3858,1380,3,450
58,6,0,7,18,1733700,3861,1380,3,456
59,8,0,7,18,1756380,3843,1380,2,464
60,9,0,5,20,1785720,3815,1380,2,473
61,4,0,6,19,1798680,3818,1380,2,477
62,5,0,6,19,1814100,3811,1380,2,482
63,9,0,11,14,1824420,3800,1380,2,491
64,10,0,9,16,1869600,3800,1380,2,501
65,11,0,14,11,1890240,3795,1380,2,512
66,4,0,3,22,1947300,3795,1380,2,516
67,6,0,6,19,1962780,3803,1380,2,522
68,8,0,9,16,1973640,3788,1380,2,530
69,8,0,10,15,1986300,3761,1380,2,538
70,7,0,10,15,2018340,3772,1380,2,545
71,7,0,6,19,2077380,3804,1380,2,552
72,8,0,6,19,2099340,3789,1380,2,560
73,3,0,5,20,2114820,3790,1380,2,563
74,5,0,4,21,2140260,3794,1380,2,568
75,5,0,4,21,2162100,3799,1380,2,573
76,4,0,3,22,2183520,3804,1380,2,577
77,3,0,5,20,2184720,3799,1380,2,580
78,10,0,7,18,2210280,3791,1380,2,590
79,19,0,14,11,2225160,3739,1380,2,609
80,6,0,8,17,2256660,3717,1380,2,615
81,5,0,3,22,2303040,3732,1380,2,620
82,8,0,8,17,2310000,3725,1380,2,628
83,9,0,8,17,2334000,3710,1380,2,637
84,15,0,18,7,2344440,3697,1380,2,652
85,9,0,11,14,2411460,3709,1380,2,661
86,12,0,10,15,2461920,3713,1380,2,673
87,10,0,9,16,2497140,3704,1380,2,683
88,13,0,12,13,2529960,3698,1380,1,696
89,10,0,10,15,2570700,3693,1380,1,706
90,14,0,15,10,2600100,3688,1380,1,720
91,6,0,6,19,2665020,3701,1380,1,726
92,6,0,7,18,2685420,3704,1380,1,732
93,5,0,9,16,2699040,3707,1380,1,737
94,7,0,7,18,2737620,3714,1380,1,744
95,7,0,7,18,2774520,3729,1380,1,751
96,4,0,6,19,2790240,3725,1380,1,755
97,6,0,5,20,2823300,3734,1380,1,761
98,3,0,2,23,2845260,3733,1380,1,764
99,5,0,5,20,2851920,3732,1380,1,769
100,4,0,6,19,2866140,3736,1380,1,773
101,2,0,4,21,2885520,3742,1380,1,775
102,9,0,8,17,2904600,3743,1380,1,784
103,3,0,7,18,2916420,3739,1380,1,787
104,8,0,7,18,2951460,3745,1380,1,795
105,11,0,7,18,2984820,3735,1380,1,806
106,13,0,11,14,3006360,3720,1380,1,819
107,5,0,5,20,3046080,3719,1380,1,824
108,11,0,9,16,3068280,3714,1380,1,835
109,15,0,17,8,3088560,3707,1380,1,850
110,10,0,11,14,3141420,3700,1380,1,860
111,9,0,6,19,3185460,3691,1380,1,869
112,10,0,7,18,3210720,3682,1380,1,879
113,9,0,11,14,3231480,3684,1380,1,888
114,8,0,9,16,3270180,3686,1380,1,896
115,5,0,5,20,3301380,3684,1380,1,901
116,4,0,5,20,3318900,3687,1380,1,905
117,4,0,7,18,3320820,3681,1380,1,909
118,3,0,4,21,3341280,3679,1380,1,912
119,4,0,3,22,3378300,3700,1380,1,916
120,7,0,3,22,3389280,3684,1380,1,923
121,6,0,8,17,3395580,3686,1380,1,929
122,4,0,5,20,3416220,3681,1380,1,933
123,4,0,5,20,3422460,3672,1380,1,937
124,5,0,4,21,3446520,3674,1380,1,942
125,5,0,3,22,3462420,3667,1380,1,947
126,9,0,8,17,3477480,3668,1380,1,956
127,12,0,10,15,3501360,3654,1380,1,968
128,11,0,12,13,3527100,3647,1380,1,979
129,12,0,14,11,3583920,3668,1380,1,991
130,9,0,14,11,3621240,3672,1380,1,1000
131,6,0,6,19,3679440,3679,1380,1,1006
132,10,0,7,18,3708240,3675,1380,1,1016
133,8,0,7,18,3728280,3665,1380,1,1024
134,14,0,11,14,3748620,3650,1380,1,1038
135,11,0,10,15,3787620,3645,1380,1,1049
136,5,0,7,18,3822720,3651,1380,1,1054
137,10,0,8,17,3855300,3650,1380,1,1064
138,8,0,4,21,3892560,3644,1380,1,1072
139,8,0,5,20,3909120,3636,1380,1,1080
140,9,0,9,16,3918960,3628,1380,1,1089
141,5,0,6,19,3945540,3626,1380,1,1094
142,11,0,6,19,3985080,3626,1380,1,1105
143,5,0,7,18,3999000,3625,1380,1,1110
144,4,0,9,16,4005300,3624,1380,1,1114
145,1,0,2,23,4052520,3641,1380,1,1115
146,7,0,6,19,4057020,3635,1380,1,1122
147,6,0,5,20,4095120,3646,1380,1,1128
148,8,0,5,20,4124460,3646,1380,1,1136
149,7,0,5,20,4135320,3633,1380,1,1143
150,10,0,8,17,4151880,3626,1380,1,1153
151,8,0,8,17,4170840,3617,1380,1,1161
152,7,0,5,20,4214280,3623,1380,1,1168
153,8,0,3,22,4241940,3616,1380,1,1176
154,5,0,5,20,4246500,3610,1380,1,1181
155,13,0,12,13,4257660,3602,1380,1,1194
156,9,0,13,12,4290060,3605,1380,1,1203
157,8,0,11,14,4344720,3620,1380,1,1211
158,9,0,10,15,4373520,3614,1380,1,1220
159,13,0,15,10,4405260,3616,1380,1,1233
160,10,0,13,12,4458540,3624,1380,1,1243
161,8,0,7,18,4519380,3632,1380,1,1251
162,10,0,7,18,4553520,3631,1380,1,1261
163,4,0,5,20,4582860,3637,1380,1,1265
164,7,0,10,15,4586340,3634,1380,1,1272
165,8,0,5,20,4613880,3618,1380,1,1280
166,3,0,4,21,4641360,3628,1380,1,1283
167,6,0,5,20,4664760,3632,1380,1,1289
168,4,0,5,20,4680240,3633,1380,1,1293
169,10,0,10,15,4690740,3627,1380,1,1303
170,7,0,6,19,4733340,3629,1380,1,1310
171,7,0,7,18,4749300,3625,1380,1,1317
172,4,0,4,21,4773600,3624,1380,1,1321
173,4,0,5,20,4784880,3624,1380,1,1325
174,7,0,5,20,4811280,3625,1380,1,1332
175,9,0,11,14,4817940,3622,1380,1,1341
176,14,0,14,11,4856280,3621,1380,1,1355
177,11,0,10,15,4898700,3612,1380,1,1366
178,8,0,11,14,4932900,3619,1380,1,1374
179,14,0,15,10,4983120,3629,1380,0,1388
180,10,0,16,9,5009220,3624,1380,0,1398
181,4,0,6,19,5087580,3644,1380,0,1402
182,11,0,10,15,5112780,3644,1380,0,1413
183,5,0,6,19,5139240,3639,1380,0,1418
184,13,0,9,16,5174400,3638,1380,0,1431
185,4,0,5,20,5200500,3636,1380,0,1435
186,10,0,9,16,5222880,3637,1380,0,1445
187,7,0,10,15,5248680,3639,1380,0,1452
188,7,0,5,20,5296020,3642,1380,0,1459
189,3,0,3,22,5326140,3650,1380,0,1462
190,10,0,5,20,5342340,3641,1380,0,1472
191,7,0,6,19,5355540,3635,1380,0,1479
192,5,0,7,18,5369100,3635,1380,0,1484
193,4,0,3,22,5402280,3637,1380,0,1488
194,4,0,4,21,5407020,3633,1380,0,1492
195,3,0,2,23,5421060,3630,1380,0,1495
196,5,0,3,22,5434080,3629,1380,0,1500
197,2,0,3,22,5442780,3630,1380,0,1502
198,8,0,8,17,5447760,3627,1380,0,1510
199,9,0,12,13,5459880,3623,1380,0,1519
200,9,0,8,17,5525160,3634,1380,0,1528
201,9,0,10,15,5547720,3633,1380,0,1537
202,19,0,11,14,5598120,3623,1380,0,1556
203,11,0,13,12,5636340,3626,1380,0,1567
204,8,0,10,15,5685180,3632,1380,0,1575
205,13,0,9,16,5745600,3638,1380,0,1588
206,16,0,13,12,5770800,3627,1380,0,1604
207,13,0,13,12,5818260,3627,1380,0,1617
208,10,0,10,15,5882700,3638,1380,0,1627
209,9,0,7,18,5918640,3633,1380,0,1636
210,4,0,5,20,5935440,3630,1380,0,1640
211,7,0,7,18,5953920,3630,1380,0,1647
212,5,0,3,22,5984640,3629,1380,0,1652
213,7,0,6,19,6001740,3630,1380,0,1659
214,6,0,6,19,6015540,3626,1380,0,1665
215,5,0,8,17,6020340,3622,1380,0,1670
216,9,0,7,18,6056880,3622,1380,0,1679
217,4,0,5,20,6075900,3620,1380,0,1683
218,4,0,6,19,6092280,3624,1380,0,1687
219,13,0,7,18,6131640,3621,1380,0,1700
220,3,0,3,22,6152700,3619,1380,0,1703
221,12,0,9,16,6173640,3618,1380,0,1715
222,5,0,8,17,6196680,3619,1380,0,1720
223,9,0,7,18,6237120,3622,1380,0,1729
224,4,0,4,21,6253680,3616,1380,0,1733
225,15,0,10,15,6280020,3613,1380,0,1748
226,10,0,11,14,6315480,3615,1380,0,1758
227,13,0,12,13,6348720,3609,1380,0,1771
228,11,0,9,16,6401580,3610,1380,0,1782
229,8,0,8,17,6443160,3615,1380,0,1790
230,12,0,8,17,6464160,3603,1380,0,1802
231,13,0,12,13,6497820,3603,1380,0,1815
232,17,2,20,5,6520860,3602,1440,0,1832
233,8,0,17,8,6578040,3608,15060,8,1840
234,10,0,9,16,6675480,3626,15060,8,1850
235,6,0,6,19,6702300,3622,15060,8,1856
236,4,0,4,21,6719940,3620,15060,8,1860
237,7,0,7,18,6736200,3621,15060,8,1867
238,4,0,5,20,6761520,3623,15060,8,1871
239,3,0,4,21,6777180,3624,15060,8,1874
240,3,0,1,24,6799740,3624,15060,8,1877
241,3,0,3,22,6802860,3624,15060,8,1880
242,4,0,4,21,6813480,3624,15060,7,1884
243,5,0,6,19,6818640,3621,15060,7,1889
244,5,0,5,20,6837120,3619,15060,7,1894
245,10,0,9,16,6862860,3621,15060,7,1904
246,5,0,9,16,6879300,3620,15060,7,1909
247,10,0,11,14,6914640,3624,15060,7,1919
248,6,0,6,19,6956340,3624,15060,7,1925
249,8,0,7,18,6984840,3626,15060,7,1933
250,5,0,4,21,7006680,3622,15060,7,1938
251,14,0,8,17,7033740,3618,15060,7,1952
252,10,0,8,17,7065840,3616,15060,7,1962
253,9,0,12,13,7074060,3611,15060,7,1971
254,12,0,13,12,7102080,3605,15060,7,1983
255,14,0,16,9,7156260,3612,15060,7,1997
256,14,0,16,9,7221240,3619,15060,7,2011
257,13,0,14,11,7269840,3616,15060,7,2024
258,13,0,16,9,7312860,3618,15060,7,2037
259,13,0,16,9,7365480,3621,15060,7,2050
260,5,0,11,14,7414200,3627,15060,7,2055
261,4,0,9,16,7460640,3639,15060,7,2059
262,2,0,3,22,7499040,3643,15060,7,2061
263,7,0,6,19,7509720,3641,15060,7,2068
264,6,0,3,22,7537980,3639,15060,7,2074
265,7,0,5,20,7550940,3637,15060,7,2081
266,9,0,10,15,7566780,3637,15060,7,2090
267,7,0,9,16,7598700,3639,15060,7,2097
268,10,0,5,20,7646100,3637,15060,7,2107
269,10,0,7,18,7673940,3636,15060,7,2117
270,5,0,4,21,7695120,3633,15060,7,2122
271,12,0,6,19,7715880,3625,15060,7,2134
272,4,0,6,19,7733520,3627,15060,7,2138
273,7,0,7,18,7755060,3627,15060,7,2145
274,7,0,11,14,7763940,3626,15060,6,2152
275,17,0,16,9,7812780,3628,15060,6,2169
276,13,0,17,8,7852020,3626,15060,6,2182
277,5,0,8,17,7915200,3632,15060,6,2187
278,11,0,8,17,7961580,3635,15060,6,2198
279,10,0,9,16,7990920,3633,15060,6,2208
280,15,0,15,10,8021700,3633,15060,6,2223
281,8,0,9,16,8071260,3632,15060,6,2231
282,6,0,8,17,8105580,3636,15060,6,2237
283,9,0,10,15,8138220,3639,15060,6,2246
284,8,0,10,15,8153460,3633,15060,6,2254
285,4,0,3,22,8210760,3641,15060,6,2258
286,2,0,3,22,8224200,3643,15060,6,2260
287,8,0,7,18,8233800,3641,15060,6,2268
288,4,0,3,22,8258820,3639,15060,6,2272
289,7,0,6,19,8273220,3639,15060,6,2279
290,10,0,11,14,8291160,3639,15060,6,2289
291,1,0,7,18,8307420,3638,15060,6,2290
292,7,0,6,19,8352960,3645,15060,6,2297
293,7,0,8,17,8372400,3646,15060,6,2304
294,7,0,9,16,8392320,3645,15060,6,2311
295,9,0,8,17,8428920,3645,15060,6,2320
296,6,0,12,13,8432760,3644,15060,6,2326
297,13,0,11,14,8496480,3649,15060,6,2339
298,15,0,10,15,8528520,3638,15060,6,2354
299,13,0,11,14,8573880,3639,15060,6,2367
300,4,0,6,19,8625780,3647,15060,6,2371
301,7,0,6,19,8643600,3644,15060,6,2378
302,11,0,8,17,8673840,3642,15060,6,2389
303,10,0,11,14,8688300,3638,15060,6,2399
304,10,0,12,13,8722380,3638,15060,6,2409
305,10,0,9,16,8765460,3637,15060,6,2419
306,6,0,7,18,8791080,3635,15060,6,2425
307,4,0,6,19,8814840,3637,15060,6,2429
308,6,0,6,19,8838480,3638,15060,6,2435
309,7,0,7,18,8861100,3639,15060,6,2442
310,5,0,2,23,8886480,3634,15060,6,2447
311,4,0,4,21,8892060,3633,15060,6,2451
312,5,0,6,19,8904120,3634,15060,6,2456
313,9,0,5,20,8923500,3627,15060,6,2465
314,6,0,4,21,8950320,3628,15060,6,2471
315,2,0,5,20,8957580,3629,15060,6,2473
316,6,0,6,19,8984700,3633,15060,6,2479
317,8,0,10,15,8992020,3630,15060,6,2487
318,13,0,14,11,9015720,3626,15060,6,2500
319,7,0,11,14,9065400,3631,15060,6,2507
320,12,0,12,13,9102600,3630,15060,5,2519
321,13,0,9,16,9162720,3631,15060,5,2532
322,9,0,10,15,9182940,3628,15060,5,2541
323,12,0,11,14,9202800,3620,15060,5,2553
324,6,0,7,18,9245280,3622,15060,5,2559
325,9,0,8,17,9273060,3622,15060,5,2568
326,8,0,6,19,9308040,3621,15060,5,2576
327,6,0,9,16,9323280,3623,15060,5,2582
328,8,0,9,16,9355320,3624,15060,5,2590
329,9,0,7,18,9397440,3625,15060,5,2599
330,9,0,10,15,9421080,3626,15060,5,2608
331,13,0,16,9,9443100,3624,15060,5,2621
332,5,0,7,18,9504000,3628,15060,5,2626
333,9,0,10,15,9535200,3632,15060,5,2635
334,10,0,12,13,9554640,3628,15060,5,2645
335,6,0,3,22,9607620,3628,15060,5,2651
336,5,0,3,22,9627120,3628,15060,5,2656
337,8,0,6,19,9641880,3627,15060,5,2664
338,10,0,10,15,9658200,3625,15060,5,2674
339,19,0,21,4,9675600,3621,15060,5,2693
340,31,17,19,6,9723300,3617,17640,6,2724
341,22,26,17,8,9823980,3634,43800,15,2746
342,34,39,21,4,9872100,3638,60780,21,2780
343,36,40,15,10,9943020,3646,76680,27,2816
344,32,38,25,0,10012380,3651,213300,76,2848
345,31,40,25,0,10102260,3653,248700,87,2879
346,34,38,25,0,10197120,3654,305940,107,2913
347,30,35,25,0,10296000,3652,353940,123,2943
348,37,40,25,0,10361100,3653,368880,127,2980
349,35,36,25,0,10449540,3657,467220,160,3015
350,43,40,25,0,10548900,3660,500880,170,3058
351,33,32,25,0,10625700,3652,631140,212,3091
352,34,30,25,0,10724520,3641,835140,278,3125
353,33,35,25,0,10809240,3635,922860,304,3158
354,32,38,25,0,10895520,3635,988860,323,3190
355,31,32,25,0,11004720,3627,1078500,349,3221
356,31,27,25,0,11080080,3609,1486860,476,3252
357,37,40,25,0,11153400,3613,1494480,474,3289
358,28,37,25,0,11260440,3619,1543920,486,3317
359,32,30,25,0,11359020,3614,1857600,581,3349
360,34,40,14,11,11440140,3610,1890540,587,3383
361,26,40,25,0,11489280,3616,1918860,592,3409
362,28,33,25,0,11589960,3615,2150580,659,3437
363,33,40,19,6,11661960,3612,2162220,659,3470
364,21,38,25,0,11742360,3623,2189940,663,3491
365,36,39,25,0,11829000,3631,2222880,669,3527
366,33,40,25,0,11908680,3631,2304840,689,3560
367,28,28,25,0,12030420,3626,2628780,780,3588
368,38,40,14,11,12102600,3624,2686800,792,3626
369,38,38,16,9,12146520,3630,2707740,796,3664
370,30,40,25,0,12215340,3636,2746800,802,3694
371,28,32,25,0,12319260,3631,2906820,843,3722
372,33,35,25,0,12411120,3631,2955720,849,3755
373,33,40,25,0,12478920,3630,2974920,849,3788
374,29,31,25,0,12570360,3623,3199500,907,3817
375,30,28,25,0,12690240,3623,3421500,962,3847
376,22,24,25,0,12770940,3619,3958020,1107,3869
377,26,19,25,0,12865140,3614,4308360,1196,3895
378,32,31,25,0,12937920,3614,4477320,1232,3927
379,30,39,25,0,13022460,3622,4487400,1226,3957
380,24,40,25,0,13097520,3630,4511400,1228,3981
381,30,38,24,1,13224600,3642,4560540,1234,4011
382,27,35,25,0,13297440,3640,4622160,1244,4038
383,32,35,25,0,13405020,3637,4673760,1248,4070
384,32,40,25,0,13461360,3637,4682580,1244,4102
385,22,24,25,0,13585440,3637,5072400,1340,4124
386,37,27,25,0,13674120,3628,5332860,1395,4161
387,34,40,25,0,13743420,3630,5341440,1387,4195
388,19,36,25,0,13824660,3635,5388780,1396,4214
389,28,31,25,0,13955520,3638,5463720,1404,4242
390,31,23,25,0,14049300,3626,5930040,1512,4273
391,33,15,25,0,14129940,3609,6186420,1565,4306
392,31,23,25,0,14195460,3604,6201780,1555,4337
393,38,40,16,9,14287200,3610,6209460,1550,4375
394,41,38,23,2,14344560,3613,6235800,1546,4416
395,32,40,23,2,14440200,3620,6292200,1553,4448
396,27,32,25,0,14539440,3615,6502380,1594,4475
397,37,37,25,0,14624400,3616,6519180,1588,4512
398,32,40,25,0,14690340,3616,6555000,1588,4544
399,29,39,25,0,14803680,3619,6615420,1592,4573
400,43,40,25,0,14889600,3619,6639300,1589,4616
401,35,36,25,0,14985720,3620,6697860,1595,4651
402,34,40,25,0,15070800,3617,6834360,1616,4685
403,34,37,25,0,15171780,3621,6849120,1611,4719
404,25,19,25,0,15266580,3608,7517940,1758,4744
405,31,16,25,0,15351660,3599,7805880,1813,4775
406,25,28,24,1,15413700,3602,7815900,1805,4800
407,29,35,25,0,15521520,3609,7844940,1799,4829
408,40,40,25,0,15598320,3609,7852620,1790,4869
409,32,39,25,0,15684600,3614,7860000,1785,4901
410,28,35,25,0,15780960,3615,7963920,1799,4929
411,33,29,25,0,15895560,3609,8154360,1829,4962
412,33,39,25,0,15963360,3609,8179980,1823,4995
413,36,38,25,0,16060320,3608,8218800,1820,5031
414,31,38,25,0,16141980,3611,8274900,1825,5062
415,34,40,25,0,16226640,3611,8327460,1827,5096
416,28,38,20,5,16310400,3617,8337480,1825,5124
417,34,33,25,0,16430280,3616,8645880,1881,5158
418,33,38,25,0,16489620,3613,8658660,1872,5191
419,21,36,25,0,16575720,3619,8677740,1870,5212
420,27,38,24,1,16669080,3619,8701140,1864,5239
421,38,40,25,0,16745820,3620,8768640,1870,5277
422,31,33,25,0,16854480,3614,8942460,1894,5308
423,22,14,25,0,16953660,3604,9805980,2067,5330
424,26,0,18,7,17041920,3587,10335180,2167,5356
425,26,0,19,6,17107260,3581,10335180,2155,5382
426,39,22,23,2,17150340,3581,10336320,2143,5421
427,31,40,15,10,17212860,3585,10340400,2131,5452
428,23,36,25,0,17286840,3593,10411920,2137,5475
429,26,40,25,0,17366340,3598,10449660,2136,5501
430,27,40,25,0,17462640,3602,10476540,2132,5528
431,32,31,25,0,17584140,3603,10688160,2166,5560
432,33,38,25,0,17658120,3602,10702680,2156,5593
433,33,39,25,0,17728860,3605,10713480,2151,5626
434,42,40,23,2,17808720,3609,10747620,2151,5668
435,35,37,25,0,17914500,3610,10829940,2156,5703
436,30,38,25,0,18009060,3614,10862700,2153,5733
437,29,39,22,3,18072000,3617,10872480,2150,5762
438,28,37,25,0,18176460,3622,10927860,2151,5790
439,32,39,25,0,18262800,3617,11005500,2154,5822
440,35,39,25,0,18358860,3619,11047920,2152,5857
441,32,40,25,0,18442680,3622,11057700,2145,5889
442,43,40,25,0,18536400,3625,11064840,2137,5932
443,16,13,25,0,18631440,3614,12225060,2354,5948
444,24,0,19,6,18718740,3601,12654420,2425,5972
445,30,6,25,0,18786600,3601,12656400,2412,6002
446,30,33,13,12,18867840,3606,12660540,2401,6032
447,33,40,11,14,18906660,3610,12664200,2395,6065
448,32,39,25,0,18960060,3616,12744480,2401,6097
449,23,38,25,0,19058280,3621,12805500,2405,6120
450,25,35,25,0,19168320,3623,12936780,2418,6145
451,28,39,25,0,19246620,3623,13022760,2422,6173
452,24,34,25,0,19339800,3621,13144320,2435,6197
453,27,39,25,0,19408920,3621,13151820,2425,6224
454,34,40,18,7,19487520,3624,13183740,2426,6258
455,36,40,25,0,19582200,3625,13241580,2422,6294
456,32,38,25,0,19673520,3627,13312620,2426,6326
457,25,31,25,0,19764600,3623,13453740,2441,6351
458,33,40,24,1,19843860,3627,13459920,2432,6384
459,23,37,20,5,19915860,3630,13485060,2432,6407
460,31,40,20,5,19998660,3627,13596480,2440,6438
461,23,36,25,0,20061420,3625,13654260,2441,6461
462,39,40,25,0,20170860,3627,13703940,2436,6500
463,30,36,25,0,20252340,3622,13831620,2448,6530
464,35,39,16,9,20336160,3626,13839000,2444,6565
465,33,22,25,0,20440920,3626,14429160,2539,6598
466,29,13,22,3,20510400,3612,15122100,2648,6627
467,31,26,25,0,20582880,3616,15137400,2638,6658
468,27,40,16,9,20661900,3618,15141600,2626,6685
469,29,40,25,0,20731860,3623,15174600,2622,6714
470,36,40,25,0,20813160,3624,15249060,2626,6750
471,39,40,25,0,20930400,3624,15443100,2644,6789
472,34,35,25,0,21010440,3623,15480720,2642,6823
473,35,40,25,0,21098160,3621,15628680,2653,6858
474,37,39,22,3,21180180,3626,15645060,2650,6895
475,31,37,25,0,21278520,3631,15674280,2647,6926
476,30,35,25,0,21377100,3631,15756060,2649,6956
477,27,35,25,0,21451380,3627,15811740,2646,6983
478,35,40,25,0,21537420,3628,15838860,2640,7018
479,29,31,25,0,21641880,3626,16065060,2668,7047
480,30,40,17,8,21682560,3625,16067940,2662,7077
481,30,38,25,0,21774120,3633,16108260,2661,7107
482,30,37,25,0,21865500,3632,16148100,2655,7137
483,37,40,25,0,21945720,3630,16199040,2652,7174
484,34,38,21,4,22027140,3630,16256220,2653,7208
485,23,35,14,11,22138380,3628,16531440,2688,7231
486,37,39,25,0,22187580,3627,16546980,2677,7268
487,28,30,25,0,22277460,3625,16706100,2694,7296
488,38,29,25,0,22384740,3620,17536680,2811,7334
489,27,38,25,0,22452900,3622,17550360,2803,7361
490,31,36,25,0,22556880,3625,17595360,2800,7392
491,33,36,25,0,22666380,3626,17700960,2804,7425
492,31,40,15,10,22723260,3622,17727420,2801,7456
493,30,37,24,1,22772880,3625,17784000,2803,7486
494,25,19,25,0,22887240,3619,18540720,2911,7511
495,31,18,23,2,22957500,3610,18855720,2947,7542
496,25,39,14,11,23025060,3614,18858480,2937,7567
497,31,39,18,7,23079840,3617,18892500,2934,7598
498,30,40,25,0,23146440,3619,18941160,2932,7628
499,30,40,25,0,23254980,3624,19016700,2934,7658
500,30,39,25,0,23334780,3622,19149780,2944,7688
501,34,40,25,0,23426400,3624,19181280,2939,7722
502,32,40,23,2,23512500,3623,19242120,2937,7754
503,24,40,18,7,23598000,3620,19304460,2936,7778
504,9,35,11,14,23681460,3626,19323960,2938,7787
505,5,17,16,9,23728320,3623,19879740,3020,7792
506,7,0,4,21,23798340,3614,20343240,3087,7799
507,8,0,7,18,23806020,3612,20343240,3083,7807
508,9,0,11,14,23830260,3613,20343240,3079,7816
509,4,0,5,20,23864220,3613,20343240,3077,7820
510,8,0,9,16,23879340,3613,20343240,3073,7828
511,6,0,5,20,23922600,3614,20343240,3071,7834
512,4,0,6,19,23928600,3613,20343240,3069,7838
513,10,0,7,18,23962800,3613,20343240,3064,7848
514,10,0,13,12,23975640,3613,20343240,3060,7858
515,11,0,12,13,24009960,3612,20343240,3054,7869
516,7,0,8,17,24066060,3614,20343240,3051,7876
517,11,0,8,17,24095160,3613,20343240,3046,7887
518,9,0,7,18,24119700,3611,20343240,3042,7896
519,9,0,11,14,24147720,3612,20343240,3038,7905
520,8,0,12,13,24177540,3613,20343240,3034,7913
521,11,0,12,13,24234720,3616,20343240,3029,7924
522,10,0,6,19,24287400,3615,20343240,3025,7934
523,8,0,6,19,24313860,3614,20343240,3021,7942
524,10,0,12,13,24331260,3615,20343240,3017,7952
525,4,0,8,17,24366300,3616,20343240,3015,7956
526,10,0,7,18,24412200,3617,20343240,3011,7966
527,5,0,5,20,24430380,3616,20343240,3008,7971
528,4,0,3,22,24448860,3615,20343240,3007,7975
529,5,0,4,21,24453960,3614,20343240,3004,7980
530,3,0,2,23,24470880,3614,20343240,3003,7983
531,5,0,5,20,24476820,3613,20343240,3001,7988
532,4,0,5,20,24495780,3614,20343240,2999,7992
533,5,0,5,20,24507660,3613,20343240,2997,7997
534,11,0,9,16,24530820,3613,20343240,2992,8008
535,3,0,8,17,24544500,3613,20343240,2991,8011
536,9,0,8,17,24585360,3614,20343240,2987,8020
537,5,0,7,18,24605700,3614,20343240,2985,8025
538,6,0,9,16,24629040,3615,20343240,2982,8031
539,16,0,16,9,24659220,3615,20343240,2975,8047
540,7,0,6,19,24716280,3614,20343240,2972,8054
541,18,0,13,12,24747000,3613,20343240,2964,8072
542,15,0,13,12,24784920,3610,20343240,2958,8087
543,11,0,14,11,24816660,3610,20343240,2953,8098
544,11,0,11,14,24867600,3610,20343240,2948,8109
545,6,0,8,17,24912120,3612,20343240,2946,8115
546,10,0,8,17,24953400,3612,20343240,2941,8125
547,9,0,8,17,24974040,3611,20343240,2938,8134
548,6,0,7,18,25001820,3611,20343240,2935,8140
549,7,0,5,20,25041300,3612,20343240,2932,8147
550,10,0,7,18,25055880,3610,20343240,2928,8157
551,4,0,7,18,25073160,3610,20343240,2926,8161
552,4,0,3,22,25107000,3611,20343240,2924,8165
553,5,0,3,22,25124700,3611,20343240,2922,8170
554,5,0,3,22,25131660,3609,20343240,2920,8175
555,7,0,4,21,25148760,3609,20343240,2917,8182
556,9,0,5,20,25162800,3607,20343240,2914,8191
557,6,0,6,19,25178460,3606,20343240,2911,8197
558,11,0,13,12,25193220,3606,20343240,2907,8208
559,9,0,10,15,25240500,3607,20343240,2903,8217
560,11,0,11,14,25271940,3606,20343240,2898,8228
561,11,0,12,13,25311420,3607,20343240,2894,8239
562,7,0,10,15,25357680,3609,20343240,2891,8246
563,9,0,12,13,25378680,3608,20343240,2887,8255
564,8,0,6,19,25447920,3611,20343240,2884,8263
565,11,0,8,17,25480860,3611,20343240,2879,8274
566,16,0,10,15,25521720,3609,20343240,2873,8290
567,12,0,8,17,25563840,3608,20343240,2868,8302
568,14,0,13,12,25579800,3606,20343240,2862,8316
569,12,0,11,14,25637520,3607,20343240,2857,8328
570,6,0,6,19,25679880,3607,20343240,2855,8334
571,4,0,3,22,25710480,3608,20343240,2853,8338
572,9,0,9,16,25715100,3607,20343240,2850,8347
573,11,0,11,14,25739580,3606,20343240,2846,8358
574,6,0,7,18,25782720,3607,20343240,2843,8364
575,5,0,7,18,25807560,3608,20343240,2841,8369
576,4,0,3,22,25835700,3608,20343240,2840,8373
577,4,0,3,22,25851060,3608,20343240,2838,8377
578,2,0,2,23,25859340,3608,20343240,2837,8379
579,3,0,2,23,25872480,3608,20343240,2836,8382
580,8,0,6,19,25878600,3607,20343240,2833,8390
581,5,0,5,20,25895460,3606,20343240,2831,8395
582,7,0,7,18,25915800,3606,20343240,2828,8402
583,7,0,8,17,25936200,3606,20343240,2825,8409
584,12,0,7,18,25970220,3604,20343240,2821,8421
585,8,0,9,16,25995120,3605,20343240,2818,8429
586,7,0,7,18,26042520,3607,20343240,2815,8436
587,13,0,9,16,26075460,3606,20343240,2810,8449
588,12,0,10,15,26101560,3604,20343240,2805,8461
589,12,0,14,11,26131860,3604,20343240,2800,8473
590,14,0,14,11,26180940,3604,20343240,2795,8487
591,13,0,13,12,26228940,3604,20343240,2790,8500
592,11,0,12,13,26284320,3606,20343240,2786,8511
593,11,0,11,14,26324700,3605,20343240,2782,8522
594,10,0,10,15,26371740,3606,20343240,2778,8532
595,9,0,11,14,26397180,3606,20343240,2774,8541
596,8,0,8,17,26436480,3606,20343240,2771,8549
597,5,0,5,20,26472600,3607,20343240,2770,8554
598,5,0,4,21,26498700,3607,20343240,2768,8559
599,3,0,5,20,26509260,3608,20343240,2767,8562
600,8,0,8,17,26518500,3606,20343240,2764,8570
601,6,0,8,17,26553180,3608,20343240,2761,8576
602,4,0,3,22,26585400,3608,20343240,2760,8580
603,3,0,2,23,26606520,3609,20343240,2759,8583
604,8,0,7,18,26609160,3608,20343240,2756,8591
605,6,0,7,18,26626020,3607,20343240,2753,8597
606,8,0,10,15,26637480,3606,20343240,2750,8605
607,9,0,10,15,26676300,3607,20343240,2747,8614
608,10,0,11,14,26706540,3607,20343240,2743,8624
609,9,0,10,15,26761440,3610,20343240,2740,8633
610,6,0,6,19,26796840,3609,20343240,2738,8639
611,11,0,13,12,26809560,3609,20343240,2734,8650
612,12,0,7,18,26870700,3609,20343240,2729,8662
613,6,0,7,18,26887980,3608,20343240,2727,8668
614,10,0,9,16,26905980,3607,20343240,2724,8678
615,17,0,17,8,26943600,3607,20343240,2717,8695
616,13,0,12,13,26998860,3606,20343240,2713,8708
617,11,0,12,13,27030660,3605,20343240,2709,8719
618,10,0,12,13,27083640,3607,20343240,2705,8729
619,5,0,9,16,27123300,3609,20343240,2703,8734
620,8,0,6,19,27164100,3609,20343240,2700,8742
621,5,0,6,19,27188940,3610,20343240,2699,8747
622,6,0,8,17,27200700,3609,20343240,2696,8753
623,5,0,4,21,27244140,3611,20343240,2695,8758
624,8,0,7,18,27263160,3611,20343240,2692,8766
625,9,0,9,16,27289200,3611,20343240,2689,8775
626,4,0,8,17,27307200,3611,20343240,2687,8779
627,3,0,4,21,27334080,3611,20343240,2686,8782
628,6,0,6,19,27354360,3612,20343240,2684,8788
629,8,0,6,19,27371100,3610,20343240,2681,8796
630,7,0,8,17,27382800,3610,20343240,2679,8803
631,4,0,3,22,27421320,3610,20343240,2677,8807
632,12,0,9,16,27428760,3609,20343240,2673,8819
633,4,0,3,22,27461820,3608,20343240,2672,8823
634,11,0,9,16,27477780,3608,20343240,2668,8834
635,10,0,11,14,27493800,3606,20343240,2664,8844
636,6,0,7,18,27538860,3607,20343240,2662,8850
637,9,0,9,16,27564600,3607,20343240,2659,8859
638,12,0,11,14,27595740,3607,20343240,2655,8871
639,8,0,10,15,27623700,3606,20343240,2652,8879
640,11,0,11,14,27664440,3607,20343240,2648,8890
641,14,0,15,10,27704880,3607,20343240,2644,8904
642,4,0,6,19,27750300,3607,20343240,2642,8908
643,10,0,10,15,27775080,3608,20343240,2639,8918
644,9,0,8,17,27814200,3608,20343240,2636,8927
645,7,0,8,17,27838020,3607,20343240,2633,8934
646,8,0,6,19,27868500,3607,20343240,2631,8942
647,4,0,5,20,27880800,3606,20343240,2629,8946
648,6,0,3,22,27909480,3606,20343240,2627,8952
649,5,0,5,20,27920220,3606,20343240,2625,8957
650,4,0,5,20,27927960,3605,20343240,2624,8961
651,5,0,4,21,27952380,3605,20343240,2622,8966
652,9,0,7,18,27972240,3605,20343240,2619,8975
653,7,0,6,19,27994560,3604,20343240,2617,8982
654,4,0,5,20,28012020,3604,20343240,2616,8986
655,7,0,5,20,28028820,3603,20343240,2613,8993
656,14,0,9,16,28069440,3604,20343240,2609,9007
657,9,0,7,18,28096800,3602,20343240,2606,9016
658,19,0,13,12,28142340,3602,20343240,2599,9035
659,6,0,14,11,28158540,3602,20343240,2597,9041
660,9,0,10,15,28220700,3604,20343240,2594,9050
661,13,0,13,12,28270560,3605,20343240,2590,9063
662,11,0,9,16,28315800,3604,20343240,2586,9074
663,5,0,8,17,28338300,3604,20343240,2585,9079
664,4,0,4,21,28368840,3605,20343240,2583,9083
665,5,0,5,20,28379160,3604,20343240,2582,9088
666,5,0,5,20,28398300,3604,20343240,2580,9093
667,7,0,6,19,28413240,3603,20343240,2578,9100
668,13,0,10,15,28439400,3603,20343240,2574,9113
669,7,0,9,16,28470240,3603,20343240,2571,9120
670,6,0,4,21,28508160,3603,20343240,2569,9126
671,5,0,6,19,28518180,3603,20343240,2568,9131
672,10,0,8,17,28544520,3602,20343240,2565,9141
673,6,0,11,14,28547340,3601,20343240,2563,9147
674,4,0,12,13,28553940,3601,20343240,2561,9151
675,5,0,12,13,28574040,3601,20343240,2560,9156
676,8,0,15,10,28590540,3601,20343240,2557,9164
677,3,0,11,14,28620300,3601,20343240,2556,9167
678,7,0,16,9,28624320,3601,20343240,2554,9174
679,9,0,17,8,28659120,3602,20343240,2551,9183
680,6,0,16,9,28680780,3601,20343240,2549,9189
681,8,0,11,14,28731960,3602,20343240,2547,9197
682,7,0,12,13,28742580,3600,20343240,2544,9204
683,10,0,12,13,28765140,3599,20343240,2541,9214
684,9,0,16,9,28779420,3598,20343240,2538,9223
685,11,0,14,11,28814640,3597,20343240,2535,9234
686,18,0,20,5,28840740,3595,20343240,2529,9252
687,15,0,21,4,28894740,3595,20343240,2524,9267
688,10,0,21,4,28932000,3595,20343240,2521,9277
689,12,0,17,8,28997580,3596,20343240,2518,9289
690,15,0,21,4,29040240,3597,20343240,2513,9304
691,11,0,19,6,29082540,3596,20343240,2509,9315
692,7,0,15,10,29138040,3598,20343240,2507,9322
693,5,0,12,13,29169300,3598,20343240,2506,9327
694,5,0,8,17,29191740,3597,20343240,2504,9332
695,2,0,10,15,29191740,3597,20343240,2504,9334
696,6,0,13,12,29195940,3596,20343240,2502,9340
697,5,0,12,13,29227320,3598,20343240,2500,9345
698,8,0,10,15,29247060,3596,20343240,2498,9353
699,7,0,15,10,29247960,3595,20343240,2496,9360
700,4,0,9,16,29281080,3594,20343240,2494,9364
701,1,0,8,17,29293320,3595,20343240,2494,9365
702,7,0,13,12,29295300,3594,20343240,2492,9372
703,7,0,13,12,29309340,3593,20343240,2490,9379
704,13,0,18,7,29333280,3593,20343240,2486,9392
705,9,0,18,7,29369160,3593,20343240,2483,9401
706,11,0,17,8,29420340,3594,20343240,2480,9412
707,12,0,16,9,29452320,3592,20343240,2476,9424
708,12,0,19,6,29473800,3591,20343240,2473,9436
709,13,0,17,8,29533980,3592,20343240,2469,9449
710,7,0,15,10,29566020,3592,20343240,2467,9456
711,4,0,12,13,29601180,3593,20343240,2465,9460
712,9,0,14,11,29626260,3593,20343240,2463,9469
713,11,0,16,9,29648760,3592,20343240,2459,9480
714,6,0,12,13,29671860,3590,20343240,2458,9486
715,7,0,13,12,29693580,3590,20343240,2456,9493
716,6,0,15,10,29703360,3589,20343240,2454,9499
717,5,0,10,15,29741460,3590,20343240,2452,9504
718,8,0,14,11,29752920,3589,20343240,2450,9512
719,5,0,13,12,29780580,3590,20343240,2448,9517
720,3,0,13,12,29797080,3591,20343240,2448,9520
721,3,0,9,16,29829840,3592,20343240,2447,9523
722,7,0,13,12,29839680,3592,20343240,2445,9530
723,3,0,9,16,29860260,3591,20343240,2444,9533
724,5,0,11,14,29862360,3590,20343240,2442,9538
725,12,0,18,7,29874600,3589,20343240,2439,9550
726,9,0,20,5,29901480,3590,20343240,2436,9559
727,6,0,16,9,29945160,3590,20343240,2434,9565
728,10,0,18,7,29977740,3591,20343240,2431,9575
729,10,0,21,4,30013140,3592,20343240,2429,9585
730,12,0,17,8,30075840,3593,20343240,2425,9597
731,16,0,20,5,30109200,3591,20343240,2420,9613
732,15,0,21,4,30142740,3589,20343240,2416,9628
733,7,0,14,11,30200160,3590,20343240,2414,9635
734,7,0,12,13,30235260,3590,20343240,2412,9642
735,11,0,13,12,30257640,3589,20343240,2409,9653
736,13,0,17,8,30281400,3588,20343240,2405,9666
737,14,0,21,4,30297300,3585,20343240,2401,9680
738,3,0,16,9,30328800,3586,20343240,2400,9683
739,8,0,16,9,30378780,3588,20343240,2398,9691
740,2,0,11,14,30403080,3588,20343240,2398,9693
741,6,0,14,11,30423360,3589,20343240,2396,9699
742,5,0,12,13,30453000,3590,20343240,2395,9704
743,3,0,10,15,30483000,3591,20343240,2394,9707
744,6,0,12,13,30492000,3591,20343240,2392,9713
745,2,0,11,14,30501060,3590,20343240,2391,9715
746,6,0,12,13,30515820,3590,20343240,2390,9721
747,2,0,11,14,30523620,3590,20343240,2389,9723
748,6,0,12,13,30544440,3590,20343240,2387,9729
749,3,0,13,12,30547740,3590,20343240,2387,9732
750,6,0,13,12,30572760,3590,20343240,2385,9738
751,2,0,9,16,30594540,3590,20343240,2384,9740
752,9,0,12,13,30602760,3588,20343240,2382,9749
753,11,0,15,10,30625440,3588,20343240,2379,9760
754,12,0,19,6,30645240,3587,20343240,2375,9772
755,8,0,16,9,30681420,3586,20343240,2373,9780
756,16,0,19,6,30725100,3586,20343240,2369,9796
757,11,0,22,3,30758400,3586,20343420,2366,9807
758,13,0,23,2,30805860,3587,20343420,2362,9820
759,11,0,17,8,30880800,3589,20343420,2359,9831
760,11,0,18,7,30907320,3588,20343420,2356,9842
761,11,0,17,8,30943800,3587,20343420,2353,9853
762,11,0,16,9,30978060,3586,20343420,2350,9864
763,8,0,14,11,31020300,3586,20343420,2348,9872
764,6,0,13,12,31038360,3586,20343420,2346,9878
765,4,0,11,14,31062240,3586,20343420,2345,9882
766,10,0,15,10,31086720,3586,20343420,2343,9892
767,6,0,16,9,31102680,3586,20343420,2341,9898
768,3,0,12,13,31128840,3586,20343420,2340,9901
769,7,0,14,11,31148700,3586,20343420,2338,9908
770,7,0,18,7,31166280,3587,20343420,2336,9915
771,5,0,16,9,31202760,3588,20343420,2335,9920
772,6,0,16,9,31228740,3589,20343420,2334,9926
773,4,0,13,12,31261500,3590,20343420,2332,9930
774,8,0,12,13,31296780,3590,20343420,2330,9938
775,6,0,13,12,31317660,3591,20343420,2329,9944
776,8,0,15,10,31338540,3590,20343420,2327,9952
777,6,0,15,10,31358160,3590,20343420,2325,9958
778,17,0,19,6,31399320,3590,20343420,2320,9975
779,6,0,15,10,31423020,3588,20343420,2319,9981
780,6,0,17,8,31443660,3589,20343420,2317,9987
781,9,0,15,10,31494300,3590,20343420,2315,9996
782,6,0,14,11,31510200,3589,20343420,2313,10002
783,8,0,15,10,31543740,3590,20343420,2311,10010
784,7,0,15,10,31565520,3590,20343420,2309,10017
785,11,0,20,5,31584180,3589,20343420,2307,10028
786,8,0,17,8,31635600,3591,20343420,2304,10036
787,9,0,13,12,31674240,3590,20343420,2302,10045
788,7,0,14,11,31695960,3590,20343420,2300,10052
789,8,0,12,13,31733040,3590,20343420,2298,10060
790,4,0,11,14,31752480,3590,20343420,2297,10064
791,9,0,15,10,31768560,3590,20343420,2295,10073
792,3,0,11,14,31793580,3590,20343420,2294,10076
793,7,0,12,13,31817220,3590,20343420,2292,10083
794,5,0,14,11,31828380,3590,20343420,2291,10088
795,7,0,16,9,31852560,3591,20343420,2289,10095
796,2,0,7,18,31894980,3591,20343420,2289,10097
797,8,0,12,13,31899720,3591,20343420,2287,10105
798,6,0,13,12,31915680,3590,20343420,2285,10111
799,10,0,15,10,31938180,3590,20343420,2282,10121
800,6,0,15,10,31957440,3589,20343420,2281,10127
801,5,0,12,13,31992480,3590,20343420,2280,10132
802,3,0,11,14,32006460,3590,20343420,2279,10135
803,19,0,19,6,32045520,3590,20343420,2274,10154
804,16,0,25,0,32071500,3589,20343420,2270,10170
805,3,0,13,12,32129040,3589,20343420,2269,10173
806,8,0,14,11,32160060,3590,20343420,2267,10181
807,7,0,15,10,32174760,3589,20343420,2265,10188
808,6,0,14,11,32208960,3590,20343420,2264,10194
809,7,0,13,12,32242680,3591,20343420,2262,10201
810,10,0,15,10,32260140,3590,20343420,2260,10211
811,5,0,14,11,32289900,3590,20343420,2258,10216
812,4,0,10,15,32312700,3590,20343420,2257,10220
813,8,0,10,15,32333220,3589,20343420,2255,10228
814,5,0,15,10,32333220,3589,20343420,2254,10233
815,6,0,12,13,32365260,3589,20343420,2253,10239
816,1,0,11,14,32374800,3589,20343420,2252,10240
817,7,0,14,11,32395260,3590,20343420,2251,10247
818,5,0,12,13,32416080,3589,20343420,2249,10252
819,5,0,14,11,32429880,3590,20343420,2248,10257
820,2,0,11,14,32459640,3591,20343420,2248,10259
821,12,0,16,9,32474700,3590,20343420,2245,10271
822,6,0,15,10,32490600,3589,20343420,2243,10277
823,12,0,17,8,32520120,3588,20343420,2240,10289
824,8,0,14,11,32556600,3588,20343420,2238,10297
825,3,0,12,13,32587200,3589,20343420,2238,10300
826,10,0,16,9,32608440,3589,20343420,2235,10310
827,5,0,10,15,32639820,3588,20343420,2234,10315
828,10,0,17,8,32650200,3588,20343420,2231,10325
829,17,0,23,2,32686800,3588,20343420,2227,10342
830,7,0,15,10,32734020,3587,20343420,2226,10349
831,7,0,13,12,32766060,3587,20343420,2224,10356
832,6,0,13,12,32793480,3588,20343420,2222,10362
833,10,0,13,12,32820180,3587,20343420,2220,10372
834,14,0,19,6,32834700,3585,20343420,2217,10386
835,11,0,21,4,32860140,3585,20343420,2214,10397
836,6,0,15,10,32909400,3585,20343420,2212,10403
837,5,0,13,12,32944980,3586,20343420,2211,10408
838,8,0,10,15,32978880,3586,20343420,2209,10416
839,3,0,11,14,32986680,3586,20343420,2209,10419
840,3,0,10,15,33009480,3587,20343420,2208,10422
841,7,0,13,12,33021000,3586,20343420,2206,10429
842,8,0,15,10,33038280,3586,20343420,2204,10437
843,3,0,11,14,33069600,3587,20343420,2204,10440
844,4,0,13,12,33079980,3587,20343420,2203,10444
845,5,0,11,14,33100680,3586,20343420,2201,10449
846,9,0,15,10,33116100,3586,20343420,2199,10458
847,9,0,15,10,33147360,3586,20343420,2197,10467
848,8,0,12,13,33178080,3585,20343420,2195,10475
849,6,0,13,12,33199920,3586,20343420,2194,10481
850,13,0,15,10,33223020,3584,20343420,2191,10494
851,9,0,17,8,33242160,3583,20343420,2189,10503
852,12,0,16,9,33285240,3583,20343420,2186,10515
853,11,0,19,6,33314760,3583,20343420,2183,10526
854,15,0,24,1,33338160,3582,20343420,2180,10541
855,13,0,19,6,33394620,3581,20343420,2177,10554
856,8,0,14,11,33452340,3582,20343420,2175,10562
857,13,0,18,7,33475800,3581,20343420,2172,10575
858,17,0,24,1,33504960,3580,20345340,2168,10592
859,6,0,16,9,33569880,3581,20345340,2167,10598
860,5,0,16,9,33595320,3582,20345340,2166,10603
861,7,0,13,12,33639420,3583,20345340,2164,10610
862,5,0,12,13,33650640,3582,20345340,2163,10615
863,10,0,13,12,33680340,3582,20345340,2160,10625
864,4,0,13,12,33693720,3582,20345340,2160,10629
865,8,0,14,11,33717900,3582,20345340,2158,10637
866,4,0,14,11,33735300,3582,20345340,2157,10641
867,5,0,10,15,33781140,3583,20345340,2156,10646
868,6,0,11,14,33799680,3583,20345340,2154,10652
869,5,0,13,12,33812760,3584,20345340,2153,10657
870,7,0,11,14,33837660,3583,20345340,2152,10664
871,9,0,14,11,33853260,3582,20345340,2149,10673
872,16,0,18,7,33895620,3582,20345340,2146,10689
873,11,0,21,4,33922560,3582,20345340,2143,10700
874,13,0,24,1,33954780,3582,20345580,2140,10713
875,12,0,20,5,34024740,3583,20345580,2138,10725
876,12,0,18,7,34076040,3583,20345580,2135,10737
877,7,0,14,11,34121040,3584,20345580,2134,10744
878,9,0,15,10,34151760,3584,20345580,2131,10753
879,7,0,12,13,34177320,3583,20345580,2130,10760
880,5,0,15,10,34190520,3583,20345580,2129,10765
881,7,0,14,11,34220700,3584,20345580,2127,10772
882,6,0,14,11,34246920,3584,20345580,2126,10778
883,7,0,16,9,34266240,3584,20345580,2124,10785
884,4,0,13,12,34299660,3585,20345580,2123,10789
885,6,0,12,13,34331220,3586,20345580,2122,10795
886,7,0,11,14,34365360,3586,20345580,2121,10802
887,4,0,12,13,34374720,3586,20345580,2120,10806
888,4,0,8,17,34402920,3586,20345580,2119,10810
889,8,0,12,13,34409820,3585,20345580,2117,10818
890,5,0,14,11,34421700,3585,20345580,2116,10823
891,4,0,14,11,34445220,3586,20345580,2115,10827
892,11,0,20,5,34458840,3586,20345580,2113,10838
893,6,0,11,14,34520760,3587,20345580,2111,10844
894,9,0,14,11,34544100,3587,20345580,2109,10853
895,13,0,21,4,34556760,3586,20345580,2107,10866
896,7,0,16,9,34598580,3586,20345580,2105,10873
897,4,0,10,15,34636380,3586,20345580,2104,10877
898,14,0,14,11,34663920,3585,20345580,2101,10891
899,14,0,20,5,34682760,3584,20345580,2098,10905
900,6,0,10,15,34733040,3584,20345580,2097,10911
901,15,0,21,4,34740300,3583,20345580,2094,10926
902,10,0,22,3,34771260,3583,20345580,2091,10936
903,9,1,21,4,34817040,3584,20345940,2089,10945
904,12,10,17,8,34867920,3587,20350080,2088,10957
905,8,15,16,9,34901820,3589,20361000,2087,10965
906,9,7,25,0,34954080,3591,20410980,2090,10974
907,9,0,16,9,35024280,3589,20468700,2094,10983
908,12,0,17,8,35060820,3589,20468700,2091,10995
909,6,0,15,10,35088840,3589,20468700,2090,11001
910,3,0,14,11,35110200,3590,20468700,2089,11004
911,6,0,16,9,35148480,3592,20468700,2088,11010
912,6,0,15,10,35176320,3592,20468700,2087,11016
913,9,0,15,10,35216640,3593,20468700,2085,11025
914,6,0,15,10,35235420,3593,20468700,2084,11031
915,7,0,15,10,35267880,3593,20468700,2082,11038
916,8,0,14,11,35295300,3593,20468700,2080,11046
917,7,0,13,12,35328780,3593,20468700,2079,11053
918,6,0,15,10,35333580,3593,20468700,2078,11059
919,5,0,15,10,35366340,3594,20468700,2077,11064
920,7,0,15,10,35398260,3595,20468700,2075,11071
921,9,0,14,11,35435940,3595,20468700,2073,11080
922,8,0,13,12,35475060,3596,20468700,2072,11088
923,14,0,19,6,35494320,3595,20468700,2069,11102
924,7,0,14,11,35527500,3594,20468700,2067,11109
925,14,0,20,5,35562300,3594,20468700,2064,11123
926,14,0,23,2,35607300,3595,20468700,2061,11137
927,13,0,18,7,35673240,3595,20469480,2059,11150
928,13,0,20,5,35697420,3593,20469480,2056,11163
929,5,0,15,10,35739600,3594,20469480,2055,11168
930,9,0,15,10,35789400,3596,20469480,2053,11177
931,9,0,14,11,35814780,3595,20469480,2051,11186
932,5,0,12,13,35845200,3595,20469480,2050,11191
933,6,0,15,10,35860260,3596,20469480,2049,11197
934,6,0,14,11,35879700,3595,20469480,2048,11203
935,10,0,15,10,35900940,3594,20469480,2046,11213
936,1,0,14,11,35912220,3594,20469480,2046,11214
937,3,0,9,16,35959320,3596,20469480,2045,11217
938,4,0,11,14,35966880,3596,20469480,2044,11221
939,6,0,15,10,35974140,3596,20469480,2043,11227
940,2,0,9,16,36004620,3596,20469480,2043,11229
941,4,0,12,13,36010620,3597,20469480,2042,11233
942,3,0,11,14,36024000,3597,20469480,2041,11236
943,7,0,11,14,36043080,3596,20469480,2040,11243
944,9,0,14,11,36054600,3595,20469480,2038,11252
945,3,0,11,14,36073620,3595,20469480,2037,11255
946,12,0,15,10,36104760,3595,20469480,2035,11267
947,11,0,19,6,36124200,3594,20469480,2033,11278
948,12,0,20,5,36159660,3594,20469480,2030,11290
949,5,0,14,11,36200280,3594,20469480,2029,11295
950,15,0,21,4,36230640,3594,20469480,2026,11310
951,12,0,22,3,36272280,3594,20469480,2024,11322
952,12,0,25,0,36307920,3595,20471580,2022,11334
953,6,0,16,9,36390180,3598,20471580,2020,11340
954,6,0,14,11,36426960,3598,20471580,2019,11346
955,5,0,12,13,36455040,3599,20471580,2018,11351
956,7,0,9,16,36484920,3598,20471580,2017,11358
957,6,0,13,12,36486780,3597,20471580,2016,11364
958,9,0,13,12,36513120,3597,20471580,2014,11373
959,7,0,15,10,36530220,3597,20471580,2012,11380
960,3,0,9,16,36561420,3597,20471580,2012,11383
961,4,0,10,15,36575580,3597,20471580,2011,11387
962,6,0,14,11,36578520,3597,20471580,2010,11393
963,8,0,14,11,36604740,3596,20471580,2008,11401
964,6,0,13,12,36632040,3597,20471580,2007,11407
965,4,0,13,12,36640260,3596,20471580,2006,11411
966,9,0,17,8,36673260,3597,20471580,2005,11420
967,11,0,14,11,36706260,3596,20471580,2002,11431
968,7,0,15,10,36735900,3596,20471580,2001,11438
969,13,0,22,3,36755280,3596,20471580,1998,11451
970,14,0,24,1,36788460,3595,20471580,1996,11465
971,9,0,21,4,36843120,3596,20471580,1994,11474
972,13,0,23,2,36886320,3597,20471580,1991,11487
973,5,0,18,7,36932820,3598,20471580,1991,11492
974,11,0,15,10,36989400,3598,20471580,1988,11503
975,5,0,14,11,37012740,3599,20471580,1987,11508
976,10,0,15,10,37044960,3599,20471580,1985,11518
977,7,0,14,11,37060800,3597,20471580,1984,11525
978,7,0,12,13,37096680,3598,20471580,1983,11532
979,9,0,16,9,37111620,3597,20471580,1981,11541
980,2,0,12,13,37133940,3597,20471580,1981,11543
981,7,0,13,12,37165440,3598,20471580,1979,11550
982,6,0,11,14,37180740,3597,20471580,1978,11556
983,3,0,9,16,37199460,3597,20471580,1978,11559
984,2,0,9,16,37209780,3597,20471580,1977,11561
985,11,0,14,11,37222500,3597,20471580,1975,11572
986,11,0,17,8,37260060,3597,20471580,1973,11583
987,4,0,12,13,37291380,3597,20471580,1972,11587
988,3,0,11,14,37304460,3597,20471580,1972,11590
989,6,0,13,12,37325100,3598,20471580,1971,11596
990,5,0,12,13,37345260,3598,20471580,1970,11601
991,7,0,12,13,37365180,3597,20471580,1968,11608
992,9,0,13,12,37387740,3597,20471580,1967,11617
993,7,0,16,9,37396380,3596,20471580,1965,11624
994,8,0,18,7,37421580,3596,20471580,1964,11632
995,16,0,21,4,37470540,3597,20471580,1961,11648
996,9,0,20,5,37504260,3596,20471580,1959,11657
997,15,0,18,7,37564440,3596,20471640,1956,11672
998,13,0,21,4,37604340,3597,20471640,1954,11685
999,17,0,22,3,37651740,3596,20471640,1951,11702
1000,9,0,18,7,37701420,3596,20471640,1949,11711
1001,8,0,14,11,37740420,3596,20471640,1948,11719
1002,7,0,15,10,37765560,3596,20471640,1946,11726
1003,11,0,15,10,37795500,3595,20471640,1944,11737
1004,5,0,13,12,37827600,3596,20471640,1943,11742
1005,8,0,15,10,37848300,3596,20471640,1942,11750
1006,6,0,15,10,37867080,3595,20471640,1941,11756
1007,4,0,12,13,37885620,3595,20471640,1940,11760
1008,8,0,14,11,37917960,3596,20471640,1938,11768
1009,6,0,16,9,37938540,3596,20471640,1937,11774
1010,13,0,17,8,37988160,3597,20471640,1935,11787
1011,28,5,25,0,38018700,3595,20471820,1930,11815
1012,27,15,25,0,38067060,3593,20478900,1926,11842
1013,27,25,25,0,38133300,3594,20491140,1922,11869
1014,35,40,22,3,38198400,3596,20495580,1918,11904
1015,29,40,25,0,38245500,3598,20513520,1918,11933
1016,28,38,25,0,38331420,3601,20546760,1919,11961
1017,32,40,25,0,38384100,3602,20564220,1918,11993
1018,35,37,25,0,38462760,3603,20692500,1928,12028
1019,29,40,20,5,38511660,3602,20704680,1926,12057
1020,34,40,15,10,38546340,3603,20706540,1926,12091
1021,27,38,24,1,38611620,3603,20886540,1938,12118
1022,34,39,25,0,38657220,3604,20902080,1937,12152
1023,30,40,25,0,38698740,3603,20941140,1938,12182
1024,26,34,25,0,38779380,3605,21069900,1948,12208
1025,26,38,25,0,38827320,3603,21196440,1956,12234
1026,33,40,25,0,38887080,3605,21211980,1955,12267
1027,32,38,25,0,38966820,3606,21272820,1957,12299
1028,34,39,25,0,39025500,3605,21307800,1957,12333
1029,23,35,25,0,39089940,3604,21474120,1969,12356
1030,33,40,25,0,39144840,3604,21487920,1967,12389
1031,20,37,25,0,39222840,3605,21523980,1967,12409
1032,32,39,25,0,39288900,3604,21560640,1966,12441
1033,30,40,25,0,39348060,3603,21623640,1969,12471
1034,37,40,25,0,39404100,3604,21652860,1969,12508
1035,31,40,24,1,39472920,3605,21683460,1969,12539
1036,29,40,25,0,39520620,3606,21696600,1968,12568
1037,32,40,25,0,39607620,3605,21903840,1982,12600
1038,27,40,23,2,39662760,3606,21908820,1980,12627
1039,35,38,22,3,39712500,3607,21926880,1981,12662
1040,38,33,25,0,39799860,3608,22150320,1997,12700
1041,34,40,25,0,39842460,3606,22154460,1993,12734
1042,31,40,25,0,39896100,3607,22166820,1993,12765
1043,37,39,25,0,39978720,3607,22259220,1997,12802
1044,34,40,25,0,40030980,3607,22270860,1995,12836
1045,33,40,25,0,40103520,3605,22354860,1998,12869
1046,32,39,20,5,40140540,3606,22363380,1998,12901
1047,33,40,25,0,40199100,3607,22416960,2000,12934
1048,26,38,25,0,40286280,3607,22482360,2002,12960
1049,33,38,25,0,40349280,3606,22515300,2001,12993
1050,23,39,25,0,40402380,3606,22531200,2000,13016
1051,33,40,25,0,40465860,3607,22537440,1997,13049
1052,27,39,22,3,40540920,3609,22542960,1996,13076
1053,29,36,25,0,40596120,3607,22710240,2007,13105
1054,32,40,25,0,40647960,3608,22722720,2005,13137
1055,31,37,25,0,40730340,3609,22864020,2015,13168
1056,39,40,25,0,40789800,3609,22934460,2018,13207
1057,29,38,25,0,40855080,3608,23150220,2033,13236
1058,30,39,25,0,40924920,3608,23188080,2033,13266
1059,24,40,25,0,40967280,3608,23206740,2032,13290
1060,28,38,25,0,41055180,3608,23315400,2038,13318
1061,28,39,25,0,41101200,3609,23320380,2036,13346
1062,34,40,25,0,41172900,3610,23343960,2035,13380
1063,36,40,24,1,41222700,3610,23361480,2035,13416
1064,26,33,25,0,41314260,3612,23475480,2042,13442
1065,20,40,25,0,41349540,3611,23480160,2039,13462
1066,35,35,25,0,41437980,3613,23552700,2043,13497
1067,30,39,25,0,41505300,3614,23563080,2040,13527
1068,30,40,25,0,41555040,3614,23586540,2040,13557
1069,37,32,25,0,41644620,3613,24024720,2074,13594
1070,37,40,25,0,41681280,3612,24029100,2071,13631
1071,35,40,25,0,41729580,3613,24046920,2070,13666
1072,37,40,25,0,41815020,3615,24074940,2070,13703
1073,24,39,25,0,41860800,3613,24246360,2081,13727
1074,37,40,25,0,41942400,3616,24257400,2080,13764
1075,24,34,25,0,42028080,3616,24349860,2084,13788
1076,30,40,23,2,42067080,3611,26304780,2247,13818
1077,32,40,25,0,42128940,3614,26317200,2245,13850
1078,33,38,25,0,42192240,3615,26348160,2245,13883
1079,31,38,25,0,42273600,3615,26418120,2247,13914
1080,30,38,25,0,42319260,3615,26431800,2246,13944
1081,31,36,25,0,42387300,3615,26476140,2246,13975
1082,32,40,25,0,42435180,3615,26482380,2244,14007
1083,32,39,24,1,42518280,3616,26550720,2246,14039
1084,31,40,24,1,42578160,3616,26641140,2251,14070
1085,29,40,25,0,42650700,3617,26678460,2250,14099
1086,23,40,25,0,42677460,3616,26692800,2250,14122
1087,29,32,25,0,42774960,3616,26924280,2265,14151
1088,25,40,24,1,42818160,3616,26928180,2262,14176
1089,33,40,24,1,42871740,3617,26943360,2261,14209
1090,27,40,24,1,42944820,3617,27163800,2276,14236
1091,33,40,21,4,42999660,3618,27174480,2275,14269
1092,25,38,25,0,43076280,3620,27347700,2286,14294
1093,31,39,25,0,43123860,3618,27385380,2285,14325
1094,36,38,25,0,43191000,3618,27443280,2287,14361
1095,31,38,25,0,43266660,3618,27459600,2284,14392
1096,29,40,21,4,43306980,3617,27465060,2283,14421
1097,29,40,25,0,43366920,3617,27569040,2287,14450
1098,23,40,18,7,43411200,3618,27571740,2287,14473
1099,30,39,25,0,43466160,3619,27731340,2297,14503
1100,30,39,25,0,43531260,3619,27794700,2298,14533
1101,37,40,25,0,43606920,3619,27874920,2301,14570
1102,32,39,25,0,43678740,3620,27891120,2299,14602
1103,22,30,25,0,43756440,3618,28727160,2364,14624
1104,31,39,25,0,43798440,3616,28832640,2368,14655
1105,23,37,25,0,43862040,3617,28856460,2367,14678
1106,29,35,25,0,43935660,3616,28981080,2374,14707
1107,36,40,25,0,43988220,3616,28992360,2371,14743
1108,36,39,25,0,44056920,3617,29040540,2371,14779
1109,39,40,25,0,44126820,3616,29070720,2370,14818
1110,28,40,25,0,44188500,3617,29096460,2369,14846
1111,38,40,24,1,44244840,3617,29138700,2370,14884
1112,32,39,25,0,44302980,3617,29200020,2371,14916
1113,31,37,25,0,44375520,3619,29279040,2376,14947
1114,37,40,25,0,44446560,3617,29315640,2373,14984
1115,29,40,25,0,44508660,3617,29332800,2371,15013
1116,30,34,25,0,44581020,3616,29533920,2385,15043
1117,29,40,25,0,44629380,3615,29539440,2380,15072
1118,27,25,25,0,44722980,3613,30836100,2481,15099
1119,28,31,25,0,44766420,3610,33260280,2671,15127
1120,31,39,25,0,44827380,3610,33272280,2666,15158
1121,35,38,25,0,44894100,3611,33300420,2665,15193
1122,32,40,25,0,44972580,3611,33366120,2665,15225
1123,33,40,23,2,45015480,3610,33380880,2664,15258
1124,32,40,20,5,45067680,3609,33417780,2663,15290
1125,27,32,25,0,45158580,3608,34033980,2707,15317
1126,30,39,25,0,45194940,3607,34049280,2703,15347
1127,33,40,25,0,45258120,3608,34070700,2702,15380
1128,39,35,25,0,45349860,3608,34176360,2706,15419
1129,30,40,25,0,45408180,3608,34182720,2702,15449
1130,27,39,25,0,45468240,3608,34212960,2701,15476
1131,33,39,25,0,45507000,3606,34241040,2700,15509
1132,25,34,25,0,45594840,3606,34351200,2704,15534
1133,24,40,25,0,45658440,3607,34371120,2702,15558
1134,41,40,25,0,45712980,3607,34378320,2699,15599
1135,26,38,25,0,45774480,3607,34451280,2701,15625
1136,21,40,25,0,45843240,3608,34475340,2700,15646
1137,30,36,25,0,45913560,3609,34539120,2702,15676
1138,32,40,25,0,45983340,3608,34573020,2699,15708
1139,32,40,25,0,46042980,3608,34597140,2698,15740
1140,34,40,25,0,46103880,3606,34635300,2696,15774
1141,20,33,24,1,46170180,3604,35237880,2738,15794
1142,35,40,19,6,46221720,3605,35243940,2736,15829
1143,34,39,25,0,46279500,3606,35289180,2736,15863
1144,25,37,25,0,46341180,3606,35310480,2734,15888
1145,23,22,25,0,46421940,3602,37049100,2864,15911
1146,29,32,25,0,46471620,3600,37533540,2895,15940
1147,34,40,25,0,46535100,3602,37543680,2891,15974
1148,36,40,25,0,46582380,3603,37560900,2891,16010
1149,24,38,25,0,46675980,3605,37605240,2890,16034
1150,27,37,25,0,46741200,3604,37773420,2899,16061
1151,43,40,25,0,46793880,3603,37805280,2897,16104
1152,28,40,25,0,46857660,3603,37834140,2895,16132
1153,31,37,25,0,46928580,3604,37852320,2893,16163
1154,21,39,25,0,46989420,3604,37877700,2890,16184
1155,37,40,25,0,47045940,3605,37883880,2888,16221
1156,31,40,25,0,47125560,3604,37939140,2888,16252
1157,31,37,25,0,47189880,3604,37991520,2888,16283
1158,35,37,25,0,47258760,3603,38111640,2892,16318
1159,29,40,25,0,47321040,3603,38284500,2901,16347
1160,29,40,25,0,47377380,3602,38325600,2900,16376
1161,31,36,25,0,47437740,3602,38357580,2899,16407
1162,33,40,25,0,47498580,3602,38391480,2898,16440
1163,38,40,25,0,47517660,3602,38398380,2897,16478
1164,37,39,25,0,47614260,3604,38512260,2901,16515
1165,34,37,25,0,47678580,3603,38550900,2900,16549
1166,37,38,25,0,47761380,3603,38666580,2903,16586
1167,30,37,25,0,47812860,3602,38748120,2905,16616
1168,27,40,25,0,47868000,3600,38990580,2919,16643
1169,35,39,25,0,47935260,3601,39001080,2916,16678
1170,34,39,25,0,48019920,3602,39103800,2920,16712
1171,31,38,25,0,48066840,3601,39138900,2918,16743
1172,24,40,25,0,48121260,3600,39158340,2916,16767
1173,31,40,25,0,48192360,3600,39191220,2914,16798
1174,27,38,25,0,48265800,3601,39217080,2912,16825
1175,14,20,25,0,48338520,3597,41280780,3062,16839
1176,12,4,25,0,48393720,3594,42643860,3160,16851
1177,5,0,13,12,48458220,3593,42901320,3178,16856
1178,10,0,16,9,48480960,3593,42901320,3176,16866
1179,2,0,14,11,48501780,3594,42901320,3175,16868
1180,11,0,16,9,48542700,3594,42901320,3173,16879
1181,5,0,14,11,48561960,3594,42901320,3172,16884
1182,12,0,21,4,48581160,3594,42901320,3169,16896
1183,10,0,21,4,48629220,3595,42901320,3166,16906
1184,10,0,18,7,48676140,3595,42901320,3164,16916
1185,9,0,15,10,48715320,3594,42901320,3162,16925
1186,10,0,17,8,48748800,3595,42901320,3160,16935
1187,12,0,22,3,48775020,3595,42901320,3157,16947
1188,11,0,19,6,48819360,3594,42901320,3154,16958
1189,6,0,13,12,48868560,3595,42901320,3153,16964
1190,7,0,14,11,48896820,3595,42901320,3151,16971
1191,10,0,15,10,48931980,3596,42901320,3149,16981
1192,10,0,16,9,48948660,3594,42901320,3147,16991
1193,13,0,18,7,48984300,3594,42901320,3144,17004
1194,7,0,20,5,48999720,3594,42901320,3142,17011
1195,10,0,16,9,49079160,3596,42901320,3140,17021
1196,7,0,12,13,49104060,3595,42901320,3138,17028
1197,5,0,13,12,49120860,3595,42901320,3137,17033
1198,8,0,14,11,49138200,3595,42901320,3135,17041
1199,5,0,18,7,49140120,3595,42901320,3134,17046
1200,5,0,13,12,49192560,3596,42901320,3133,17051
1201,9,0,14,11,49224300,3596,42901320,3131,17060
1202,4,0,12,13,49241160,3596,42901320,3130,17064
1203,9,0,15,10,49262160,3596,42901320,3128,17073
1204,4,0,15,10,49277520,3596,42901320,3127,17077
1205,7,0,15,10,49311420,3596,42901320,3125,17084
1206,7,0,14,11,49344780,3597,42901320,3124,17091
1207,7,0,12,13,49367940,3596,42901320,3122,17098
1208,8,0,13,12,49392600,3596,42901320,3120,17106
1209,5,0,14,11,49404240,3596,42901320,3119,17111
1210,9,0,16,9,49425900,3595,42901320,3117,17120
1211,9,0,20,5,49439520,3595,42901320,3115,17129
1212,10,0,17,8,49494360,3596,42901320,3113,17139
1213,11,0,15,10,49549200,3596,42901320,3110,17150
1214,8,0,17,8,49585860,3597,42901320,3109,17158
1215,6,0,15,10,49619880,3598,42901320,3107,17164
1216,10,0,19,6,49636080,3597,42901320,3105,17174
1217,8,0,19,6,49686480,3599,42901320,3103,17182
1218,4,0,11,14,49739640,3600,42901320,3102,17186
1219,7,0,14,11,49748520,3599,42901320,3101,17193
1220,6,0,13,12,49776240,3599,42901320,3099,17199
1221,9,0,15,10,49804500,3600,42901320,3097,17208
1222,4,0,14,11,49819140,3599,42901320,3096,17212
1223,7,0,15,10,49848120,3600,42901320,3095,17219
1224,3,0,11,14,49876260,3600,42901320,3094,17222
1225,8,0,13,12,49892520,3600,42901320,3092,17230
1226,4,0,13,12,49915140,3600,42901320,3091,17234
1227,2,0,12,13,49933920,3601,42901320,3091,17236
1228,3,0,12,13,49947240,3601,42901320,3090,17239
1229,3,0,10,15,49967100,3601,42901320,3090,17242
1230,9,0,16,9,49981380,3602,42901320,3088,17251
1231,5,0,14,11,50001540,3601,42901320,3087,17256
1232,8,0,15,10,50022600,3601,42901320,3085,17264
1233,14,0,18,7,50055060,3600,42901320,3082,17278
1234,15,0,16,9,50098140,3599,42901320,3078,17293
1235,12,0,20,5,50120880,3599,42901320,3076,17305
1236,12,0,20,5,50166420,3599,42901320,3073,17317
1237,17,0,19,6,50219280,3598,42901320,3069,17334
1238,13,0,17,8,50265780,3597,42901320,3067,17347
1239,10,0,15,10,50297160,3597,42901320,3064,17357
1240,13,0,19,6,50342640,3597,42901320,3061,17370
1241,4,0,15,10,50365140,3597,42901320,3061,17374
1242,8,0,16,9,50402220,3598,42901320,3059,17382
1243,7,0,13,12,50434920,3598,42901320,3057,17389
1244,5,0,12,13,50459820,3598,42901320,3056,17394
1245,4,0,10,15,50481480,3598,42901320,3055,17398
1246,3,0,9,16,50499000,3598,42901320,3055,17401
1247,4,0,9,16,50506560,3598,42901320,3054,17405
1248,1,0,10,15,50506560,3598,42901320,3054,17406
1249,4,0,10,15,50520900,3598,42901320,3053,17410
1250,6,0,10,15,50533740,3597,42901320,3051,17416
1251,7,0,13,12,50540880,3596,42901320,3050,17423
1252,8,0,14,11,50567400,3597,42901320,3048,17431
1253,7,0,13,12,50590200,3596,42901320,3047,17438
1254,6,0,12,13,50617260,3596,42901320,3045,17444
1255,9,0,17,8,50636160,3597,42901320,3043,17453
1256,6,0,16,9,50658900,3596,42901320,3042,17459
1257,8,0,12,13,50699760,3596,42901320,3040,17467
1258,8,0,12,13,50719500,3596,42901320,3039,17475
1259,17,0,20,5,50737200,3595,42901320,3035,17492
1260,14,0,22,3,50775660,3594,42901320,3032,17506
1261,7,0,16,9,50829120,3595,42901320,3031,17513
1262,11,0,17,8,50872140,3595,42901320,3028,17524
1263,5,0,15,10,50899740,3595,42901320,3027,17529
1264,5,0,13,12,50945220,3597,42901320,3026,17534
1265,10,0,18,7,50959500,3597,42901320,3024,17544
1266,12,0,16,9,51009000,3596,42901320,3021,17556
1267,8,0,19,6,51029220,3597,42901320,3020,17564
1268,7,0,16,9,51067020,3597,42901320,3018,17571
1269,11,0,17,8,51115260,3598,42901320,3016,17582
1270,6,0,15,10,51135300,3597,42901320,3015,17588
1271,7,0,15,10,51166500,3597,42901320,3013,17595
1272,2,0,10,15,51195360,3598,42901320,3013,17597
1273,3,0,11,14,51205200,3598,42901320,3012,17600
1274,4,0,11,14,51225840,3598,42901320,3011,17604
1275,7,0,14,11,51232860,3598,42901320,3010,17611
1276,6,0,13,12,51248100,3597,42901320,3008,17617
1277,3,0,10,15,51279960,3598,42901320,3008,17620
1278,9,0,18,7,51280800,3598,42901320,3006,17629
1279,6,0,12,13,51328560,3598,42901320,3005,17635
1280,7,0,12,13,51347520,3598,42901320,3003,17642
1281,9,0,13,12,51369600,3597,42901320,3001,17651
1282,15,0,17,8,51395520,3596,42901320,2998,17666
1283,9,0,18,7,51421680,3596,42901320,2996,17675
1284,13,0,17,8,51470940,3596,42901320,2994,17688
1285,7,0,18,7,51487440,3595,42901320,2992,17695
1286,8,0,17,8,51532080,3596,42901560,2990,17703
1287,13,0,18,7,51560220,3595,42901560,2988,17716
1288,13,0,19,6,51619260,3596,42901560,2985,17729
1289,8,0,16,9,51650700,3596,42901560,2983,17737
1290,11,0,17,8,51686940,3596,42901560,2981,17748
1291,7,0,16,9,51721440,3596,42901560,2980,17755
1292,7,0,17,8,51752400,3597,42901560,2978,17762
1293,11,0,19,6,51776760,3596,42901560,2976,17773
1294,4,0,13,12,51817920,3597,42901560,2975,17777
1295,7,0,11,14,51860460,3597,42901560,2974,17784
1296,4,0,11,14,51876180,3598,42901560,2973,17788
1297,5,0,13,12,51885420,3597,42901560,2972,17793
1298,6,0,10,15,51910440,3597,42901560,2971,17799
1299,4,0,11,14,51920160,3597,42901560,2970,17803
1300,6,0,13,12,51936600,3597,42901560,2968,17809
1301,4,0,14,11,51947100,3597,42901560,2968,17813
1302,8,0,14,11,51971460,3597,42901560,2966,17821
1303,10,0,17,8,51998160,3597,42901560,2964,17831
1304,10,0,21,4,52026960,3597,42901560,2962,17841
1305,9,0,17,8,52077120,3597,42901560,2960,17850
1306,4,0,11,14,52123020,3598,42901560,2959,17854
1307,8,0,12,13,52143300,3598,42901560,2958,17862
1308,11,0,18,7,52159680,3598,42901560,2955,17873
1309,10,0,17,8,52190940,3597,42901560,2953,17883
1310,8,0,11,14,52239360,3597,42901560,2952,17891
1311,13,0,15,10,52257600,3596,42901560,2949,17904
1312,8,0,12,13,52297980,3596,42901560,2947,17912
1313,9,0,17,8,52307820,3596,42901560,2946,17921
1314,10,0,14,11,52344480,3595,42901560,2944,17931
1315,9,0,14,11,52377000,3595,42901560,2942,17940
1316,5,0,12,13,52404360,3595,42901560,2941,17945
1317,12,0,16,9,52425540,3595,42901560,2938,17957
1318,5,0,14,11,52456800,3595,42901560,2937,17962
1319,7,0,16,9,52484760,3596,42901560,2936,17969
1320,4,0,13,12,52513200,3596,42901560,2935,17973
1321,6,0,16,9,52529040,3596,42901560,2934,17979
1322,2,0,12,13,52552500,3597,42901560,2934,17981
1323,4,0,10,15,52587240,3597,42901560,2933,17985
1324,3,0,10,15,52593060,3597,42901560,2932,17988
1325,7,0,12,13,52602000,3596,42901560,2931,17995
1326,6,0,14,11,52612680,3596,42901560,2930,18001
1327,3,0,10,15,52641540,3596,42901560,2929,18004
1328,11,0,12,13,52663140,3596,42901560,2927,18015
1329,7,0,15,10,52682100,3596,42901560,2925,18022
1330,12,0,20,5,52703520,3596,42901560,2923,18034
1331,12,0,23,2,52742340,3596,42901560,2921,18046
1332,14,0,19,6,52796580,3596,42901560,2918,18060
1333,9,0,22,3,52821840,3596,42901560,2916,18069
1334,10,0,18,7,52883460,3597,42901560,2914,18079
1335,4,0,14,11,52916460,3597,42901560,2913,18083
1336,9,0,14,11,52954320,3597,42901560,2911,18092
1337,8,0,18,7,52969260,3597,42901560,2910,18100
1338,4,0,11,14,53012280,3597,42901560,2909,18104
1339,9,0,15,10,53026500,3597,42901560,2907,18113
1340,8,0,17,8,53054640,3598,42901560,2906,18121
1341,3,0,12,13,53084940,3598,42901560,2905,18124
1342,7,0,14,11,53106960,3598,42901560,2904,18131
1343,4,0,10,15,53132820,3598,42901560,2903,18135
1344,5,0,11,14,53152680,3598,42901560,2902,18140
1345,2,0,13,12,53152680,3598,42901560,2902,18142
1346,2,0,12,13,53156760,3598,42901560,2901,18144
1347,8,0,15,10,53171640,3598,42901560,2900,18152
1348,5,0,19,6,53172420,3597,42901560,2899,18157
1349,13,0,21,4,53210340,3597,42901560,2896,18170
1350,6,0,17,8,53250720,3598,42901560,2895,18176
1351,3,0,11,14,53291220,3598,42901560,2894,18179
1352,6,0,16,9,53293140,3598,42901560,2893,18185
1353,8,0,18,7,53308200,3598,42901560,2892,18193
1354,9,0,22,3,53334000,3598,42904740,2890,18202
1355,3,0,14,11,53378640,3598,42904740,2889,18205
1356,13,0,17,8,53406300,3598,42904740,2887,18218
1357,9,0,20,5,53418000,3597,42904740,2885,18227
1358,7,0,18,7,53453340,3597,42904740,2884,18234
1359,5,0,17,8,53488500,3598,42904740,2883,18239
1360,9,0,15,10,53521440,3598,42904740,2881,18248
1361,11,0,22,3,53529060,3597,42904740,2879,18259
1362,9,0,22,3,53559840,3597,42904740,2877,18268
1363,7,0,19,6,53601960,3598,42904740,2876,18275
1364,2,0,14,11,53643060,3599,42904740,2876,18277
1365,1,0,12,13,53663580,3599,42904740,2875,18278
1366,5,0,15,10,53665200,3599,42904740,2874,18283
1367,6,0,13,12,53689980,3599,42904740,2873,18289
1368,3,0,13,12,53703960,3599,42904740,2873,18292
1369,5,0,15,10,53709720,3599,42904740,2872,18297
1370,4,0,15,10,53723040,3599,42904740,2871,18301
1371,5,0,12,13,53746260,3598,42904740,2870,18306
1372,7,0,17,8,53748420,3598,42904740,2869,18313
1373,8,0,20,5,53763840,3598,42904740,2867,18321
1374,8,0,20,5,53798760,3598,42904740,2866,18329
1375,3,0,17,8,53827980,3599,42904740,2865,18332
1376,12,0,18,7,53874360,3599,42904740,2863,18344
1377,8,0,18,7,53891520,3598,42904740,2861,18352
1378,7,0,19,6,53919960,3599,42904740,2860,18359
1379,10,0,18,7,53956080,3598,42904740,2858,18369
1380,10,0,18,7,53997360,3599,42904740,2856,18379
1381,17,0,25,0,54022020,3598,42904740,2853,18396
1382,16,6,25,0,54052920,3598,42908700,2850,18412
1383,8,2,25,0,54107700,3599,42930480,2850,18420
1384,7,0,20,5,54159720,3599,42939900,2849,18427
1385,13,0,19,6,54203820,3598,42939900,2847,18440
1386,9,0,19,6,54238020,3598,42939900,2845,18449
1387,10,0,22,3,54272520,3599,42939900,2843,18459
1388,5,0,18,7,54315960,3600,42939900,2842,18464
1389,6,0,18,7,54343140,3600,42939900,2841,18470
1390,5,0,17,8,54361020,3600,42939900,2840,18475
1391,11,0,20,5,54391620,3600,42939900,2838,18486
1392,4,0,13,12,54437760,3600,42939900,2837,18490
1393,6,0,16,9,54448020,3600,42939900,2836,18496
1394,7,0,16,9,54468780,3600,42939900,2835,18503
1395,2,0,13,12,54486300,3600,42939900,2835,18505
1396,1,0,13,12,54489900,3600,42939900,2834,18506
1397,7,0,16,9,54512040,3601,42939900,2833,18513
1398,17,0,24,1,54530220,3600,42939900,2830,18530
1399,6,0,19,6,54571560,3600,42940320,2829,18536
1400,12,0,21,4,54611700,3600,42940320,2827,18548
1401,13,0,24,1,54640320,3599,42940320,2824,18561
1402,13,0,21,4,54713580,3600,42942600,2822,18574
1403,13,0,20,5,54746100,3599,42942600,2819,18587
1404,17,0,23,2,54790380,3599,42943320,2816,18604
1405,12,0,24,1,54837120,3599,42944400,2814,18616
1406,4,0,18,7,54877740,3600,42944400,2813,18620
1407,13,0,20,5,54919320,3600,42944400,2811,18633
1408,7,0,17,8,54959520,3600,42944400,2810,18640
1409,9,0,19,6,54975300,3599,42944400,2808,18649
1410,8,0,18,7,55019640,3600,42944400,2807,18657
1411,8,0,17,8,55047960,3600,42944400,2805,18665
1412,5,0,19,6,55060260,3600,42944400,2804,18670
1413,7,0,18,7,55097880,3601,42944400,2803,18677
1414,7,0,16,9,55130400,3601,42944400,2802,18684
1415,7,0,19,6,55141380,3600,42944400,2800,18691
1416,9,0,17,8,55177320,3600,42944400,2799,18700
1417,9,0,22,3,55199040,3601,42944400,2797,18709
1418,9,0,19,6,55250220,3601,42944400,2796,18718
1419,13,0,23,2,55278000,3601,42944400,2793,18731
1420,5,0,18,7,55311780,3601,42944400,2792,18736
1421,12,0,21,4,55360680,3602,42944400,2790,18748
1422,5,0,19,6,55387440,3602,42944400,2789,18753
1423,6,0,16,9,55429560,3603,42944400,2788,18759
1424,6,0,17,8,55454040,3603,42944400,2787,18765
1425,5,0,18,7,55479540,3604,42944400,2786,18770
1426,14,0,23,2,55508700,3603,42944400,2784,18784
1427,10,0,21,4,55546560,3603,42944760,2782,18794
1428,11,0,24,1,55576020,3603,42944760,2780,18805
1429,14,2,25,0,55629840,3604,42948900,2778,18819
1430,7,0,23,2,55682100,3605,42951840,2776,18826
1431,15,1,25,0,55738020,3606,42952080,2774,18841
1432,12,1,23,2,55784880,3606,42953400,2772,18853
1433,7,0,20,5,55830480,3606,42956220,2771,18860
1434,9,0,20,5,55869900,3606,42956220,2769,18869
1435,9,0,19,6,55913400,3607,42956220,2767,18878
1436,8,0,18,7,55952280,3607,42956220,2766,18886
1437,6,0,18,7,55984440,3608,42956220,2765,18892
1438,9,0,17,8,56014380,3608,42956220,2763,18901
1439,3,0,13,12,56040300,3608,42956220,2763,18904
1440,4,0,12,13,56060340,3608,42956220,2762,18908
1441,6,0,14,11,56064600,3607,42956220,2761,18914
1442,7,0,16,9,56076060,3607,42956220,2760,18921
1443,4,0,16,9,56083560,3606,42956220,2759,18925
1444,4,0,14,11,56117880,3607,42956220,2758,18929
1445,7,0,16,9,56124960,3606,42956220,2757,18936
1446,7,0,16,9,56142660,3606,42956220,2756,18943
1447,7,0,18,7,56161140,3606,42956220,2755,18950
1448,8,0,15,10,56194320,3605,42956220,2753,18958
1449,5,0,14,11,56214060,3605,42956220,2752,18963
1450,10,0,20,5,56221080,3605,42956220,2751,18973
1451,11,0,22,3,56251320,3605,42956220,2749,18984
1452,6,0,19,6,56289660,3605,42956220,2748,18990
1453,14,0,24,1,56325120,3605,42956220,2745,19004
1454,10,0,24,1,56353080,3605,42958020,2744,19014
1455,13,0,21,4,56418420,3605,42958020,2741,19027
1456,10,0,18,7,56456100,3605,42958020,2740,19037
1457,12,0,20,5,56498280,3605,42958020,2737,19049
1458,10,0,24,1,56513160,3605,42958020,2736,19059
1459,6,0,17,8,56566440,3605,42958020,2735,19065
1460,8,0,19,6,56586900,3605,42958020,2733,19073
1461,10,0,18,7,56625240,3605,42958020,2732,19083
1462,6,0,16,9,56651340,3605,42958020,2730,19089
1463,2,0,11,14,56681280,3605,42958020,2730,19091
1464,2,0,11,14,56685180,3605,42958020,2730,19093
1465,7,0,16,9,56688060,3604,42958020,2729,19100
1466,4,0,16,9,56704020,3605,42958020,2728,19104
1467,6,0,15,10,56723760,3604,42958020,2727,19110
1468,9,0,15,10,56770680,3605,42958020,2725,19119
1469,7,0,18,7,56777220,3605,42958020,2724,19126
1470,9,0,18,7,56810040,3605,42958020,2722,19135
1471,10,0,17,8,56838180,3604,42958020,2721,19145
1472,9,0,18,7,56860260,3603,42958020,2719,19154
1473,10,0,18,7,56890260,3603,42958020,2718,19164
1474,11,0,21,4,56922900,3603,42958020,2716,19175
1475,6,0,16,9,56951940,3603,42958020,2715,19181
1476,17,0,23,2,56980140,3602,42958020,2712,19198
1477,9,0,23,2,57019620,3603,42958020,2710,19207
1478,11,0,19,6,57062640,3602,42958380,2708,19218
1479,10,0,20,5,57100140,3602,42958380,2707,19228
1480,10,0,20,5,57127980,3602,42958380,2705,19238
1481,6,0,18,7,57164760,3602,42958380,2704,19244
1482,5,0,17,8,57202200,3603,42958380,2703,19249
1483,10,0,18,7,57238740,3604,42958380,2701,19259
1484,7,0,17,8,57268140,3604,42958380,2700,19266
1485,2,0,17,8,57272400,3603,42958380,2700,19268
1486,11,0,20,5,57313260,3604,42958380,2698,19279
1487,3,0,14,11,57340260,3604,42958380,2697,19282
1488,6,0,14,11,57365640,3604,42958380,2696,19288
1489,6,0,16,9,57373860,3604,42958380,2695,19294
1490,5,0,16,9,57393600,3604,42958380,2695,19299
1491,6,0,14,11,57418980,3604,42958380,2693,19305
1492,8,0,19,6,57433320,3604,42958380,2692,19313
1493,5,0,19,6,57453000,3604,42958380,2691,19318
1494,9,0,17,8,57483060,3603,42958380,2690,19327
1495,10,0,18,7,57511440,3603,42958380,2688,19337
1496,11,0,21,4,57532140,3602,42958380,2686,19348
1497,8,0,15,10,57579300,3602,42958380,2685,19356
1498,6,0,15,10,57590760,3602,42958380,2684,19362
1499,15,0,24,1,57615840,3602,42958380,2681,19377
1500,7,0,24,1,57643620,3602,42958380,2680,19384
1501,12,2,25,0,57687120,3603,42961020,2679,19396
1502,6,0,20,5,57750240,3604,42963420,2678,19402
1503,14,0,19,6,57805440,3604,42963420,2675,19416
1504,10,0,20,5,57826500,3603,42963420,2674,19426
1505,8,0,23,2,57847560,3603,42963420,2672,19434
1506,10,0,18,7,57908940,3604,42963420,2671,19444
1507,8,0,19,6,57934440,3604,42963420,2669,19452
1508,2,0,14,11,57961860,3604,42963420,2669,19454
1509,5,0,17,8,57979440,3605,42963420,2668,19459
1510,4,0,14,11,58008900,3605,42963420,2667,19463
1511,5,0,15,10,58022940,3605,42963420,2667,19468
1512,8,0,15,10,58046100,3604,42963420,2665,19476
1513,3,0,15,10,58056540,3604,42963420,2665,19479
1514,5,0,14,11,58075200,3604,42963420,2664,19484
1515,3,0,11,14,58098420,3604,42963420,2663,19487
1516,6,0,14,11,58106100,3604,42963420,2662,19493
1517,12,0,18,7,58124280,3603,42963420,2660,19505
1518,5,0,15,10,58139700,3603,42963420,2660,19510
1519,5,0,14,11,58162740,3603,42963420,2659,19515
1520,10,0,17,8,58181340,3602,42963420,2657,19525
1521,8,0,17,8,58200960,3602,42963420,2656,19533
1522,8,0,17,8,58232760,3602,42963420,2655,19541
1523,11,0,22,3,58246680,3601,42963420,2653,19552
1524,11,5,19,6,58278240,3601,42964560,2651,19563
1525,11,0,22,3,58334760,3602,42982200,2650,19574
1526,16,3,25,0,58374180,3602,42983460,2648,19590
1527,10,2,25,0,58430400,3603,42993180,2647,19600
1528,6,0,17,8,58497480,3604,43000980,2646,19606
1529,17,0,23,2,58535640,3604,43001460,2643,19623
1530,6,0,18,7,58560660,3603,43001460,2642,19629
1531,7,0,14,11,58599360,3603,43001460,2641,19636
1532,4,0,16,9,58603980,3603,43001460,2641,19640
1533,5,0,17,8,58632120,3603,43001460,2640,19645
1534,5,0,16,9,58653420,3603,43001460,2639,19650
1535,6,0,17,8,58669140,3603,43001460,2638,19656
1536,6,0,18,7,58684560,3603,43001460,2637,19662
1537,3,0,15,10,58718160,3604,43001460,2637,19665
1538,5,0,16,9,58733520,3604,43001460,2636,19670
1539,6,0,15,10,58767540,3604,43001460,2635,19676
1540,8,0,16,9,58785180,3604,43001460,2634,19684
1541,5,0,18,7,58799220,3604,43001460,2633,19689
1542,6,0,17,8,58817400,3604,43001460,2632,19695
1543,10,0,18,7,58857720,3604,43001460,2630,19705
1544,6,0,17,8,58875840,3604,43001460,2629,19711
1545,15,0,21,4,58902360,3603,43001460,2627,19726
1546,13,0,19,6,58951560,3603,43001460,2625,19739
1547,9,0,20,5,58984680,3603,43001460,2623,19748
1548,9,0,23,2,59005980,3603,43001460,2622,19757
1549,15,0,19,6,59063940,3602,43001520,2619,19772
1550,8,0,20,5,59102340,3603,43001520,2618,19780
1551,10,0,21,4,59129040,3603,43001520,2617,19790
1552,14,0,22,3,59169120,3602,43001520,2614,19804
1553,5,0,20,5,59187120,3602,43001520,2614,19809
1554,20,3,25,0,59241660,3603,43002720,2611,19829
1555,7,0,21,4,59293500,3603,43009500,2610,19836
1556,7,0,16,9,59349900,3603,43009500,2609,19843
1557,5,0,15,10,59368860,3603,43009500,2608,19848
1558,7,0,18,7,59389500,3604,43009500,2607,19855
1559,10,0,21,4,59414160,3604,43009500,2605,19865
1560,7,0,19,6,59449260,3604,43009500,2604,19872
1561,5,0,14,11,59490720,3604,43009500,2603,19877
1562,4,0,15,10,59501100,3604,43009500,2603,19881
1563,2,0,14,11,59507520,3604,43009500,2602,19883
1564,9,0,15,10,59532120,3604,43009500,2601,19892
1565,6,0,18,7,59540040,3603,43009500,2600,19898
1566,14,0,22,3,59570040,3603,43012320,2598,19912
1567,11,0,19,6,59628120,3603,43012320,2596,19923
1568,10,0,18,7,59662860,3603,43012320,2595,19933
1569,10,0,25,0,59672760,3603,43012320,2593,19943
1570,13,0,23,2,59730600,3603,43012860,2591,19956
1571,9,0,18,7,59776200,3603,43012920,2590,19965
1572,9,0,21,4,59807280,3604,43012920,2588,19974
1573,11,0,21,4,59845500,3604,43012920,2587,19985
1574,8,0,21,4,59872560,3603,43012920,2585,19993
1575,14,0,22,3,59923980,3604,43012920,2583,20007
1576,8,0,20,5,59961600,3604,43012920,2582,20015
1577,14,7,19,6,59989140,3604,43012980,2581,20029
1578,13,15,19,6,60027360,3605,43019820,2578,20042
1579,8,13,25,0,60048180,3605,43054260,2579,20050
1580,9,0,21,4,60141120,3605,43138140,2583,20059
1581,3,0,15,10,60160560,3605,43138140,2582,20062
1582,3,0,14,11,60172320,3604,43138140,2582,20065
1583,4,0,13,12,60197580,3605,43138140,2581,20069
1584,7,0,16,9,60210780,3605,43138140,2580,20076
1585,4,0,15,10,60222960,3604,43138140,2579,20080
1586,4,0,15,10,60242640,3605,43138140,2579,20084
1587,7,0,14,11,60268380,3604,43138140,2578,20091
1588,2,0,12,13,60286800,3605,43138140,2577,20093
1589,8,0,13,12,60296100,3604,43138140,2576,20101
1590,10,0,18,7,60310140,3604,43138140,2575,20111
1591,3,0,14,11,60338100,3604,43138140,2574,20114
1592,11,0,23,2,60343500,3604,43138140,2572,20125
1593,15,4,25,0,60384420,3604,43138500,2570,20140
1594,8,0,20,5,60430440,3603,43140420,2569,20148
1595,7,0,18,7,60480000,3604,43140420,2568,20155
1596,9,0,17,8,60512940,3604,43140420,2567,20164
1597,13,0,22,3,60536880,3604,43140420,2565,20177
1598,6,0,21,4,60559200,3604,43140420,2564,20183
1599,12,1,25,0,60594360,3604,43140420,2562,20195
1600,10,0,18,7,60664620,3604,43141620,2560,20205
1601,5,0,15,10,60700860,3605,43141620,2560,20210
1602,7,0,16,9,60729420,3605,43141620,2559,20217
1603,11,0,20,5,60749160,3605,43141620,2557,20228
1604,9,0,24,1,60771300,3605,43141620,2556,20237
1605,7,0,16,9,60833760,3606,43141620,2555,20244
1606,6,0,17,8,60858780,3606,43141620,2554,20250
1607,11,8,19,6,60861660,3606,43144380,2552,20261
1608,6,6,22,3,60902460,3607,43161660,2552,20267
1609,4,0,20,5,60953640,3608,43195860,2554,20271
1610,5,0,17,8,60987780,3608,43195860,2553,20276
1611,8,0,18,7,61006740,3608,43195860,2552,20284
1612,7,0,14,11,61050420,3608,43195860,2551,20291
1613,5,0,16,9,61063320,3608,43195860,2550,20296
1614,7,0,18,7,61085160,3608,43195860,2549,20303
1615,8,0,18,7,61120200,3609,43195860,2548,20311
1616,7,0,19,6,61138080,3609,43195860,2547,20318
1617,10,0,19,6,61179720,3609,43195860,2545,20328
1618,11,0,20,5,61204140,3608,43195860,2543,20339
1619,11,0,24,1,61220400,3608,43195860,2542,20350
1620,6,0,20,5,61264020,3608,43195860,2541,20356
1621,6,0,16,9,61314780,3609,43195860,2540,20362
1622,13,0,17,8,61356780,3609,43195860,2538,20375
1623,8,0,17,8,61376040,3608,43195860,2537,20383
1624,13,0,22,3,61398360,3608,43195860,2535,20396
1625,4,0,16,9,61439160,3608,43195860,2534,20400
1626,5,0,14,11,61469520,3609,43195860,2534,20405
1627,4,0,15,10,61474080,3608,43195860,2533,20409
1628,10,0,18,7,61499040,3608,43195860,2531,20419
1629,12,0,22,3,61520100,3608,43195860,2530,20431
1630,3,0,18,7,61552020,3608,43195860,2529,20434
1631,7,0,18,7,61585200,3609,43195860,2528,20441
1632,8,0,15,10,61620060,3608,43195860,2527,20449
1633,3,0,16,9,61630980,3609,43195860,2527,20452
1634,7,0,15,10,61662420,3609,43195860,2526,20459
1635,8,0,19,6,61670640,3608,43195860,2524,20467
1636,4,0,15,10,61699680,3608,43195860,2524,20471
1637,9,0,19,6,61712280,3608,43195860,2522,20480
1638,6,0,18,7,61743300,3608,43195860,2522,20486
1639,10,0,19,6,61775040,3608,43195860,2520,20496
1640,7,0,16,9,61811820,3608,43195860,2519,20503
1641,16,0,22,3,61835400,3608,43195860,2517,20519
1642,10,0,18,7,61873680,3607,43195860,2515,20529
1643,9,0,18,7,61899660,3606,43195860,2514,20538
1644,10,0,23,2,61918080,3607,43195860,2512,20548
1645,13,0,23,2,61965540,3607,43195860,2511,20561
1646,13,0,20,5,62019720,3606,43195920,2509,20574
1647,12,0,22,3,62047740,3606,43195980,2507,20586
1648,8,0,19,6,62090640,3606,43196160,2506,20594
1649,13,0,19,6,62143980,3606,43196160,2504,20607
1650,6,0,17,8,62170080,3606,43196160,2503,20613
1651,10,0,15,10,62202960,3606,43196160,2502,20623
1652,5,0,16,9,62222700,3606,43196160,2501,20628
1653,6,0,12,13,62261340,3606,43196160,2500,20634
1654,4,0,14,11,62267280,3606,43196160,2499,20638
1655,8,0,21,4,62269260,3606,43196160,2498,20646
1656,4,0,17,8,62299560,3606,43196160,2498,20650
1657,7,0,22,3,62305560,3606,43196160,2497,20657
1658,6,0,18,7,62362860,3607,43196160,2496,20663
1659,1,0,15,10,62377320,3607,43196160,2496,20664
1660,6,0,17,8,62409300,3608,43196160,2495,20670
1661,7,0,17,8,62434080,3608,43196160,2494,20677
1662,11,0,21,4,62449380,3608,43196160,2492,20688
1663,9,0,18,7,62492340,3608,43196160,2491,20697
1664,22,6,25,0,62528040,3608,43197540,2488,20719
1665,12,10,25,0,62561220,3608,43204080,2487,20731
1666,9,0,22,3,62636520,3608,43248180,2488,20740
1667,9,0,17,8,62682300,3608,43248180,2486,20749
1668,10,0,18,7,62715720,3608,43248180,2485,20759
1669,13,0,20,5,62745360,3607,43248180,2483,20772
1670,11,0,20,5,62778240,3607,43248180,2482,20783
1671,9,0,20,5,62802840,3606,43248180,2480,20792
1672,7,0,18,7,62835600,3606,43248180,2479,20799
1673,13,0,20,5,62894880,3607,43248180,2477,20812
1674,6,0,21,4,62907360,3607,43248180,2477,20818
1675,4,0,16,9,62960580,3608,43248180,2476,20822
1676,10,0,18,7,62979300,3608,43248180,2475,20832
1677,4,0,14,11,63008460,3608,43248180,2474,20836
1678,6,0,14,11,63023340,3607,43248180,2473,20842
1679,3,0,12,13,63049020,3608,43248180,2473,20845
1680,2,0,12,13,63057300,3608,43248180,2473,20847
1681,5,0,16,9,63058200,3608,43248180,2472,20852
1682,18,5,25,0,63070860,3607,43248420,2470,20870
1683,23,16,22,3,63117480,3607,43256760,2467,20893
1684,28,33,24,1,63165420,3608,43269420,2464,20921
1685,26,40,23,2,63186720,3609,43275000,2463,20947
1686,31,40,19,6,63251220,3610,43301580,2463,20978
1687,27,40,25,0,63284880,3611,43361640,2465,21005
1688,34,40,25,0,63315540,3612,43374060,2465,21039
1689,34,40,25,0,63376860,3613,43472460,2469,21073
1690,37,40,25,0,63444660,3614,43589700,2474,21110
1691,33,40,25,0,63505380,3614,43703760,2478,21143
1692,32,40,25,0,63554580,3614,43817160,2482,21175
1693,24,38,25,0,63598680,3614,43829280,2481,21199
1694,32,39,25,0,63662040,3613,43892700,2482,21231
1695,43,40,25,0,63725520,3613,43917660,2481,21274
1696,39,40,25,0,63770160,3612,43927680,2479,21313
1697,30,40,25,0,63825540,3611,43970880,2479,21343
1698,26,37,25,0,63856620,3612,44073960,2484,21369
1699,34,40,22,3,63922800,3612,44106840,2483,21403
1700,28,39,25,0,63951000,3612,44125560,2483,21431
1701,36,40,25,0,64006980,3613,44168280,2484,21467
1702,30,40,25,0,64049220,3612,44207160,2484,21497
1703,37,40,25,0,64100580,3613,44235240,2484,21534
1704,44,40,25,0,64162260,3614,44245680,2483,21578
1705,25,40,25,0,64218360,3614,44278500,2482,21603
1706,32,40,25,0,64262520,3614,44380740,2487,21635
1707,41,40,25,0,64312140,3613,44416860,2486,21676
1708,35,40,25,0,64368660,3614,44454840,2487,21711
1709,37,40,25,0,64428180,3614,44490240,2486,21748
1710,33,39,25,0,64459920,3614,44494980,2486,21781
1711,31,40,25,0,64522800,3615,44513340,2485,21812
1712,25,39,25,0,64601460,3615,44576220,2486,21837
1713,28,40,25,0,64629180,3616,44580720,2485,21865
1714,25,33,25,0,64711140,3616,44937900,2503,21890
1715,25,38,25,0,64762620,3616,44946540,2500,21915
1716,33,39,25,0,64799340,3615,44972940,2500,21948
1717,25,38,25,0,64872780,3615,45030180,2500,21973
1718,35,39,23,2,64898220,3615,45039420,2500,22008
1719,35,40,25,0,64956060,3614,45334200,2513,22043
1720,29,40,25,0,64999500,3615,45342660,2513,22072
1721,32,39,25,0,65067420,3616,45467100,2518,22104
1722,28,37,25,0,65113380,3615,45503820,2518,22132
1723,34,40,25,0,65187480,3615,45655440,2523,22166
1724,31,40,25,0,65222280,3615,45669840,2523,22197
1725,42,40,25,0,65277540,3615,45721500,2523,22239
1726,30,36,25,0,65351880,3615,45802680,2525,22269
1727,41,40,25,0,65396940,3614,45815340,2523,22310
1728,37,37,25,0,65462760,3614,45911940,2526,22347
1729,25,39,25,0,65505360,3613,45919920,2524,22372
1730,33,40,25,0,65553060,3611,45966120,2523,22405
1731,31,40,25,0,65592900,3612,45972540,2523,22436
1732,25,39,23,2,65670600,3613,46019580,2523,22461
1733,39,40,19,6,65697540,3613,46026840,2523,22500
1734,34,40,19,6,65744640,3614,46034760,2522,22534
1735,30,40,25,0,65766600,3614,46129260,2526,22564
1736,31,38,25,0,65825100,3614,46146060,2525,22595
1737,34,38,25,0,65879160,3614,46207500,2526,22629
1738,39,40,25,0,65926260,3614,46214400,2524,22668
1739,25,40,25,0,65972940,3614,46273680,2526,22693
1740,26,40,25,0,66047160,3616,46281540,2525,22719
1741,29,39,25,0,66089340,3616,46348680,2527,22748
1742,33,40,20,5,66146820,3616,46392060,2528,22781
1743,38,40,25,0,66168720,3616,46399020,2527,22819
1744,35,40,25,0,66219780,3617,46479420,2530,22854
1745,32,40,25,0,66294600,3617,46606980,2534,22886
1746,29,39,25,0,66354720,3617,46647660,2534,22915
1747,29,40,25,0,66391860,3617,46659600,2533,22944
1748,40,39,25,0,66432720,3617,46662600,2532,22984
1749,26,39,25,0,66499080,3618,46784160,2536,23010
1750,26,40,25,0,66556980,3617,46863420,2538,23036
1751,33,40,25,0,66617460,3617,46889640,2537,23069
1752,30,39,25,0,66672420,3617,46985700,2540,23099
1753,21,38,25,0,66723240,3617,46996080,2539,23120
1754,30,39,25,0,66779280,3616,47059440,2539,23150
1755,28,40,25,0,66829620,3616,47113740,2541,23178
1756,40,39,25,0,66874140,3616,47135400,2540,23218
1757,26,38,25,0,66932340,3617,47161740,2540,23244
1758,32,40,25,0,66999060,3617,47186280,2539,23276
1759,26,40,25,0,67042140,3618,47211840,2539,23302
1760,37,39,25,0,67101840,3618,47233680,2538,23339
1761,22,38,25,0,67160280,3618,47284260,2539,23361
1762,44,40,21,4,67195920,3618,47317740,2540,23405
1763,35,40,25,0,67238280,3619,47373600,2541,23440
1764,38,40,25,0,67318260,3620,47390400,2540,23478
1765,34,40,24,1,67360080,3620,47445840,2541,23512
1766,37,38,25,0,67398780,3620,47462160,2541,23549
1767,33,40,25,0,67477560,3621,48051720,2569,23582
1768,34,40,25,0,67508700,3621,48060540,2569,23616
1769,25,38,21,4,67572300,3622,48078900,2569,23641
1770,32,40,25,0,67616520,3621,48126780,2569,23673
1771,23,37,25,0,67682100,3621,48206880,2571,23696
1772,38,40,25,0,67720680,3621,48226320,2570,23734
1773,30,34,25,0,67793760,3620,49169280,2617,23764
1774,35,39,25,0,67834200,3620,49176540,2615,23799
1775,36,40,25,0,67875600,3621,49198500,2615,23835
1776,33,40,23,2,67934340,3622,49200600,2614,23868
1777,33,40,25,0,67987080,3622,49235340,2614,23901
1778,32,40,25,0,68043780,3623,49249440,2613,23933
1779,37,37,25,0,68094360,3624,49326420,2616,23970
1780,30,40,25,0,68150400,3623,49436880,2619,24000
1781,38,39,25,0,68201640,3624,49443660,2618,24038
1782,22,38,25,0,68262840,3624,49556340,2622,24060
1783,28,39,25,0,68316540,3624,49605480,2622,24088
1784,36,40,25,0,68361660,3623,49629240,2622,24124
1785,33,35,25,0,68433360,3623,50110440,2645,24157
1786,35,39,25,0,68480400,3623,50117340,2642,24192
1787,32,40,25,0,68523420,3622,50206140,2645,24224
1788,26,40,25,0,68570940,3623,50216040,2644,24250
1789,31,40,25,0,68644680,3624,50238540,2643,24281
1790,32,39,25,0,68694840,3625,50244600,2642,24313
1791,33,40,25,0,68752980,3624,50342580,2645,24346
1792,36,40,25,0,68796240,3624,50391120,2646,24382
1793,40,40,25,0,68842140,3624,50396340,2644,24422
1794,41,40,25,0,68910000,3624,50425140,2643,24463
1795,38,40,25,0,68967420,3624,50512440,2645,24501
1796,34,39,25,0,69023160,3624,50522040,2643,24535
1797,28,39,25,0,69049680,3624,50584080,2646,24563
1798,36,38,25,0,69132720,3623,50617440,2644,24599
1799,39,40,25,0,69177180,3623,50622900,2643,24638
1800,34,40,25,0,69231240,3623,50711160,2645,24672
1801,26,40,24,1,69272040,3623,50747400,2646,24698
1802,25,37,21,4,69317400,3624,50765460,2646,24723
1803,27,37,25,0,69385920,3623,51552240,2684,24750
1804,29,40,22,3,69417720,3623,51557760,2683,24779
1805,27,39,25,0,69460140,3624,51584580,2682,24806
1806,34,40,25,0,69542160,3625,51610080,2682,24840
1807,33,40,25,0,69564900,3626,51618780,2681,24873
1808,33,39,25,0,69633660,3627,51667740,2682,24906
1809,32,40,25,0,69692400,3626,51785760,2685,24938
1810,22,36,25,0,69753540,3625,51871740,2687,24960
1811,28,40,25,0,69804900,3623,53846700,2786,24988
1812,31,40,25,0,69844680,3623,53856300,2784,25019
1813,34,37,25,0,69912780,3624,53880840,2784,25053
1814,30,40,25,0,69952560,3624,53939100,2785,25083
1815,25,40,25,0,70009560,3624,54019200,2787,25108
1816,34,39,25,0,70073520,3624,54046500,2786,25142
1817,29,36,25,0,70133880,3623,54093660,2786,25171
1818,34,36,25,0,70177020,3623,54145920,2787,25205
1819,38,39,23,2,70225260,3624,54159720,2786,25243
1820,36,40,25,0,70269840,3624,54170100,2785,25279
1821,33,40,25,0,70318500,3624,54202680,2784,25312
1822,26,37,25,0,70384740,3624,54286200,2786,25338
1823,27,40,25,0,70436100,3623,54501900,2794,25365
1824,28,40,25,0,70502160,3624,54522780,2793,25393
1825,22,36,25,0,70551360,3623,54550200,2793,25415
1826,32,38,25,0,70617900,3622,54592860,2791,25447
1827,18,39,25,0,70649280,3622,54614220,2791,25465
1828,24,31,25,0,70725720,3620,57156480,2917,25489
1829,30,40,25,0,70756920,3620,57165120,2915,25519
1830,28,40,25,0,70814040,3621,57187560,2914,25547
1831,35,39,25,0,70875960,3622,57207540,2914,25582
1832,35,37,25,0,70932420,3621,57299640,2916,25617
1833,28,40,25,0,70979640,3620,57325080,2914,25645
1834,34,40,24,1,71021160,3620,57351300,2914,25679
1835,30,40,25,0,71080380,3621,57377700,2913,25709
1836,31,39,25,0,71122560,3621,57406140,2913,25740
1837,25,40,23,2,71168940,3621,57414360,2912,25765
1838,29,40,25,0,71212620,3622,57444540,2912,25794
1839,24,40,25,0,71280600,3622,57561900,2916,25818
1840,33,39,25,0,71341500,3623,57573480,2914,25851
1841,41,39,25,0,71387640,3624,57581880,2914,25892
1842,31,40,19,6,71443260,3623,57678540,2917,25923
1843,31,39,25,0,71474220,3624,57851280,2923,25954
1844,37,38,25,0,71538780,3625,57858480,2922,25991
1845,27,39,25,0,71584980,3624,57953880,2924,26018
1846,23,39,24,1,71647920,3624,58037280,2926,26041
1847,23,40,25,0,71691240,3624,58092360,2927,26064
1848,19,39,21,4,71737920,3625,58104300,2927,26083
1849,10,32,25,0,71801160,3626,58290360,2935,26093
1850,8,11,25,0,71864100,3624,63988140,3220,26101
1851,10,0,18,7,71910840,3621,66632220,3352,26111
1852,6,0,16,9,71944620,3621,66632220,3351,26117
1853,6,0,14,11,71967420,3621,66632220,3350,26123
1854,5,0,12,13,71982660,3620,66632220,3349,26128
1855,7,0,17,8,71990280,3620,66632220,3348,26135
1856,10,0,18,7,72005880,3619,66632220,3346,26145
1857,11,0,18,7,72030360,3619,66632220,3344,26156
1858,7,0,20,5,72052560,3619,66632220,3343,26163
1859,12,0,22,3,72096240,3619,66632220,3341,26175
1860,10,0,21,4,72120300,3618,66632220,3339,26185
1861,5,0,18,7,72150000,3618,66632220,3339,26190
1862,17,2,25,0,72188760,3619,66633300,3336,26207
1863,5,0,22,3,72231600,3619,66636780,3335,26212
1864,8,0,16,9,72285660,3619,66636780,3334,26220
1865,11,0,18,7,72331860,3620,66636780,3332,26231
1866,7,0,16,9,72348600,3619,66636780,3331,26238
1867,7,0,12,13,72388620,3619,66636780,3330,26245
1868,7,0,17,8,72392400,3619,66636780,3329,26252
1869,3,0,13,12,72407400,3619,66636780,3328,26255
1870,4,0,13,12,72413040,3618,66636780,3327,26259
1871,4,0,14,11,72424380,3618,66636780,3327,26263
1872,5,0,17,8,72436080,3618,66636780,3326,26268
1873,3,0,14,11,72454140,3618,66636780,3325,26271
1874,4,0,13,12,72475260,3618,66636780,3325,26275
1875,11,0,20,5,72497220,3619,66636780,3323,26286
1876,4,0,15,10,72518940,3618,66636780,3322,26290
1877,9,0,22,3,72528540,3618,66636780,3321,26299
1878,3,0,17,8,72572340,3619,66636780,3320,26302
1879,7,0,16,9,72599100,3619,66636780,3319,26309
1880,7,0,20,5,72609240,3619,66636780,3318,26316
1881,7,0,22,3,72641760,3620,66636780,3317,26323
1882,9,0,22,3,72680940,3620,66636780,3315,26332
1883,6,0,18,7,72720360,3620,66636780,3314,26338
1884,12,0,20,5,72764280,3621,66636780,3312,26350
1885,9,0,19,6,72786540,3620,66636780,3311,26359
1886,12,0,22,3,72817380,3620,66636780,3309,26371
1887,13,0,21,4,72860400,3619,66636780,3307,26384
1888,10,0,19,6,72904440,3619,66636780,3305,26394
1889,11,0,21,4,72928620,3619,66636780,3303,26405
1890,11,0,24,1,72966060,3619,66636780,3301,26416
1891,11,1,24,1,72999720,3619,66637440,3300,26427
1892,6,2,20,5,73040820,3620,66638760,3299,26433
1893,10,7,21,4,73074900,3621,66641940,3297,26443
1894,4,0,19,6,73122240,3621,66663540,3298,26447
1895,12,0,18,7,73179240,3621,66663540,3296,26459
1896,3,0,16,9,73200120,3621,66663540,3295,26462
1897,4,0,14,11,73223640,3621,66663540,3295,26466
1898,2,0,13,12,73241700,3622,66663540,3294,26468
1899,5,0,13,12,73250760,3621,66663540,3293,26473
1900,4,0,12,13,73268340,3621,66663540,3293,26477
1901,7,0,16,9,73272180,3621,66663540,3292,26484
1902,9,0,19,6,73294020,3621,66663540,3290,26493
1903,6,0,13,12,73340040,3621,66663540,3289,26499
1904,12,0,19,6,73349280,3620,66663540,3287,26511
1905,14,0,24,1,73379700,3620,66664200,3285,26525
1906,7,0,17,8,73425060,3620,66664200,3284,26532
1907,6,0,19,6,73443660,3620,66664200,3283,26538
1908,15,0,20,5,73494060,3620,66664200,3281,26553
1909,15,0,23,2,73530840,3620,66667080,3278,26568
1910,11,0,20,5,73586760,3620,66667080,3276,26579
1911,5,0,15,10,73623960,3620,66667080,3276,26584
1912,6,0,19,6,73634700,3620,66667080,3275,26590
1913,10,0,24,1,73652040,3620,66667080,3273,26600
1914,7,0,19,6,73707480,3621,66667080,3272,26607
1915,13,0,22,3,73741740,3621,66667080,3270,26620
1916,8,0,14,11,73779480,3620,66667080,3269,26628
1917,9,0,20,5,73790340,3620,66667080,3267,26637
1918,7,0,16,9,73825860,3620,66667080,3266,26644
1919,6,0,15,10,73845840,3619,66667080,3265,26650
1920,6,0,15,10,73861440,3619,66667080,3264,26656
1921,8,0,18,7,73877040,3619,66667080,3263,26664
1922,6,0,15,10,73913640,3619,66667080,3262,26670
1923,4,0,15,10,73934040,3619,66667080,3261,26674
1924,6,0,14,11,73962600,3620,66667080,3260,26680
1925,4,0,15,10,73976520,3620,66667080,3260,26684
1926,7,0,17,8,73992300,3620,66667080,3259,26691
1927,13,0,19,6,74019480,3619,66667080,3256,26704
1928,8,0,19,6,74042760,3619,66667080,3255,26712
1929,10,0,20,5,74072520,3619,66667080,3254,26722
1930,11,0,17,8,74133780,3619,66667080,3252,26733
1931,13,0,16,9,74167680,3618,66667080,3250,26746
1932,4,0,16,9,74181420,3618,66667080,3249,26750
1933,11,0,22,3,74200200,3618,66667080,3247,26761
1934,6,0,18,7,74241480,3619,66667080,3246,26767
1935,10,0,18,7,74273160,3618,66667080,3245,26777
1936,16,0,19,6,74306160,3617,66667080,3242,26793
1937,16,2,25,0,74330280,3617,66667920,3240,26809
1938,11,6,25,0,74371380,3618,66671340,3238,26820
1939,6,0,21,4,74438640,3618,66690900,3238,26826
1940,8,0,19,6,74470320,3618,66690900,3237,26834
1941,5,0,13,12,74520840,3619,66690900,3236,26839
1942,7,0,14,11,74533020,3618,66690900,3235,26846
1943,3,0,14,11,74542080,3618,66690900,3235,26849
1944,7,0,17,8,74552460,3618,66690900,3234,26856
1945,5,0,14,11,74593860,3618,66690900,3233,26861
1946,1,0,12,13,74606400,3619,66690900,3233,26862
1947,3,0,15,10,74606400,3619,66690900,3232,26865
1948,2,0,12,13,74626740,3619,66690900,3232,26867
1949,10,0,18,7,74631300,3618,66690900,3230,26877
1950,2,0,13,12,74656560,3618,66690900,3230,26879
1951,5,0,12,13,74671740,3618,66690900,3229,26884
1952,12,0,16,9,74691480,3617,66690900,3227,26896
1953,5,0,17,8,74703960,3617,66690900,3227,26901
1954,11,0,23,2,74719380,3617,66690900,3225,26912
1955,12,0,23,2,74771700,3618,66690900,3223,26924
1956,6,0,20,5,74802840,3618,66690900,3222,26930
1957,11,0,15,10,74854320,3617,66690900,3220,26941
1958,6,0,16,9,74879760,3618,66690900,3219,26947
1959,12,0,22,3,74894460,3617,66690900,3218,26959
1960,14,0,22,3,74937780,3617,66690900,3215,26973
1961,7,0,19,6,74979000,3617,66690900,3214,26980
1962,7,0,21,4,74997060,3617,66690900,3213,26987
1963,9,0,15,10,75050100,3617,66690900,3212,26996
1964,7,0,14,11,75065460,3616,66690900,3211,27003
1965,4,0,14,11,75080640,3616,66690900,3210,27007
1966,6,0,17,8,75089940,3616,66690900,3209,27013
1967,4,0,19,6,75095580,3616,66690900,3209,27017
1968,6,0,14,11,75144540,3617,66690900,3208,27023
1969,6,0,16,9,75163920,3617,66690900,3207,27029
1970,4,0,12,13,75190140,3617,66690900,3206,27033
1971,4,0,15,10,75195840,3617,66690900,3205,27037
1972,6,0,16,9,75206700,3617,66690900,3205,27043
1973,6,0,18,7,75216420,3616,66690900,3204,27049
1974,2,0,14,11,75254520,3617,66690900,3203,27051
1975,11,0,21,4,75272340,3617,66690900,3202,27062
1976,6,0,21,4,75293160,3617,66690900,3201,27068
1977,8,0,18,7,75336840,3617,66690900,3199,27076
1978,9,0,19,6,75367020,3618,66690900,3198,27085
1979,10,0,19,6,75403980,3618,66690900,3197,27095
1980,8,0,19,6,75422400,3617,66690900,3195,27103
1981,8,0,17,8,75462360,3617,66690900,3194,27111
1982,11,0,19,6,75478380,3616,66690900,3192,27122
1983,12,0,20,5,75518280,3616,66690900,3191,27134
1984,12,0,22,3,75540420,3616,66690900,3189,27146
1985,9,0,21,4,75586860,3616,66690900,3187,27155
1986,6,0,20,5,75612180,3616,66690900,3186,27161
1987,6,0,18,7,75653580,3617,66690900,3186,27167
1988,5,0,18,7,75687960,3618,66690900,3185,27172
1989,5,0,16,9,75723000,3618,66690900,3184,27177
1990,3,0,13,12,75750120,3618,66690900,3184,27180
1991,3,0,12,13,75758700,3618,66690900,3183,27183
1992,1,0,11,14,75764700,3618,66690900,3183,27184
1993,5,0,13,12,75769620,3618,66690900,3182,27189
1994,2,0,13,12,75775560,3618,66690900,3182,27191
1995,6,0,17,8,75779520,3618,66690900,3181,27197
1996,5,0,17,8,75802500,3618,66690900,3180,27202
1997,9,0,20,5,75826860,3618,66690900,3179,27211
1998,9,0,22,3,75862140,3618,66690900,3178,27220
1999,13,0,24,1,75902400,3618,66691020,3176,27233
2000,10,0,16,9,75952260,3618,66691140,3174,27243
2001,7,0,16,9,75975600,3618,66691140,3173,27250
2002,13,0,18,7,76005480,3617,66691140,3171,27263
2003,11,0,20,5,76028040,3617,66691140,3169,27274
2004,9,0,20,5,76065120,3617,66691140,3168,27283
2005,17,0,22,3,76108380,3616,66691140,3165,27300
2006,15,10,20,5,76128360,3616,66691320,3164,27315
2007,12,19,17,8,76172160,3617,66698160,3162,27327
2008,11,26,18,7,76191660,3618,66706800,3161,27338
2009,10,25,25,0,76226760,3618,66760260,3162,27348
2010,10,24,25,0,76288080,3620,66819780,3163,27358
2011,10,23,25,0,76342740,3620,66894060,3165,27368
2012,4,3,25,0,76398180,3619,67154400,3177,27372
2013,10,0,18,7,76446600,3618,67171680,3176,27382
2014,4,0,16,9,76470660,3618,67171680,3175,27386
2015,6,0,13,12,76503720,3618,67171680,3174,27392
2016,3,0,14,11,76507980,3618,67171680,3174,27395
2017,5,0,18,7,76508760,3617,67171680,3173,27400
2018,2,0,15,10,76526580,3617,67171680,3173,27402
2019,7,0,19,6,76533780,3617,67171680,3172,27409
2020,7,0,21,4,76547160,3617,67171680,3171,27416
2021,9,0,23,2,76568040,3617,67171680,3169,27425
2022,6,0,20,5,76599000,3617,67171680,3169,27431
2023,5,0,19,6,76629900,3617,67171680,3168,27436
2024,8,0,21,4,76650900,3617,67171680,3167,27444
2025,6,0,24,1,76671060,3618,67172580,3166,27450
2026,7,0,19,6,76720920,3618,67172940,3165,27457
2027,14,0,25,0,76744380,3618,67172940,3163,27471
2028,14,3,25,0,76788300,3618,67177080,3161,27485
2029,6,0,21,4,76825740,3617,67179660,3160,27491
2030,14,0,25,0,76858740,3617,67183260,3158,27505
2031,5,0,20,5,76900980,3618,67183260,3157,27510
2032,8,0,21,4,76923600,3617,67183260,3156,27518
2033,6,0,20,5,76942320,3617,67183260,3155,27524
2034,7,0,18,7,76985520,3618,67183260,3154,27531
2035,10,1,21,4,77009520,3618,67183800,3153,27541
2036,8,0,23,2,77034060,3618,67185480,3152,27549
2037,6,0,20,5,77067000,3618,67185480,3151,27555
2038,2,0,14,11,77101680,3618,67185480,3150,27557
2039,7,0,19,6,77104080,3618,67185480,3149,27564
2040,5,0,19,6,77113500,3617,67185480,3149,27569
2041,9,1,22,3,77125560,3617,67185720,3147,27578
2042,4,0,22,3,77154240,3618,67186980,3147,27582
2043,1,0,16,9,77190960,3618,67186980,3147,27583
2044,5,0,17,8,77207460,3618,67186980,3146,27588
2045,8,0,18,7,77224560,3618,67186980,3145,27596
2046,5,0,18,7,77238900,3618,67186980,3144,27601
2047,14,1,25,0,77255520,3617,67188720,3142,27615
2048,8,3,25,0,77285340,3618,67192020,3141,27623
2049,13,4,25,0,77340840,3618,67196040,3139,27636
2050,5,0,19,6,77384460,3618,67213680,3139,27641
2051,12,3,25,0,77390820,3618,67213800,3138,27653
2052,12,0,24,1,77444520,3617,67223820,3136,27665
2053,12,0,24,1,77480580,3617,67225140,3135,27677
2054,8,0,17,8,77528100,3617,67225140,3134,27685
2055,7,0,21,4,77537160,3617,67225140,3133,27692
2056,6,0,16,9,77568360,3616,67225140,3132,27698
2057,13,0,24,1,77573580,3616,67225140,3130,27711
2058,7,4,20,5,77610420,3616,67227240,3129,27718
2059,12,9,22,3,77641260,3617,67241760,3128,27730
2060,6,7,25,0,77670780,3617,67254960,3127,27736
2061,6,0,24,1,77711100,3617,67318440,3130,27742
2062,6,0,19,6,77750700,3617,67318440,3129,27748
2063,9,1,20,5,77773320,3617,67318440,3128,27757
2064,6,3,20,5,77791800,3617,67320060,3127,27763
2065,3,0,22,3,77816520,3617,67325820,3126,27766
2066,7,0,21,4,77839200,3617,67325820,3125,27773
2067,7,2,25,0,77843700,3617,67325820,3125,27780
2068,12,1,25,0,77907780,3618,67326480,3123,27792
2069,7,0,23,2,77948340,3618,67327740,3122,27799
2070,7,0,21,4,77982180,3618,67327740,3121,27806
2071,9,0,22,3,78007320,3618,67327740,3119,27815
2072,8,0,23,2,78037380,3618,67327740,3118,27823
2073,7,1,19,6,78075780,3618,67327740,3117,27830
2074,7,6,18,7,78093120,3619,67330860,3116,27837
2075,11,5,25,0,78121320,3619,67347720,3116,27848
2076,5,0,24,1,78163920,3619,67370280,3116,27853
2077,12,0,21,4,78214200,3619,67371420,3114,27865
2078,16,1,25,0,78249240,3619,67372440,3112,27881
2079,8,0,23,2,78277740,3618,67373220,3111,27889
2080,11,0,22,3,78320100,3618,67373220,3109,27900
2081,8,0,23,2,78343800,3618,67373220,3108,27908
2082,14,0,24,1,78387600,3618,67374240,3106,27922
2083,6,0,20,5,78418380,3618,67374240,3105,27928
2084,3,0,19,6,78437340,3618,67374240,3105,27931
2085,6,0,17,8,78466500,3618,67374240,3104,27937
2086,6,0,17,8,78483540,3618,67374240,3103,27943
2087,10,0,23,2,78498900,3618,67374240,3102,27953
2088,1,0,16,9,78531240,3618,67374240,3102,27954
2089,7,0,19,6,78549480,3618,67374240,3101,27961
2090,6,0,18,7,78572940,3618,67374240,3100,27967
2091,4,0,18,7,78587940,3618,67374240,3099,27971
2092,5,0,18,7,78609300,3618,67374240,3098,27976
2093,7,0,19,6,78626160,3618,67374240,3097,27983
2094,6,0,16,9,78652860,3618,67374240,3097,27989
2095,6,0,19,6,78663600,3618,67374240,3096,27995
2096,19,6,25,0,78683820,3617,67376160,3093,28014
2097,8,4,25,0,78715260,3617,67384380,3093,28022
2098,7,0,19,6,78769740,3617,67397700,3092,28029
2099,16,0,23,2,78794340,3616,67397700,3090,28045
2100,11,0,24,1,78824100,3616,67397880,3088,28056
2101,13,5,25,0,78848700,3616,67399620,3087,28069
2102,17,8,25,0,78911040,3616,67411200,3085,28086
2103,12,15,25,0,78935880,3617,67415040,3083,28098
2104,17,23,25,0,78991200,3618,67428180,3082,28115
2105,9,20,25,0,79037280,3618,67457220,3082,28124
2106,17,23,25,0,79084140,3618,67478520,3080,28141
2107,8,20,25,0,79114020,3617,67510920,3081,28149
2108,8,7,25,0,79172160,3616,67670880,3086,28157
2109,9,0,22,3,79217100,3615,67815180,3092,28166
2110,4,0,18,7,79243320,3615,67815180,3091,28170
2111,5,0,20,5,79256340,3615,67815180,3090,28175
2112,5,0,17,8,79294380,3616,67815180,3090,28180
2113,6,0,16,9,79314480,3615,67815180,3089,28186
2114,3,0,14,11,79326840,3615,67815180,3088,28189
2115,9,0,19,6,79332360,3615,67815180,3087,28198
2116,4,0,20,5,79341480,3615,67815180,3087,28202
2117,4,0,17,8,79372320,3615,67815180,3086,28206
2118,7,0,19,6,79382160,3615,67815180,3085,28213
2119,4,0,19,6,79394940,3614,67815180,3085,28217
2120,13,0,23,2,79423920,3614,67815180,3083,28230
2121,15,13,20,5,79437420,3614,67817700,3081,28245
2122,13,22,19,6,79474140,3615,67831800,3080,28258
2123,13,33,19,6,79489320,3615,67835820,3078,28271
2124,7,37,18,7,79519740,3616,67842540,3077,28278
2125,19,40,25,0,79530000,3616,67899420,3078,28297
2126,16,40,25,0,79571940,3617,67929000,3079,28313
2127,13,37,25,0,79627860,3618,68034000,3082,28326
2128,10,32,25,0,79677720,3618,68240460,3090,28336
2129,11,34,25,0,79709280,3618,68280780,3091,28347
2130,7,29,25,0,79757760,3618,68365920,3094,28354
2131,9,28,25,0,79802220,3618,68372280,3093,28363
2132,6,26,25,0,79834020,3618,68459340,3096,28369
2133,3,3,25,0,79887900,3617,69102000,3124,28372
2134,7,0,19,6,79929240,3616,69175500,3127,28379
2135,5,0,19,6,79938240,3615,69175500,3126,28384
2136,4,0,19,6,79956720,3616,69175500,3125,28388
2137,2,0,15,10,79996560,3616,69175500,3125,28390
2138,4,0,17,8,80000700,3616,69175500,3125,28394
2139,8,0,19,6,80018460,3616,69175500,3123,28402
2140,6,0,22,3,80031900,3616,69175500,3123,28408
2141,7,0,18,7,80067180,3616,69175500,3122,28415
2142,7,0,18,7,80081940,3616,69175500,3121,28422
2143,5,0,17,8,80106180,3616,69175500,3120,28427
2144,6,0,18,7,80125680,3616,69175500,3119,28433
2145,17,0,22,3,80152680,3615,69175500,3117,28450
2146,9,0,22,3,80178120,3615,69175500,3115,28459
2147,12,2,25,0,80198520,3614,69175980,3114,28471
2148,14,8,25,0,80238240,3615,69179880,3112,28485
2149,15,13,25,0,80297100,3616,69192300,3111,28500
2150,6,8,25,0,80334180,3616,69222780,3111,28506
2151,10,0,21,4,80394540,3615,69295920,3113,28516
2152,6,0,20,5,80412420,3615,69295920,3112,28522
2153,10,0,21,4,80442600,3614,69295920,3111,28532
2154,10,0,21,4,80474520,3614,69295920,3109,28542
2155,6,0,17,8,80509740,3614,69295920,3108,28548
2156,4,0,15,10,80529360,3614,69295920,3108,28552
2157,8,0,18,7,80540640,3614,69295920,3107,28560
2158,3,0,16,9,80559780,3614,69295920,3106,28563
2159,3,0,17,8,80566800,3614,69295920,3106,28566
2160,3,0,16,9,80585220,3614,69295920,3105,28569
2161,4,0,18,7,80589420,3614,69295920,3105,28573
2162,6,0,17,8,80609940,3614,69295920,3104,28579
2163,2,0,17,8,80615460,3614,69295920,3104,28581
2164,7,0,20,5,80636520,3614,69295920,3103,28588
2165,9,0,18,7,80660340,3613,69295920,3102,28597
2166,9,0,22,3,80677920,3613,69295920,3100,28606
2167,5,0,18,7,80714100,3613,69295920,3100,28611
2168,13,0,24,1,80734860,3613,69295920,3098,28624
2169,2,0,19,6,80762760,3613,69295920,3097,28626
2170,12,0,24,1,80801280,3614,69295920,3096,28638
2171,11,5,23,2,80820300,3614,69301140,3095,28649
2172,8,12,19,6,80846100,3614,69302340,3094,28657
2173,11,12,25,0,80890980,3615,69323880,3093,28668
2174,21,27,25,0,80911380,3615,69327300,3090,28689
2175,6,32,18,7,80960940,3616,69329280,3090,28695
2176,7,36,18,7,80982420,3616,69339180,3089,28702
2177,11,36,25,0,81013140,3617,69399120,3090,28713
2178,7,38,25,0,81031020,3617,69421380,3090,28720
2179,11,37,25,0,81080100,3618,69507180,3093,28731
2180,10,37,25,0,81124320,3618,69582120,3095,28741
2181,9,33,25,0,81172980,3618,69799200,3103,28750
2182,4,23,25,0,81214740,3618,69976500,3110,28754
2183,7,8,25,0,81252660,3616,70315440,3124,28761
2184,6,0,20,5,81302640,3615,70530900,3133,28767
2185,6,0,19,6,81330780,3615,70530900,3132,28773
2186,4,0,18,7,81351180,3615,70530900,3132,28777
2187,2,0,17,8,81357840,3615,70530900,3131,28779
2188,6,0,16,9,81389460,3615,70530900,3131,28785
2189,5,0,18,7,81398640,3615,70530900,3130,28790
2190,3,0,16,9,81415800,3615,70530900,3129,28793
2191,7,0,17,8,81438360,3615,70530900,3129,28800
2192,4,0,20,5,81441600,3615,70530900,3128,28804
2193,5,0,18,7,81459300,3615,70530900,3127,28809
2194,8,0,19,6,81482580,3615,70530900,3126,28817
2195,12,0,22,3,81503880,3614,70530900,3124,28829
2196,11,4,25,0,81515820,3614,70531620,3123,28840
2197,10,6,25,0,81564360,3615,70546020,3122,28850
2198,9,0,20,5,81622620,3614,70563540,3122,28859
2199,15,3,25,0,81636720,3614,70564200,3120,28874
2200,11,7,25,0,81669000,3614,70569480,3119,28885
2201,12,8,25,0,81723360,3615,70579860,3117,28897
2202,8,10,23,2,81754980,3615,70592400,3117,28905
2203,8,13,22,3,81787500,3615,70595340,3116,28913
2204,7,5,25,0,81834540,3616,70661880,3118,28920
2205,3,0,18,7,81877860,3615,70723560,3120,28923
2206,8,0,17,8,81910440,3615,70723560,3119,28931
2207,7,0,18,7,81925680,3615,70723560,3118,28938
2208,6,0,19,6,81938880,3615,70723560,3117,28944
2209,5,0,18,7,81966180,3615,70723560,3116,28949
2210,4,0,17,8,81987540,3615,70723560,3116,28953
2211,7,0,21,4,81999120,3615,70723560,3115,28960
2212,5,0,17,8,82040220,3615,70723560,3114,28965
2213,6,0,20,5,82050480,3615,70723560,3113,28971
2214,6,0,18,7,82074060,3615,70723560,3113,28977
2215,15,0,25,0,82089900,3615,70723740,3111,28992
2216,12,3,25,0,82119420,3614,70725600,3109,29004
2217,3,3,21,4,82168320,3615,70731240,3109,29007
2218,4,4,21,4,82189680,3616,70738080,3109,29011
2219,16,6,25,0,82234680,3616,70764420,3108,29027
2220,9,5,25,0,82266840,3616,70775040,3107,29036
2221,13,4,25,0,82317420,3616,70794600,3106,29049
2222,7,3,25,0,82352760,3616,70803600,3105,29056
2223,6,0,20,5,82396440,3616,70814760,3105,29062
2224,9,0,20,5,82436160,3616,70814760,3104,29071
2225,7,0,20,5,82447920,3616,70814760,3103,29078
2226,6,0,18,7,82474080,3616,70814760,3102,29084
2227,6,0,18,7,82499040,3616,70814760,3101,29090
2228,5,0,19,6,82515360,3616,70814760,3101,29095
2229,3,0,18,7,82534680,3616,70814760,3100,29098
2230,9,0,19,6,82563420,3616,70814760,3099,29107
2231,3,0,17,8,82577460,3616,70814760,3098,29110
2232,3,0,18,7,82586700,3616,70814760,3098,29113
2233,4,0,17,8,82604760,3616,70814760,3098,29117
2234,3,0,18,7,82614480,3616,70814760,3097,29120
2235,4,0,19,6,82621260,3616,70814760,3097,29124
2236,10,0,22,3,82649640,3616,70814760,3095,29134
2237,3,0,18,7,82665540,3616,70814760,3095,29137
2238,5,0,18,7,82686720,3616,70814760,3094,29142
2239,7,0,19,6,82696560,3615,70814760,3093,29149
2240,8,0,21,4,82714740,3615,70814760,3092,29157
2241,15,6,23,2,82740120,3615,70816140,3091,29172
2242,8,11,21,4,82771620,3616,70819980,3089,29180
2243,10,10,25,0,82805760,3616,70849440,3089,29190
2244,11,10,25,0,82836840,3616,70862160,3088,29201
2245,9,0,21,4,82894200,3615,70936740,3090,29210
2246,23,6,25,0,82943640,3615,70937700,3088,29233
2247,13,10,25,0,82971000,3614,70946460,3086,29246
2248,7,5,24,1,83015760,3614,70983180,3087,29253
2249,10,0,24,1,83053020,3614,71006580,3086,29263
2250,7,0,22,3,83079000,3613,71006580,3085,29270
2251,5,0,19,6,83113980,3614,71006580,3085,29275
2252,8,0,20,5,83151060,3614,71006580,3084,29283
2253,6,0,18,7,83171940,3614,71006580,3083,29289
2254,8,0,22,3,83185380,3614,71006580,3082,29297
2255,8,0,19,6,83222400,3614,71006700,3081,29305
2256,8,0,21,4,83244240,3614,71006700,3080,29313
2257,5,0,20,5,83272800,3614,71006700,3079,29318
2258,5,0,19,6,83292960,3614,71006700,3078,29323
2259,7,0,19,6,83319780,3614,71006700,3077,29330
2260,11,0,21,4,83345520,3614,71006700,3076,29341
2261,10,0,23,2,83370000,3613,71008440,3075,29351
2262,6,2,23,2,83384340,3613,71009400,3074,29357
2263,8,0,21,4,83446620,3614,71010240,3073,29365
2264,10,5,22,3,83463300,3614,71011860,3072,29375
2265,5,2,24,1,83504280,3615,71027940,3072,29380
2266,15,10,21,4,83544660,3615,71036640,3070,29395
2267,7,12,21,4,83570040,3616,71052420,3070,29402
2268,5,14,22,3,83588100,3616,71056260,3069,29407
2269,12,16,25,0,83629740,3617,71079720,3069,29419
2270,12,19,25,0,83670660,3617,71131140,3070,29431
2271,8,14,25,0,83716320,3617,71151840,3069,29439
2272,14,12,25,0,83769840,3617,71181540,3069,29453
2273,8,3,25,0,83808000,3616,71347020,3075,29461
2274,7,0,20,5,83853720,3616,71388000,3075,29468
2275,6,0,20,5,83869800,3615,71388000,3075,29474
2276,8,1,22,3,83903700,3616,71392620,3074,29482
2277,7,0,22,3,83924160,3616,71396400,3073,29489
2278,5,0,20,5,83958120,3616,71397180,3072,29494
2279,9,4,20,5,83983860,3616,71398800,3071,29503
2280,3,0,21,4,84012060,3617,71410620,3071,29506
2281,4,0,16,9,84058440,3617,71410620,3071,29510
2282,5,0,19,6,84069120,3617,71410620,3070,29515
2283,6,0,21,4,84083100,3617,71410620,3069,29521
2284,5,0,19,6,84108660,3617,71410620,3069,29526
2285,3,0,18,7,84135060,3618,71410620,3068,29529
2286,9,0,22,3,84144360,3618,71410620,3067,29538
2287,13,3,23,2,84164760,3617,71410740,3066,29551
2288,8,0,19,6,84220320,3617,71414700,3065,29559
2289,10,0,24,1,84231720,3617,71414700,3063,29569
2290,10,0,23,2,84274500,3617,71414700,3062,29579
2291,5,0,21,4,84288180,3616,71414700,3061,29584
2292,12,0,21,4,84349860,3617,71414880,3060,29596
2293,11,0,21,4,84373380,3616,71414880,3058,29607
2294,4,0,20,5,84397800,3617,71414880,3058,29611
2295,10,0,20,5,84433020,3617,71414880,3056,29621
2296,8,0,20,5,84447780,3616,71414880,3055,29629
2297,11,0,23,2,84480360,3616,71414880,3054,29640
2298,10,0,23,2,84511380,3616,71415240,3053,29650
2299,4,0,18,7,84549240,3616,71415240,3052,29654
2300,10,0,22,3,84568620,3616,71415240,3051,29664
2301,9,0,22,3,84601680,3616,71415420,3050,29673
2302,3,0,19,6,84624660,3616,71415960,3049,29676
2303,3,0,18,7,84645480,3617,71415960,3049,29679
2304,2,0,14,11,84679200,3617,71415960,3049,29681
2305,2,0,13,12,84685560,3617,71415960,3048,29683
2306,3,0,15,10,84686040,3617,71415960,3048,29686
2307,5,0,19,6,84687120,3617,71415960,3047,29691
2308,6,0,18,7,84713640,3617,71415960,3047,29697
2309,4,0,19,6,84725400,3617,71415960,3046,29701
2310,5,0,20,5,84747540,3617,71415960,3045,29706
2311,8,0,21,4,84774180,3617,71415960,3044,29714
2312,9,0,19,6,84801120,3617,71415960,3043,29723
2313,4,0,19,6,84820020,3617,71415960,3043,29727
2314,18,14,20,5,84832560,3617,71416500,3041,29745
2315,6,17,18,7,84873660,3618,71426340,3040,29751
2316,12,27,19,6,84883500,3618,71431080,3040,29763
2317,18,40,20,5,84903300,3618,71439840,3037,29781
2318,14,40,20,5,84920460,3619,71452080,3037,29795
2319,12,40,20,5,84969720,3620,71463960,3037,29807
2320,8,40,18,7,84980160,3620,71463960,3037,29815
2321,4,36,21,4,85007460,3621,71590320,3042,29819
2322,8,34,25,0,85043520,3621,71694300,3045,29827
2323,9,36,25,0,85079040,3622,71731080,3046,29836
2324,10,35,25,0,85121820,3622,71867400,3050,29846
2325,5,25,25,0,85180320,3622,72201960,3064,29851
2326,8,10,25,0,85225680,3621,72613920,3080,29859
2327,6,0,16,9,85263900,3618,72816060,3088,29865
2328,5,0,19,6,85272180,3618,72816060,3087,29870
2329,8,3,19,6,85288440,3618,72816480,3087,29878
2330,4,0,21,4,85301880,3618,72824160,3086,29882
2331,4,0,19,6,85329360,3618,72824160,3086,29886
2332,7,0,21,4,85359060,3619,72824160,3085,29893
2333,6,0,18,7,85393860,3619,72824160,3084,29899
2334,4,0,20,5,85398480,3619,72824160,3083,29903
2335,12,0,22,3,85438860,3619,72824160,3082,29915
2336,5,0,19,6,85463160,3619,72824160,3081,29920
2337,10,0,22,3,85482780,3619,72824160,3080,29930
2338,12,0,23,2,85510320,3618,72824160,3078,29942
2339,7,0,22,3,85533780,3618,72824160,3077,29949
2340,8,0,20,5,85581960,3618,72824160,3076,29957
2341,10,0,25,0,85596360,3618,72824580,3075,29967
2342,7,0,21,4,85645860,3619,72824580,3074,29974
2343,12,0,24,1,85675380,3618,72824580,3073,29986
2344,9,0,23,2,85700820,3618,72824580,3071,29995
2345,13,0,24,1,85745340,3618,72825120,3070,30008
2346,12,3,24,1,85762080,3617,72826980,3068,30020
2347,11,11,20,5,85802700,3618,72833940,3067,30031
2348,12,11,25,0,85838460,3618,72857760,3067,30043
2349,6,1,25,0,85894920,3618,72918120,3068,30049
2350,9,0,23,2,85918140,3618,72925560,3067,30058
2351,4,0,20,5,85936920,3617,72925560,3067,30062
2352,2,0,16,9,85970340,3618,72925560,3067,30064
2353,8,0,18,7,85987980,3618,72925560,3066,30072
2354,14,3,25,0,85998480,3617,72926400,3064,30086
2355,25,19,22,3,86045040,3618,72932040,3061,30111
2356,24,40,19,6,86073840,3618,72936660,3059,30135
2357,36,40,20,5,86093880,3618,72951060,3058,30171
2358,29,40,19,6,86125980,3619,72973740,3059,30200
2359,30,40,19,6,86152140,3620,73016400,3060,30230
2360,32,40,25,0,86171280,3620,73097520,3063,30262
2361,29,39,25,0,86194320,3620,73130640,3063,30291
2362,21,40,25,0,86240040,3621,73225200,3066,30312
2363,28,40,25,0,86300700,3622,73276680,3067,30340
2364,30,40,25,0,86344260,3622,73381980,3070,30370
2365,28,40,25,0,86373960,3622,73530780,3075,30398
2366,37,40,20,5,86410920,3622,73533480,3075,30435
2367,32,40,21,4,86444100,3623,73629120,3078,30467
2368,31,39,25,0,86477400,3623,73722900,3080,30498
2369,32,40,25,0,86497680,3622,73748160,3080,30530
2370,32,37,25,0,86554980,3622,73824900,3082,30562
2371,29,40,25,0,86593080,3623,73827900,3080,30591
2372,22,38,25,0,86629440,3623,73867800,3081,30613
2373,32,39,25,0,86682060,3624,73887420,3081,30645
2374,38,40,25,0,86729940,3623,73968420,3082,30683
2375,30,40,25,0,86769480,3623,73976100,3081,30713
2376,37,40,25,0,86810760,3623,74050440,3082,30750
2377,36,38,25,0,86856300,3622,74074260,3081,30786
2378,29,39,25,0,86898780,3622,74116740,3081,30815
2379,37,40,25,0,86936040,3622,74125140,3080,30852
2380,31,40,25,0,86963400,3622,74128860,3079,30883
2381,34,40,25,0,87033420,3622,74205480,3080,30917
2382,38,40,22,3,87064320,3623,74207400,3080,30955
2383,32,39,24,1,87114600,3623,74265840,3080,30987
2384,33,40,18,7,87132600,3622,74265840,3080,31020
2385,35,40,25,0,87154380,3623,74287140,3080,31055
2386,22,39,24,1,87220920,3623,74511960,3087,31077
2387,34,40,19,6,87244260,3623,74511960,3087,31111
2388,35,40,20,5,87265140,3623,74532720,3087,31146
2389,25,40,25,0,87296220,3624,74560500,3087,31171
2390,28,40,20,5,87323760,3623,74578800,3087,31199
2391,29,40,19,6,87363120,3624,74585100,3087,31228
2392,37,40,25,0,87390180,3624,74662320,3088,31265
2393,30,40,25,0,87434940,3624,74722200,3089,31295
2394,37,40,25,0,87478140,3624,74733600,3088,31332
2395,27,39,25,0,87510600,3624,74761200,3087,31359
2396,28,40,23,2,87564060,3624,74829960,3089,31387
2397,36,40,25,0,87594960,3624,74838960,3088,31423
2398,35,40,23,2,87639420,3624,74843940,3087,31458
2399,34,39,24,1,87668520,3625,74864280,3087,31492

