Hour,Arrivals,Waiting,Treating,Available Rooms,Total Treatment Time,Average Treatment Time,Total Wait Time,Average Wait Time,Total Arrivals
1,3,0,1,24,1680,840,0,0,3
2,3,0,3,22,2160,720,0,0,6
3,3,0,3,22,9180,1530,0,0,9
4,4,0,4,21,22440,2493,0,0,13
5,4,0,7,18,25140,2514,0,0,17
6,12,0,7,18,53460,2430,0,0,29
7,6,0,4,21,76620,2471,0,0,35
8,4,0,4,21,97680,2790,0,0,39
9,10,0,11,14,102420,2695,0,0,49
10,6,0,7,18,132960,2770,0,0,55
11,15,0,7,18,171240,2718,0,0,70
12,8,0,9,16,194220,2814,0,0,78
13,7,0,7,18,221280,2836,0,0,85
14,10,0,4,21,263580,2896,0,0,95
15,15,0,11,14,288660,2915,0,0,110
16,6,0,9,16,320460,2994,0,0,116
17,10,0,12,13,347040,3044,0,0,126
18,8,0,7,18,388080,3055,0,0,134
19,13,0,15,10,410640,3110,0,0,147
20,8,0,11,14,453540,3149,0,0,155
21,3,0,3,22,489300,3156,0,0,158
22,6,0,6,19,507600,3212,0,0,164
23,7,0,9,16,520500,3212,0,0,171
24,2,0,7,18,537360,3237,0,0,173
25,5,0,6,19,580140,3372,0,0,178
26,8,0,6,19,600360,3335,0,0,186
27,10,0,7,18,619860,3279,0,0,196
28,6,0,4,21,649260,3279,0,0,202
29,6,0,6,19,663480,3284,0,0,208
30,2,0,4,21,677820,3290,0,0,210
31,9,0,9,16,689760,3284,0,0,219
32,9,0,11,14,722580,3329,0,0,228
33,11,0,11,14,762600,3344,0,0,239
34,15,0,17,8,793260,3347,0,0,254
35,9,0,12,13,863700,3441,0,0,263
36,11,0,11,14,906900,3448,0,0,274
37,11,0,12,13,945480,3463,0,0,285
38,11,0,11,14,979020,3435,0,0,296
39,15,0,13,12,1015020,3406,0,0,311
40,5,0,7,18,1069560,3461,0,0,316
41,5,0,3,22,1112580,3498,0,0,321
42,6,0,5,20,1120440,3479,0,0,327
43,5,0,4,21,1129500,3443,0,0,332
44,4,0,4,21,1155120,3479,0,0,336
45,10,0,4,21,1185540,3466,0,0,346
46,10,0,9,16,1195320,3444,0,0,356
47,6,0,6,19,1224180,3438,0,0,362
48,7,0,6,19,1251840,3448,0,0,369
49,4,0,5,20,1270320,3451,0,0,373
50,2,0,4,21,1289280,3475,0,0,375
51,4,0,6,19,1300920,3487,0,0,379
52,5,0,6,19,1324260,3503,0,0,384
53,10,0,12,13,1331640,3485,0,0,394
54,11,0,11,14,1382280,3508,0,0,405
55,12,0,11,14,1426620,3513,0,0,417
56,11,0,11,14,1468620,3521,0,0,428
57,12,0,10,15,1498260,3484,0,0,440
58,13,0,11,14,1537260,3477,0,0,453
59,8,0,10,15,1581000,3505,0,0,461
60,15,0,14,11,1605660,3475,0,0,476
61,4,0,8,17,1660080,3517,0,0,480
62,13,0,11,14,1695420,3517,0,0,493
63,11,0,11,14,1743840,3537,0,0,504
64,9,0,12,13,1771800,3536,0,0,513
65,10,0,9,16,1818780,3538,0,0,523
66,10,0,13,12,1847160,3552,0,0,533
67,10,0,10,15,1892580,3550,0,0,543
68,8,0,11,14,1930500,3575,0,0,551
69,7,0,8,17,1955520,3555,0,0,558
70,3,0,6,19,1989420,3584,0,0,561
71,5,0,4,21,2007180,3571,0,0,566
72,6,0,8,17,2023860,3588,0,0,572
73,5,0,7,18,2050560,3597,0,0,577
74,4,0,4,21,2077980,3601,0,0,581
75,5,0,4,21,2098920,3606,0,0,586
76,1,0,3,22,2105460,3605,0,0,587
77,8,0,7,18,2117820,3601,0,0,595
78,2,0,5,20,2132220,3601,0,0,597
79,11,0,9,16,2159280,3604,0,0,608
80,12,0,12,13,2182200,3589,0,0,620
81,5,0,5,20,2231640,3599,0,0,625
82,15,0,11,14,2248440,3574,0,0,640
83,12,0,14,11,2280300,3574,0,0,652
84,5,0,9,16,2319300,3579,0,0,657
85,8,0,7,18,2365080,3594,0,0,665
86,11,0,11,14,2382900,3583,0,0,676
87,7,0,7,18,2420040,3579,0,0,683
88,8,0,9,16,2447880,3589,0,0,691
89,12,0,10,15,2484960,3585,0,0,703
90,12,0,13,12,2509620,3574,0,0,715
91,4,0,9,16,2548560,3589,0,0,719
92,6,0,6,19,2598540,3614,0,0,725
93,5,0,4,21,2622660,3612,0,0,730
94,5,0,3,22,2634540,3599,0,0,735
95,6,0,5,20,2639880,3586,0,0,741
96,5,0,5,20,2657520,3586,0,0,746
97,4,0,2,23,2678520,3580,0,0,750
98,9,0,6,19,2687520,3569,0,0,759
99,6,0,7,18,2702460,3565,0,0,765
100,5,0,5,20,2727600,3565,0,0,770
101,7,0,10,15,2735580,3566,0,0,777
102,8,0,13,12,2759820,3574,0,0,785
103,9,0,6,19,2822880,3582,0,0,794
104,12,0,8,17,2858940,3582,0,0,806
105,6,0,9,16,2873160,3578,0,0,812
106,10,0,7,18,2912460,3573,0,0,822
107,14,0,12,13,2937780,3565,0,0,836
108,7,0,10,15,2977020,3573,0,0,843
109,9,0,8,17,3032040,3592,0,0,852
110,11,0,9,16,3063720,3587,0,0,863
111,8,0,8,17,3088200,3578,0,0,871
112,10,0,5,20,3131580,3574,0,0,881
113,7,0,5,20,3148980,3566,0,0,888
114,5,0,4,21,3168720,3564,0,0,893
115,6,0,6,19,3188640,3570,0,0,899
116,8,0,6,19,3211680,3564,0,0,907
117,9,0,8,17,3233280,3560,0,0,916
118,8,0,8,17,3264540,3563,0,0,924
119,4,0,7,18,3284400,3566,0,0,928
120,3,0,3,22,3314220,3571,0,0,931
121,3,0,4,21,3328560,3579,0,0,934
122,5,0,7,18,3340860,3584,0,0,939
123,1,0,1,24,3354720,3572,0,0,940
124,6,0,5,20,3366060,3577,0,0,946
125,10,0,11,14,3372720,3569,0,0,956
126,5,0,11,14,3392280,3570,0,0,961
127,6,0,9,16,3432960,3583,0,0,967
128,12,0,12,13,3463200,3581,0,0,979
129,10,0,10,15,3508260,3583,0,0,989
130,13,0,8,17,3550260,3571,0,0,1002
131,8,0,7,18,3576300,3565,0,0,1010
132,7,0,3,22,3606960,3557,0,0,1017
133,11,0,9,16,3618840,3551,0,0,1028
134,6,0,5,20,3659100,3555,0,0,1034
135,11,0,12,13,3671160,3553,0,0,1045
136,13,0,14,11,3699660,3543,0,0,1058
137,7,0,6,19,3752520,3543,0,0,1065
138,11,0,8,17,3782880,3542,0,0,1076
139,6,0,8,17,3793080,3531,0,0,1082
140,8,0,9,16,3812580,3526,0,0,1090
141,6,0,5,20,3859080,3537,0,0,1096
142,5,0,2,23,3889860,3539,0,0,1101
143,7,0,5,20,3895440,3531,0,0,1108
144,6,0,1,24,3920040,3522,0,0,1114
145,6,0,5,20,3921960,3517,0,0,1120
146,11,0,13,12,3928800,3514,0,0,1131
147,7,0,4,21,3981180,3510,0,0,1138
148,7,0,5,20,3998220,3507,0,0,1145
149,18,0,15,10,4008900,3492,0,0,1163
150,7,0,10,15,4057440,3497,0,0,1170
151,5,0,7,18,4088820,3500,0,0,1175
152,11,0,9,16,4117020,3497,0,0,1186
153,6,0,8,17,4161180,3514,0,0,1192
154,9,0,10,15,4190460,3518,0,0,1201
155,12,0,10,15,4228680,3515,0,0,1213
156,11,0,10,15,4262280,3510,0,0,1224
157,9,0,11,14,4289760,3510,0,0,1233
158,11,0,11,14,4329480,3511,0,0,1244
159,8,0,11,14,4354140,3508,0,0,1252
160,4,0,6,19,4398240,3518,0,0,1256
161,12,0,11,14,4421580,3517,0,0,1268
162,4,0,7,18,4468020,3532,0,0,1272
163,10,0,7,18,4499400,3528,0,0,1282
164,8,0,5,20,4530600,3525,0,0,1290
165,7,0,5,20,4548660,3520,0,0,1297
166,5,0,5,20,4572120,3525,0,0,1302
167,9,0,10,15,4591080,3528,0,0,1311
168,3,0,9,16,4606380,3529,0,0,1314
169,7,0,8,17,4641840,3535,0,0,1321
170,8,0,9,16,4680360,3545,0,0,1329
171,3,0,2,23,4714620,3544,0,0,1332
172,5,0,5,20,4727160,3548,0,0,1337
173,6,0,8,17,4732320,3544,0,0,1343
174,7,0,7,18,4759980,3544,0,0,1350
175,6,0,5,20,4790580,3545,0,0,1356
176,12,0,9,16,4803480,3534,0,0,1368
177,12,0,9,16,4837980,3528,0,0,1380
178,5,0,11,14,4852380,3531,0,0,1385
179,8,0,10,15,4890300,3536,0,0,1393
180,9,0,6,19,4947660,3544,0,0,1402
181,9,0,7,18,4980180,3547,0,0,1411
182,7,0,8,17,5002620,3547,0,0,1418
183,13,0,11,14,5027400,3540,0,0,1431
184,9,0,8,17,5081940,3548,0,0,1440
185,8,0,8,17,5103180,3543,0,0,1448
186,12,0,10,15,5129820,3537,0,0,1460
187,8,0,13,12,5151780,3540,0,0,1468
188,8,0,13,12,5190660,3547,0,0,1476
189,11,0,12,13,5248020,3557,0,0,1487
190,6,0,11,14,5280240,3562,0,0,1493
191,9,0,8,17,5327100,3565,0,0,1502
192,2,0,6,19,5354460,3574,0,0,1504
193,4,0,4,21,5385120,3580,0,0,1508
194,6,0,7,18,5401620,3584,0,0,1514
195,6,0,8,17,5426820,3589,0,0,1520
196,8,0,5,20,5460960,3585,0,0,1528
197,8,0,10,15,5473800,3587,0,0,1536
198,8,0,9,16,5495940,3580,0,0,1544
199,7,0,6,19,5541540,3586,0,0,1551
200,8,0,6,19,5563620,3582,0,0,1559
201,5,0,6,19,5582460,3583,0,0,1564
202,10,0,5,20,5608200,3574,0,0,1574
203,8,0,8,17,5623020,3572,0,0,1582
204,12,0,11,14,5647800,3567,0,0,1594
205,12,0,10,15,5679840,3558,0,0,1606
206,13,0,11,14,5730780,3563,0,0,1619
207,13,0,17,8,5753400,3562,0,0,1632
208,5,0,7,18,5808960,3563,0,0,1637
209,2,0,3,22,5838300,3568,0,0,1639
210,14,0,9,16,5865840,3568,0,0,1653
211,6,0,6,19,5891400,3564,0,0,1659
212,13,0,11,14,5912400,3559,0,0,1672
213,3,0,7,18,5932680,3556,0,0,1675
214,4,0,4,21,5969580,3563,0,0,1679
215,8,0,7,18,5978700,3558,0,0,1687
216,3,0,5,20,6001320,3561,0,0,1690
217,6,0,3,22,6025800,3559,0,0,1696
218,3,0,2,23,6036780,3557,0,0,1699
219,5,0,6,19,6039720,3556,0,0,1704
220,7,0,7,18,6052800,3552,0,0,1711
221,3,0,4,21,6076800,3553,0,0,1714
222,10,0,6,19,6101940,3551,0,0,1724
223,9,0,8,17,6119880,3547,0,0,1733
224,7,0,12,13,6135540,3550,0,0,1740
225,8,0,8,17,6186900,3555,0,0,1748
226,12,0,8,17,6229980,3555,0,0,1760
227,9,0,8,17,6263100,3556,0,0,1769
228,9,0,9,16,6288000,3554,0,0,1778
229,16,0,12,13,6322140,3547,0,0,1794
230,11,0,12,13,6344040,3538,0,0,1805
231,9,0,6,19,6418260,3549,0,0,1814
232,5,0,7,18,6437220,3552,0,0,1819
233,1,0,6,19,6451740,3556,0,0,1820
234,8,0,9,16,6481860,3563,0,0,1828
235,5,0,8,17,6508980,3566,0,0,1833
236,9,0,9,16,6538740,3567,0,0,1842
237,5,0,5,20,6564180,3563,0,0,1847
238,6,0,5,20,6579960,3560,0,0,1853
239,8,0,8,17,6611280,3567,0,0,1861
240,9,0,11,14,6622500,3562,0,0,1870
241,9,0,8,17,6670800,3565,0,0,1879
242,6,0,5,20,6709500,3568,0,0,1885
243,4,0,7,18,6722760,3572,0,0,1889
244,6,0,6,19,6751260,3573,0,0,1895
245,8,0,7,18,6762540,3566,0,0,1903
246,2,0,4,21,6793620,3573,0,0,1905
247,5,0,5,20,6818460,3579,0,0,1910
248,7,0,9,16,6833220,3581,0,0,1917
249,11,0,10,15,6860820,3577,0,0,1928
250,4,0,3,22,6894300,3574,0,0,1932
251,6,0,5,20,6906600,3572,0,0,1938
252,4,0,4,21,6922920,3572,0,0,1942
253,6,0,7,18,6931980,3571,0,0,1948
254,10,0,12,13,6944760,3568,0,0,1958
255,7,0,7,18,6989220,3569,0,0,1965
256,13,0,12,13,7013940,3567,0,0,1978
257,6,0,11,14,7029780,3562,0,0,1984
258,11,0,10,15,7080120,3566,0,0,1995
259,6,0,8,17,7113000,3568,0,0,2001
260,6,0,7,18,7143480,3571,0,0,2007
261,4,0,5,20,7166700,3572,0,0,2011
262,6,0,5,20,7192320,3574,0,0,2017
263,5,0,6,19,7205820,3574,0,0,2022
264,5,0,6,19,7232280,3578,0,0,2027
265,8,0,10,15,7241640,3576,0,0,2035
266,2,0,4,21,7288320,3585,0,0,2037
267,5,0,4,21,7304520,3584,0,0,2042
268,7,0,5,20,7318740,3580,0,0,2049
269,8,0,9,16,7335480,3581,0,0,2057
270,10,0,11,14,7350900,3575,0,0,2067
271,10,0,10,15,7397700,3578,0,0,2077
272,9,0,8,17,7429140,3575,0,0,2086
273,14,0,7,18,7477320,3572,0,0,2100
274,13,0,12,13,7487040,3563,0,0,2113
275,15,0,15,10,7545480,3570,0,0,2128
276,14,0,13,12,7574160,3557,0,0,2142
277,10,0,11,14,7634640,3565,0,0,2152
278,8,0,9,16,7676340,3568,0,0,2160
279,13,0,11,14,7703280,3563,0,0,2173
280,4,0,5,20,7741140,3564,0,0,2177
281,3,0,3,22,7770120,3569,0,0,2180
282,9,0,6,19,7779120,3563,0,0,2189
283,10,0,13,12,7786860,3562,0,0,2199
284,4,0,9,16,7833900,3570,0,0,2203
285,8,0,10,15,7865220,3573,0,0,2211
286,8,0,8,17,7902480,3574,0,0,2219
287,5,0,6,19,7939740,3579,0,0,2224
288,5,0,6,19,7957920,3579,0,0,2229
289,7,0,4,21,7998960,3583,0,0,2236
290,2,0,3,22,8010420,3584,0,0,2238
291,2,0,2,23,8022660,3584,0,0,2240
292,5,0,5,20,8027280,3583,0,0,2245
293,4,0,5,20,8040900,3583,0,0,2249
294,13,0,12,13,8058960,3581,0,0,2262
295,10,0,13,12,8080020,3576,0,0,2272
296,11,0,8,17,8146080,3580,0,0,2283
297,10,0,6,19,8177100,3575,0,0,2293
298,6,0,7,18,8192340,3574,0,0,2299
299,17,0,15,10,8233500,3578,0,0,2316
300,20,0,20,5,8261460,3567,0,0,2336
301,15,0,15,10,8333160,3567,0,0,2351
302,8,0,12,13,8394300,3576,0,0,2359
303,10,0,10,15,8422980,3570,0,0,2369
304,9,0,10,15,8478720,3580,0,0,2378
305,12,0,9,16,8514960,3576,0,0,2390
306,13,0,10,15,8542260,3569,0,0,2403
307,13,0,15,10,8568540,3568,0,0,2416
308,6,0,9,16,8621280,3572,0,0,2422
309,3,0,7,18,8649180,3576,0,0,2425
310,7,0,7,18,8673540,3576,0,0,2432
311,6,0,6,19,8692560,3574,0,0,2438
312,3,0,4,21,8712780,3575,0,0,2441
313,4,0,1,24,8740140,3576,0,0,2445
314,6,0,6,19,8740920,3575,0,0,2451
315,4,0,4,21,8751180,3570,0,0,2455
316,6,0,7,18,8770980,3574,0,0,2461
317,6,0,8,17,8788740,3574,0,0,2467
318,6,0,8,17,8814060,3575,0,0,2473
319,8,0,5,20,8844000,3571,0,0,2481
320,9,0,10,15,8862780,3573,0,0,2490
321,11,0,11,14,8894340,3572,0,0,2501
322,9,0,9,16,8938680,3574,0,0,2510
323,11,0,9,16,8973060,3572,0,0,2521
324,7,0,6,19,9000240,3568,0,0,2528
325,13,0,10,15,9017100,3562,0,0,2541
326,9,0,8,17,9040920,3556,0,0,2550
327,7,0,8,17,9079140,3561,0,0,2557
328,7,0,10,15,9100380,3563,0,0,2564
329,12,0,9,16,9137340,3559,0,0,2576
330,12,0,13,12,9163800,3558,0,0,2588
331,12,0,13,12,9203820,3557,0,0,2600
332,5,0,9,16,9251820,3563,0,0,2605
333,9,0,7,18,9293760,3564,0,0,2614
334,13,0,11,14,9318000,3561,0,0,2627
335,4,0,8,17,9336780,3559,0,0,2631
336,9,0,11,14,9373260,3565,0,0,2640
337,5,0,7,18,9407160,3566,0,0,2645
338,8,0,7,18,9447000,3570,0,0,2653
339,4,0,6,19,9472560,3573,0,0,2657
340,4,0,6,19,9483720,3572,0,0,2661
341,5,0,7,18,9517980,3579,0,0,2666
342,4,0,4,21,9546420,3580,0,0,2670
343,10,0,6,19,9570540,3579,0,0,2680
344,6,0,6,19,9590760,3578,0,0,2686
345,12,0,9,16,9613380,3575,0,0,2698
346,7,0,10,15,9639720,3576,0,0,2705
347,7,0,8,17,9672060,3576,0,0,2712
348,10,0,6,19,9715560,3577,0,0,2722
349,7,0,9,16,9735240,3579,0,0,2729
350,15,0,16,9,9757080,3576,0,0,2744
351,8,0,8,17,9825480,3580,0,0,2752
352,11,0,11,14,9855900,3581,0,0,2763
353,12,0,13,12,9885000,3578,0,0,2775
354,8,0,11,14,9918420,3578,0,0,2783
355,10,0,11,14,9965220,3582,0,0,2793
356,4,0,9,16,9991380,3583,0,0,2797
357,14,0,9,16,10041480,3583,0,0,2811
358,3,0,7,18,10061640,3584,0,0,2814
359,12,0,7,18,10107720,3585,0,0,2826
360,4,0,5,20,10126020,3584,0,0,2830
361,6,0,8,17,10132980,3583,0,0,2836
362,4,0,3,22,10168800,3584,0,0,2840
363,9,0,9,16,10183920,3585,0,0,2849
364,8,0,6,19,10209660,3581,0,0,2857
365,8,0,8,17,10228200,3580,0,0,2865
366,9,0,12,13,10246320,3580,0,0,2874
367,7,0,8,17,10293300,3582,0,0,2881
368,7,0,10,15,10320840,3586,0,0,2888
369,11,0,10,15,10347660,3581,0,0,2899
370,13,0,14,11,10383960,3583,0,0,2912
371,4,0,8,17,10416240,3581,0,0,2916
372,11,0,6,19,10472820,3585,0,0,2927
373,12,0,13,12,10487640,3584,0,0,2939
374,8,0,11,14,10524480,3584,0,0,2947
375,7,0,8,17,10562040,3585,0,0,2954
376,7,0,8,17,10589940,3586,0,0,2961
377,10,0,8,17,10622400,3585,0,0,2971
378,3,0,6,19,10645800,3586,0,0,2974
379,4,0,5,20,10667640,3588,0,0,2978
380,10,0,7,18,10688400,3585,0,0,2988
381,7,0,5,20,10723920,3586,0,0,2995
382,6,0,4,21,10741440,3584,0,0,3001
383,1,0,0,25,10755540,3582,0,0,3002
384,4,0,2,23,10759560,3581,0,0,3006
385,7,0,7,18,10763160,3580,0,0,3013
386,6,0,7,18,10779840,3578,0,0,3019
387,6,0,7,18,10807320,3580,0,0,3025
388,7,0,6,19,10837140,3581,0,0,3032
389,2,0,3,22,10849140,3579,0,0,3034
390,4,0,2,23,10867800,3579,0,0,3038
391,5,0,4,21,10870800,3577,0,0,3043
392,7,0,8,17,10883400,3577,0,0,3050
393,9,0,8,17,10909680,3575,0,0,3059
394,11,0,9,16,10947300,3576,0,0,3070
395,8,0,9,16,10973940,3575,0,0,3078
396,9,0,8,17,11004780,3574,0,0,3087
397,6,0,6,19,11031360,3573,0,0,3093
398,8,0,11,14,11047800,3575,0,0,3101
399,14,0,8,17,11107620,3575,0,0,3115
400,5,0,6,19,11136540,3576,0,0,3120
401,15,0,15,10,11158980,3576,0,0,3135
402,7,0,12,13,11205060,3579,0,0,3142
403,5,0,10,15,11253480,3587,0,0,3147
404,6,0,5,20,11304960,3591,0,0,3153
405,9,0,8,17,11335380,3593,0,0,3162
406,6,0,6,19,11351520,3589,0,0,3168
407,4,0,2,23,11389560,3592,0,0,3172
408,6,0,6,19,11398440,3593,0,0,3178
409,7,0,9,16,11410260,3592,0,0,3185
410,4,0,6,19,11446440,3596,0,0,3189
411,6,0,5,20,11474280,3596,0,0,3195
412,4,0,3,22,11493360,3596,0,0,3199
413,6,0,5,20,11517180,3599,0,0,3205
414,6,0,5,20,11532300,3597,0,0,3211
415,8,0,9,16,11541600,3595,0,0,3219
416,11,0,8,17,11586060,3595,0,0,3230
417,7,0,7,18,11607300,3593,0,0,3237
418,6,0,6,19,11632440,3593,0,0,3243
419,14,0,10,15,11652720,3588,0,0,3257
420,9,0,9,16,11687580,3588,0,0,3266
421,9,0,5,20,11735820,3588,0,0,3275
422,10,0,7,18,11756580,3586,0,0,3285
423,9,0,11,14,11777340,3587,0,0,3294
424,12,0,14,11,11822700,3591,0,0,3306
425,5,0,9,16,11858820,3591,0,0,3311
426,9,0,5,20,11910180,3592,0,0,3320
427,5,0,4,21,11921460,3589,0,0,3325
428,7,0,6,19,11931720,3587,0,0,3332
429,8,0,7,18,11944980,3583,0,0,3340
430,5,0,6,19,11962380,3582,0,0,3345
431,6,0,8,17,11984880,3585,0,0,3351
432,3,0,6,19,12011220,3587,0,0,3354
433,5,0,4,21,12057780,3593,0,0,3359
434,5,0,5,20,12063720,3591,0,0,3364
435,5,0,5,20,12088620,3593,0,0,3369
436,3,0,5,20,12098220,3593,0,0,3372
437,8,0,5,20,12121020,3591,0,0,3380
438,14,0,12,13,12143520,3590,0,0,3394
439,4,0,3,22,12186540,3589,0,0,3398
440,11,0,7,18,12201540,3586,0,0,3409
441,10,0,9,16,12220980,3583,0,0,3419
442,9,0,11,14,12243360,3583,0,0,3428
443,5,0,5,20,12276900,3581,0,0,3433
444,12,0,9,16,12309120,3582,0,0,3445
445,10,0,9,16,12337080,3580,0,0,3455
446,8,0,14,11,12345840,3579,0,0,3463
447,9,0,12,13,12400020,3583,0,0,3472
448,9,0,12,13,12439500,3585,0,0,3481
449,10,0,12,13,12484680,3588,0,0,3491
450,3,0,4,21,12533280,3591,0,0,3494
451,9,0,9,16,12551640,3592,0,0,3503
452,5,0,4,21,12584880,3591,0,0,3508
453,6,0,5,20,12594720,3589,0,0,3514
454,4,0,7,18,12604740,3590,0,0,3518
455,4,0,4,21,12639300,3592,0,0,3522
456,3,0,4,21,12649740,3592,0,0,3525
457,7,0,6,19,12668520,3592,0,0,3532
458,6,0,7,18,12685500,3592,0,0,3538
459,4,0,2,23,12721440,3593,0,0,3542
460,8,0,7,18,12725700,3591,0,0,3550
461,10,0,7,18,12759720,3591,0,0,3560
462,7,0,9,16,12777960,3591,0,0,3567
463,4,0,7,18,12806520,3593,0,0,3571
464,5,0,5,20,12839820,3595,0,0,3576
465,8,0,8,17,12854880,3594,0,0,3584
466,8,0,8,17,12883440,3594,0,0,3592
467,13,0,10,15,12921300,3594,0,0,3605
468,10,0,12,13,12943200,3592,0,0,3615
469,8,0,11,14,12968820,3590,0,0,3623
470,9,0,8,17,13018440,3592,0,0,3632
471,12,0,14,11,13040040,3592,0,0,3644
472,14,0,10,15,13086660,3587,0,0,3658
473,11,0,11,14,13133640,3590,0,0,3669
474,10,0,9,16,13170660,3588,0,0,3679
475,11,0,10,15,13200600,3587,0,0,3690
476,3,0,4,21,13238340,3588,0,0,3693
477,4,0,4,21,13264380,3591,0,0,3697
478,5,0,6,19,13272600,3591,0,0,3702
479,6,0,6,19,13290780,3590,0,0,3708
480,6,0,6,19,13313640,3590,0,0,3714
481,7,0,10,15,13320060,3589,0,0,3721
482,11,0,13,12,13358040,3591,0,0,3732
483,3,0,6,19,13412880,3596,0,0,3735
484,5,0,6,19,13433580,3597,0,0,3740
485,4,0,5,20,13459140,3599,0,0,3744
486,8,0,6,19,13485900,3600,0,0,3752
487,15,0,10,15,13512840,3596,0,0,3767
488,8,0,8,17,13549080,3596,0,0,3775
489,11,0,13,12,13566720,3595,0,0,3786
490,12,0,14,11,13605900,3595,0,0,3798
491,8,0,7,18,13666680,3597,0,0,3806
492,7,0,8,17,13682820,3596,0,0,3813
493,11,0,10,15,13727760,3599,0,0,3824
494,9,0,6,19,13767180,3597,0,0,3833
495,12,0,11,14,13786980,3595,0,0,3845
496,8,0,7,18,13821420,3593,0,0,3853
497,9,0,8,17,13860180,3596,0,0,3862
498,9,0,9,16,13888080,3596,0,0,3871
499,4,0,5,20,13913040,3595,0,0,3875
500,6,0,6,19,13926000,3593,0,0,3881
501,6,0,6,19,13951800,3594,0,0,3887
502,10,0,7,18,13977240,3593,0,0,3897
503,9,0,9,16,13998540,3592,0,0,3906
504,7,0,9,16,14034000,3594,0,0,3913
505,4,0,8,17,14055180,3595,0,0,3917
506,10,0,10,15,14090940,3597,0,0,3927
507,6,0,6,19,14121900,3596,0,0,3933
508,2,0,3,22,14148000,3598,0,0,3935
509,7,0,5,20,14160780,3596,0,0,3942
510,7,0,8,17,14173200,3596,0,0,3949
511,8,0,10,15,14196180,3596,0,0,3957
512,5,0,6,19,14231520,3597,0,0,3962
513,5,0,4,21,14265720,3599,0,0,3967
514,15,0,12,13,14278200,3596,0,0,3982
515,12,0,11,14,14313780,3593,0,0,3994
516,11,0,10,15,14363340,3595,0,0,4005
517,11,0,13,12,14377860,3591,0,0,4016
518,11,0,10,15,14440860,3594,0,0,4027
519,7,0,5,20,14473320,3592,0,0,4034
520,10,0,4,21,14498460,3588,0,0,4044
521,7,0,6,19,14509200,3586,0,0,4051
522,7,0,5,20,14533860,3585,0,0,4058
523,8,0,11,14,14542740,3586,0,0,4066
524,3,0,4,21,14576880,3585,0,0,4069
525,5,0,4,21,14592060,3585,0,0,4074
526,9,0,7,18,14607780,3583,0,0,4083
527,5,0,6,19,14630460,3584,0,0,4088
528,4,0,4,21,14659860,3586,0,0,4092
529,4,0,4,21,14673120,3585,0,0,4096
530,6,0,9,16,14679720,3586,0,0,4102
531,7,0,11,14,14696400,3586,0,0,4109
532,4,0,4,21,14752800,3590,0,0,4113
533,4,0,3,22,14777760,3592,0,0,4117
534,3,0,3,22,14784780,3591,0,0,4120
535,6,0,7,18,14789220,3590,0,0,4126
536,7,0,6,19,14809560,3588,0,0,4133
537,13,0,14,11,14824500,3587,0,0,4146
538,13,0,14,11,14862900,3585,0,0,4159
539,14,0,17,8,14914140,3588,0,0,4173
540,6,0,9,16,14972460,3590,0,0,4179
541,17,0,17,8,15004260,3590,0,0,4196
542,10,0,15,10,15048240,3590,0,0,4206
543,12,0,15,10,15099000,3592,0,0,4218
544,12,0,15,10,15145080,3593,0,0,4230
545,8,0,12,13,15193260,3595,0,0,4238
546,4,0,2,23,15256200,3598,0,0,4242
547,4,0,4,21,15260340,3597,0,0,4246
548,6,0,6,19,15271260,3596,0,0,4252
549,4,0,3,22,15293220,3595,0,0,4256
550,6,0,5,20,15301140,3594,0,0,4262
551,11,0,12,13,15309660,3592,0,0,4273
552,10,0,12,13,15354780,3595,0,0,4283
553,5,0,5,20,15399420,3595,0,0,4288
554,4,0,6,19,15414060,3596,0,0,4292
555,7,0,5,20,15447060,3597,0,0,4299
556,0,0,2,23,15464040,3598,0,0,4299
557,4,0,5,20,15472080,3599,0,0,4303
558,8,0,5,20,15493560,3598,0,0,4311
559,8,0,9,16,15505500,3597,0,0,4319
560,9,0,6,19,15547380,3597,0,0,4328
561,8,0,6,19,15566700,3595,0,0,4336
562,8,0,9,16,15581640,3594,0,0,4344
563,10,0,10,15,15612060,3593,0,0,4354
564,8,0,9,16,15643320,3593,0,0,4362
565,10,0,6,19,15699300,3595,0,0,4372
566,11,0,6,19,15723600,3592,0,0,4383
567,9,0,7,18,15741900,3589,0,0,4392
568,13,0,12,13,15758460,3587,0,0,4405
569,8,0,11,14,15783360,3585,0,0,4413
570,13,0,14,11,15829980,3587,0,0,4426
571,5,0,7,18,15874860,3588,0,0,4431
572,8,0,8,17,15911280,3590,0,0,4439
573,3,0,3,22,15949200,3592,0,0,4442
574,10,0,9,16,15962160,3592,0,0,4452
575,5,0,7,18,15978720,3590,0,0,4457
576,6,0,6,19,16012500,3592,0,0,4463
577,6,0,4,21,16040460,3592,0,0,4469
578,8,0,10,15,16042620,3591,0,0,4477
579,7,0,9,16,16074540,3592,0,0,4484
580,5,0,6,19,16113660,3594,0,0,4489
581,8,0,5,20,16142520,3593,0,0,4497
582,6,0,7,18,16159740,3594,0,0,4503
583,7,0,9,16,16176720,3594,0,0,4510
584,8,0,11,14,16197180,3593,0,0,4518
585,11,0,11,14,16249080,3596,0,0,4529
586,7,0,8,17,16283340,3596,0,0,4536
587,15,0,9,16,16323300,3593,0,0,4551
588,8,0,7,18,16347300,3591,0,0,4559
589,7,0,5,20,16375680,3590,0,0,4566
590,12,0,8,17,16407420,3590,0,0,4578
591,11,0,9,16,16435500,3588,0,0,4589
592,7,0,8,17,16468140,3589,0,0,4596
593,11,0,13,12,16486860,3588,0,0,4607
594,7,0,8,17,16545600,3592,0,0,4614
595,6,0,7,18,16573620,3592,0,0,4620
596,2,0,1,24,16600260,3592,0,0,4622
597,4,0,5,20,16600260,3592,0,0,4626
598,5,0,6,19,16616280,3592,0,0,4631
599,8,0,8,17,16639560,3593,0,0,4639
600,2,0,4,21,16666560,3594,0,0,4641
601,8,0,7,18,16682640,3593,0,0,4649
602,6,0,4,21,16708920,3592,0,0,4655
603,6,0,5,20,16731420,3593,0,0,4661
604,8,0,10,15,16743780,3593,0,0,4669
605,11,0,9,16,16773240,3590,0,0,4680
606,4,0,11,14,16781700,3591,0,0,4684
607,9,0,7,18,16839720,3593,0,0,4693
608,8,0,8,17,16870920,3594,0,0,4701
609,12,0,11,14,16894260,3592,0,0,4713
610,15,0,17,8,16925040,3592,0,0,4728
611,19,0,21,4,16978320,3592,420,0,4747
612,13,0,18,7,17041020,3593,960,0,4760
613,6,0,8,17,17126760,3599,960,0,4766
614,11,0,11,14,17148000,3597,960,0,4777
615,8,0,11,14,17184660,3599,960,0,4785
616,12,0,12,13,17225400,3599,960,0,4797
617,7,0,6,19,17274780,3600,960,0,4804
618,6,0,5,20,17304960,3601,960,0,4810
619,15,0,9,16,17336460,3599,960,0,4825
620,9,0,12,13,17355480,3599,960,0,4834
621,6,0,7,18,17402940,3600,960,0,4840
622,6,0,7,18,17430840,3602,960,0,4846
623,5,0,4,21,17461860,3602,960,0,4851
624,9,0,7,18,17483220,3602,960,0,4860
625,4,0,2,23,17511060,3601,960,0,4864
626,7,0,5,20,17523060,3601,960,0,4871
627,3,0,5,20,17533980,3601,960,0,4874
628,8,0,7,18,17555460,3601,960,0,4882
629,7,0,7,18,17586180,3602,960,0,4889
630,8,0,10,15,17603820,3602,960,0,4897
631,6,0,8,17,17641560,3603,960,0,4903
632,9,0,10,15,17677320,3606,960,0,4912
633,8,0,12,13,17700480,3606,960,0,4920
634,12,0,14,11,17748840,3608,960,0,4932
635,6,0,6,19,17790960,3607,960,0,4938
636,12,0,8,17,17823420,3606,960,0,4950
637,14,0,9,16,17851980,3602,960,0,4964
638,10,0,11,14,17895780,3605,960,0,4974
639,15,0,10,15,17934180,3601,960,0,4989
640,17,0,13,12,17981820,3601,960,0,5006
641,9,0,8,17,18021240,3599,960,0,5015
642,8,0,12,13,18036720,3599,960,0,5023
643,9,0,9,16,18072840,3598,960,0,5032
644,10,0,11,14,18116400,3600,960,0,5042
645,7,0,11,14,18151380,3602,960,0,5049
646,6,0,7,18,18182160,3601,960,0,5055
647,12,0,9,16,18219360,3602,960,0,5067
648,2,0,3,22,18251040,3602,960,0,5069
649,5,0,6,19,18260640,3603,960,0,5074
650,5,0,6,19,18275700,3602,960,0,5079
651,9,0,12,13,18289260,3603,960,0,5088
652,4,0,9,16,18314220,3603,960,0,5092
653,5,0,4,21,18361200,3605,960,0,5097
654,10,0,8,17,18379620,3604,960,0,5107
655,10,0,10,15,18395040,3601,960,0,5117
656,9,0,8,17,18439980,3602,960,0,5126
657,11,0,12,13,18470940,3604,960,0,5137
658,8,0,9,16,18506280,3603,960,0,5145
659,12,0,10,15,18541980,3602,960,0,5157
660,15,0,16,9,18569280,3601,960,0,5172
661,8,0,11,14,18617580,3601,960,0,5180
662,11,0,13,12,18655260,3602,960,0,5191
663,10,0,13,12,18692460,3603,960,0,5201
664,10,0,13,12,18738360,3604,960,0,5211
665,6,0,11,14,18784260,3608,960,0,5217
666,11,0,10,15,18822420,3607,960,0,5228
667,9,0,6,19,18878760,3609,960,0,5237
668,11,0,6,19,18913320,3608,960,0,5248
669,9,0,9,16,18925680,3606,960,0,5257
670,9,0,5,20,18964920,3604,960,0,5266
671,4,0,5,20,18978120,3604,960,0,5270
672,6,0,9,16,18991440,3605,960,0,5276
673,3,0,10,15,18992880,3604,960,0,5279
674,5,0,12,13,18999900,3603,960,0,5284
675,5,0,14,11,19010040,3603,960,0,5289
676,2,0,10,15,19037820,3604,960,0,5291
677,6,0,14,11,19049580,3605,960,0,5297
678,8,0,15,10,19065840,3604,960,0,5305
679,13,0,18,7,19086660,3601,960,0,5318
680,10,0,17,8,19125060,3601,960,0,5328
681,8,0,19,6,19149000,3601,960,0,5336
682,12,0,19,6,19197660,3602,960,0,5348
683,11,0,18,7,19234380,3601,960,0,5359
684,17,0,24,1,19270140,3600,960,0,5376
685,10,0,22,3,19318440,3601,960,0,5386
686,5,4,15,10,19349880,3601,1920,0,5391
687,14,12,16,9,19388940,3605,12420,2,5405
688,9,10,22,3,19416600,3607,23820,4,5414
689,10,7,25,0,19456680,3608,66540,12,5424
690,10,7,21,4,19519500,3610,78360,14,5434
691,13,7,25,0,19562880,3612,83520,15,5447
692,9,1,18,7,19621800,3608,162780,29,5456
693,7,0,16,9,19668180,3610,164100,30,5463
694,5,0,16,9,19689540,3611,164100,30,5468
695,2,0,10,15,19728480,3613,164100,30,5470
696,7,0,13,12,19742040,3613,164100,29,5477
697,6,0,14,11,19750140,3611,164100,29,5483
698,6,0,16,9,19768860,3612,164100,29,5489
699,5,0,16,9,19794420,3613,164100,29,5494
700,8,0,17,8,19819140,3613,164820,29,5502
701,4,0,13,12,19861140,3615,166920,30,5506
702,6,0,12,13,19893000,3616,166920,30,5512
703,10,0,14,11,19916040,3615,166920,30,5522
704,8,0,15,10,19927500,3613,166920,30,5530
705,11,0,18,7,19948380,3611,166920,30,5541
706,10,0,18,7,19982040,3611,166920,30,5551
707,8,0,13,12,20018040,3609,166920,30,5559
708,10,0,14,11,20040540,3607,166920,29,5569
709,16,0,23,2,20054580,3605,166920,29,5585
710,13,5,19,6,20101440,3606,168000,30,5598
711,5,0,19,6,20150400,3608,180360,32,5603
712,10,0,14,11,20202600,3608,180360,32,5613
713,7,0,14,11,20221020,3607,180360,32,5620
714,7,0,18,7,20231880,3607,180360,32,5627
715,13,0,19,6,20269500,3606,180360,31,5640
716,6,0,14,11,20311020,3606,180360,31,5646
717,9,0,13,12,20336340,3604,180360,31,5655
718,5,0,11,14,20363940,3604,180360,31,5660
719,4,0,12,13,20377740,3605,180360,31,5664
720,9,0,14,11,20397600,3604,180360,31,5673
721,3,0,13,12,20415480,3605,180360,31,5676
722,8,0,16,9,20426760,3603,180360,31,5684
723,3,0,11,14,20458320,3604,180360,31,5687
724,6,0,14,11,20472840,3605,180360,31,5693
725,4,0,10,15,20492460,3603,180360,31,5697
726,5,0,14,11,20497800,3603,180360,31,5702
727,5,0,15,10,20508840,3603,180360,31,5707
728,9,0,14,11,20539740,3602,180360,31,5716
729,9,0,16,9,20566680,3602,180360,31,5725
730,7,0,17,8,20589180,3602,180360,31,5732
731,10,0,16,9,20621820,3601,180360,31,5742
732,6,0,15,10,20640360,3600,180360,31,5748
733,6,0,12,13,20674320,3600,180360,31,5754
734,11,0,18,7,20688360,3599,180360,31,5765
735,8,0,17,8,20705460,3597,180360,31,5773
736,15,7,18,7,20737800,3598,181380,31,5788
737,12,18,14,11,20763360,3599,184020,31,5800
738,7,22,13,12,20799720,3603,201360,34,5807
739,4,20,17,8,20818920,3605,225060,38,5811
740,15,19,24,1,20860920,3607,306060,52,5826
741,6,19,18,7,20909520,3608,325200,55,5832
742,7,14,21,4,20953260,3610,407700,69,5839
743,5,0,14,11,21007980,3603,590040,100,5844
744,1,0,9,16,21032580,3603,590040,100,5845
745,3,0,9,16,21042720,3603,590040,100,5848
746,3,0,10,15,21045720,3603,590040,100,5851
747,7,0,15,10,21052140,3602,590040,100,5858
748,7,0,17,8,21066420,3602,590040,100,5865
749,5,0,13,12,21101220,3602,590040,100,5870
750,5,0,14,11,21113460,3602,590040,100,5875
751,12,0,20,5,21141060,3603,590040,100,5887
752,12,0,19,6,21169740,3600,590040,100,5899
753,9,0,19,6,21217140,3602,590040,99,5908
754,9,0,17,8,21268260,3604,590040,99,5917
755,14,0,20,5,21301260,3603,590040,99,5931
756,6,0,17,8,21333540,3603,590040,99,5937
757,5,0,14,11,21375240,3605,590040,99,5942
758,9,0,18,7,21391920,3605,590040,99,5951
759,7,0,19,6,21412620,3605,590340,99,5958
760,8,0,17,8,21454200,3606,590340,98,5966
761,10,0,18,7,21494760,3607,590340,98,5976
762,9,0,19,6,21526620,3608,590340,98,5985
763,12,9,15,10,21557820,3609,594660,99,5997
764,8,3,23,2,21588660,3610,621900,103,6005
765,7,0,15,10,21641700,3608,635220,105,6012
766,8,0,20,5,21661380,3610,635220,105,6020
767,2,0,13,12,21699000,3611,635220,105,6022
768,5,0,15,10,21708600,3610,635220,105,6027
769,5,0,12,13,21742380,3611,635220,105,6032
770,5,0,12,13,21757260,3611,635220,105,6037
771,2,0,13,12,21762060,3611,635220,105,6039
772,3,0,12,13,21785460,3612,635220,105,6042
773,4,0,11,14,21802440,3612,635220,105,6046
774,6,0,10,15,21824160,3612,635220,104,6052
775,10,0,15,10,21835320,3610,635220,104,6062
776,7,0,18,7,21839520,3609,635220,104,6069
777,13,0,17,8,21898620,3610,637080,104,6082
778,10,1,20,5,21920100,3610,639180,104,6092
779,7,0,16,9,21965880,3611,640020,104,6099
780,10,0,15,10,22005720,3611,640020,104,6109
781,9,0,17,8,22028520,3610,640020,104,6118
782,3,0,14,11,22042620,3609,640020,104,6121
783,11,0,20,5,22072440,3611,640020,104,6132
784,10,2,19,6,22103940,3611,640260,104,6142
785,15,15,15,10,22139940,3613,644760,104,6157
786,10,19,15,10,22188480,3617,662580,107,6167
787,10,20,22,3,22198380,3618,679560,110,6177
788,6,5,25,0,22260420,3617,813900,131,6183
789,8,0,13,12,22323720,3613,861060,139,6191
790,5,0,12,13,22340040,3612,861060,138,6196
791,5,0,14,11,22348560,3612,861060,138,6201
792,5,0,12,13,22369560,3611,861060,138,6206
793,7,0,11,14,22390380,3610,861060,138,6213
794,5,0,13,12,22396680,3609,861060,138,6218
795,9,0,16,9,22417860,3609,861060,138,6227
796,8,0,17,8,22435380,3608,861060,138,6235
797,9,0,18,7,22469460,3608,861060,137,6244
798,19,0,21,4,22521120,3607,861180,137,6263
799,7,0,15,10,22559400,3606,861180,137,6270
800,5,0,14,11,22587300,3607,861180,137,6275
801,11,0,19,6,22615920,3608,861180,136,6286
802,6,0,17,8,22638540,3607,861180,136,6292
803,9,0,16,9,22680060,3608,861180,136,6301
804,15,0,19,6,22713720,3607,861180,136,6316
805,8,0,18,7,22748340,3607,861180,136,6324
806,9,0,16,9,22781640,3606,861180,135,6333
807,10,0,18,7,22813440,3606,861180,135,6343
808,11,5,16,9,22837080,3606,861300,135,6354
809,7,8,15,10,22872240,3608,869880,136,6361
810,6,9,17,8,22895280,3610,877620,137,6367
811,12,7,25,0,22919640,3611,926340,145,6379
812,8,0,13,12,22998720,3608,953160,149,6387
813,6,0,11,14,23022780,3607,953160,149,6393
814,4,0,9,16,23042340,3607,953160,149,6397
815,3,0,9,16,23044680,3605,953160,148,6400
816,3,0,11,14,23047140,3605,953160,148,6403
817,7,0,12,13,23054340,3603,953160,148,6410
818,5,0,14,11,23059080,3602,953160,148,6415
819,4,0,12,13,23085360,3603,953160,148,6419
820,12,0,16,9,23107080,3602,953160,148,6431
821,11,0,19,6,23138460,3602,953160,147,6442
822,4,0,12,13,23181540,3602,953160,147,6446
823,11,0,19,6,23194020,3602,953160,147,6457
824,9,0,18,7,23235720,3603,953160,147,6466
825,4,0,13,12,23274000,3604,953160,147,6470
826,8,0,15,10,23301420,3605,953160,147,6478
827,14,0,18,7,23322420,3602,953160,146,6492
828,10,0,17,8,23354040,3601,953280,146,6502
829,13,0,22,3,23381100,3600,953460,146,6515
830,8,0,16,9,23432700,3601,953700,146,6523
831,10,0,17,8,23473260,3602,953700,145,6533
832,11,0,21,4,23487600,3600,953700,145,6544
833,9,0,18,7,23540280,3602,953700,145,6553
834,6,0,14,11,23568360,3600,953700,145,6559
835,6,0,12,13,23610780,3603,953700,145,6565
836,4,0,14,11,23614980,3602,953700,145,6569
837,6,0,15,10,23633460,3602,953700,145,6575
838,6,0,13,12,23668800,3603,953700,144,6581
839,9,0,13,12,23689980,3601,953700,144,6590
840,3,0,10,15,23701320,3600,953700,144,6593
841,5,0,14,11,23708160,3600,953700,144,6598
842,6,0,11,14,23729280,3599,953700,144,6604
843,8,0,15,10,23735340,3597,953700,144,6612
844,4,0,15,10,23749320,3597,953700,144,6616
845,5,0,13,12,23785080,3599,953700,144,6621
846,9,0,18,7,23799180,3599,953700,143,6630
847,5,0,16,9,23818380,3598,953700,143,6635
848,9,0,15,10,23867400,3600,953700,143,6644
849,8,0,17,8,23890740,3600,953700,143,6652
850,9,0,18,7,23922960,3601,953700,143,6661
851,11,0,22,3,23941680,3600,953700,142,6672
852,13,0,21,4,23995140,3600,953700,142,6685
853,12,0,21,4,24038520,3600,953700,142,6697
854,9,0,17,8,24088740,3601,953700,142,6706
855,9,0,19,6,24112080,3600,953700,142,6715
856,5,0,12,13,24156780,3601,953700,141,6720
857,10,0,16,9,24166080,3599,953700,141,6730
858,11,0,16,9,24199860,3598,953700,141,6741
859,6,0,17,8,24221160,3598,953700,141,6747
860,9,0,15,10,24265080,3599,953700,141,6756
861,9,0,15,10,24287460,3598,953700,140,6765
862,4,0,12,13,24315840,3598,953700,140,6769
863,6,0,14,11,24326160,3598,953700,140,6775
864,4,0,16,9,24341340,3599,953700,140,6779
865,6,0,15,10,24379260,3601,953700,140,6785
866,7,0,16,9,24398520,3600,953700,140,6792
867,5,0,17,8,24418800,3601,953700,140,6797
868,5,0,11,14,24461100,3601,953700,140,6802
869,5,0,12,13,24466380,3600,953700,140,6807
870,9,0,18,7,24480540,3601,953700,139,6816
871,5,0,16,9,24510420,3601,953700,139,6821
872,8,0,18,7,24535500,3602,953700,139,6829
873,8,0,16,9,24562020,3600,953700,139,6837
874,9,0,13,12,24604320,3600,953700,139,6846
875,6,0,14,11,24623040,3600,953700,139,6852
876,7,0,16,9,24643800,3601,953700,139,6859
877,6,0,15,10,24676200,3602,953700,138,6865
878,8,0,16,9,24700800,3602,953700,138,6873
879,9,0,16,9,24735360,3602,954120,138,6882
880,10,3,16,9,24762060,3602,954900,138,6892
881,10,10,15,10,24778320,3603,957780,138,6902
882,11,19,14,11,24806340,3605,963780,139,6913
883,8,16,21,4,24835320,3607,1007640,145,6921
884,6,0,24,1,24886380,3605,1133160,163,6927
885,3,0,13,12,24929700,3604,1133160,163,6930
886,9,0,15,10,24947580,3603,1133160,163,6939
887,2,0,10,15,24968100,3602,1133160,163,6941
888,3,0,10,15,24978480,3602,1133160,163,6944
889,3,0,11,14,24989820,3602,1133160,163,6947
890,4,0,10,15,25000320,3601,1133160,163,6951
891,3,0,10,15,25005180,3600,1133160,162,6954
892,5,0,11,14,25013880,3600,1133160,162,6959
893,10,0,13,12,25024380,3597,1133160,162,6969
894,3,0,12,13,25037100,3597,1133160,162,6972
895,4,0,12,13,25050420,3597,1133160,162,6976
896,5,0,12,13,25068420,3597,1133160,162,6981
897,10,0,20,5,25072320,3596,1133160,162,6991
898,6,0,15,10,25113600,3596,1133160,161,6997
899,8,0,15,10,25147620,3597,1133160,161,7005
900,12,0,18,7,25172220,3596,1133160,161,7017
901,12,0,20,5,25201140,3595,1133160,161,7029
902,12,0,21,4,25246200,3596,1133160,160,7041
903,8,0,17,8,25286700,3595,1133160,160,7049
904,7,0,14,11,25334940,3597,1133160,160,7056
905,7,0,12,13,25361460,3596,1133160,160,7063
906,6,0,17,8,25364640,3596,1133160,160,7069
907,6,0,15,10,25401120,3597,1133160,160,7075
908,9,0,15,10,25430640,3597,1133160,159,7084
909,7,0,17,8,25450800,3597,1133160,159,7091
910,6,0,15,10,25485360,3598,1133160,159,7097
911,6,0,11,14,25518300,3598,1133160,159,7103
912,7,0,13,12,25527600,3596,1133160,159,7110
913,7,0,15,10,25542600,3596,1133160,159,7117
914,4,0,12,13,25567560,3596,1133160,159,7121
915,4,0,12,13,25579980,3596,1133160,159,7125
916,11,0,17,8,25593600,3595,1133160,158,7136
917,6,0,16,9,25610460,3593,1133160,158,7142
918,6,2,16,9,25625580,3594,1136520,158,7148
919,6,2,17,8,25663020,3596,1148100,160,7154
920,9,0,20,5,25681200,3595,1153380,161,7163
921,8,0,16,9,25739340,3597,1153380,160,7171
922,4,0,14,11,25762740,3597,1153380,160,7175
923,12,9,15,10,25772880,3598,1155180,160,7187
924,10,12,16,9,25815060,3600,1168620,162,7197
925,11,11,25,0,25829700,3601,1198440,166,7208
926,7,0,19,6,25897980,3598,1264080,175,7215
927,13,0,24,1,25936020,3600,1264260,174,7228
928,17,0,25,0,25991400,3599,1265820,174,7245
929,7,0,13,12,26048700,3598,1266600,174,7252
930,12,0,15,10,26084160,3598,1266600,174,7264
931,7,0,17,8,26101320,3598,1266600,174,7271
932,3,0,12,13,26143320,3600,1266600,174,7274
933,8,0,15,10,26163360,3600,1266600,173,7282
934,6,0,13,12,26174580,3597,1266600,173,7288
935,9,0,13,12,26213340,3598,1266600,173,7297
936,6,0,15,10,26226840,3598,1266600,173,7303
937,4,0,14,11,26243760,3598,1266600,173,7307
938,6,0,13,12,26277900,3599,1266600,173,7313
939,4,0,12,13,26293260,3599,1266600,173,7317
940,10,0,17,8,26303700,3598,1266600,172,7327
941,6,0,15,10,26338440,3599,1266600,172,7333
942,7,0,14,11,26359740,3598,1266600,172,7340
943,12,0,15,10,26387940,3596,1266600,172,7352
944,10,0,17,8,26404560,3594,1266600,172,7362
945,8,0,17,8,26440140,3595,1268100,172,7370
946,9,0,19,6,26471880,3596,1268220,171,7379
947,16,10,16,9,26507040,3597,1273200,172,7395
948,10,6,25,0,26531280,3597,1301280,175,7405
949,11,0,20,5,26607300,3597,1327500,179,7416
950,14,0,20,5,26649780,3596,1327500,178,7430
951,10,0,17,8,26697360,3596,1327500,178,7440
952,8,0,14,11,26739120,3596,1327500,178,7448
953,11,0,18,7,26750940,3595,1327500,177,7459
954,9,0,18,7,26789220,3595,1327500,177,7468
955,7,0,18,7,26814480,3595,1327500,177,7475
956,5,0,13,12,26854620,3596,1327500,177,7480
957,4,0,13,12,26880180,3597,1327500,177,7484
958,6,0,18,7,26885640,3598,1327500,177,7490
959,6,0,15,10,26927280,3599,1327500,177,7496
960,7,0,16,9,26941020,3598,1327500,176,7503
961,7,2,16,9,26974080,3600,1328220,176,7510
962,4,1,17,8,26995320,3601,1334460,177,7514
963,5,0,11,14,27041760,3601,1335300,177,7519
964,6,0,12,13,27056940,3601,1335300,177,7525
965,0,0,10,15,27072660,3602,1335300,177,7525
966,4,0,12,13,27086940,3603,1335300,177,7529
967,12,0,18,7,27096060,3601,1335300,177,7541
968,10,0,21,4,27127500,3602,1335300,176,7551
969,8,0,17,8,27170280,3602,1335300,176,7559
970,5,0,16,9,27195480,3603,1335300,176,7564
971,9,0,16,9,27240360,3604,1335300,176,7573
972,9,0,20,5,27251340,3603,1335300,176,7582
973,12,0,23,2,27282180,3603,1335300,175,7594
974,11,0,17,8,27353220,3604,1335300,175,7605
975,11,0,19,6,27378900,3603,1335300,175,7616
976,7,0,17,8,27412440,3604,1335300,175,7623
977,6,0,18,7,27439800,3605,1335300,175,7629
978,6,0,15,10,27475140,3605,1335300,174,7635
979,8,0,17,8,27490980,3604,1335300,174,7643
980,6,0,13,12,27529800,3605,1335300,174,7649
981,6,0,15,10,27537480,3604,1335300,174,7655
982,2,0,11,14,27561420,3604,1335300,174,7657
983,7,0,14,11,27572400,3604,1335300,174,7664
984,8,0,14,11,27596880,3603,1335300,174,7672
985,10,0,13,12,27630780,3602,1335300,173,7682
986,1,0,10,15,27644640,3602,1335300,173,7683
987,4,0,12,13,27653520,3603,1335300,173,7687
988,7,0,15,10,27665160,3602,1335300,173,7694
989,8,0,16,9,27689040,3602,1335300,173,7702
990,2,0,13,12,27707280,3602,1335300,173,7704
991,9,0,14,11,27752640,3604,1335300,173,7713
992,9,0,16,9,27771660,3603,1335300,172,7722
993,12,0,22,3,27785460,3602,1335300,172,7734
994,11,0,17,8,27838020,3602,1336380,172,7745
995,6,0,17,8,27870420,3603,1336380,172,7751
996,16,0,22,3,27899160,3602,1336800,172,7767
997,11,0,20,5,27944520,3602,1336800,171,7778
998,10,0,19,6,27991320,3602,1338180,171,7788
999,10,6,13,12,28019100,3601,1338720,171,7798
1000,16,16,15,10,28051200,3604,1345200,172,7814
1001,9,23,16,9,28059540,3604,1346520,172,7823
1002,15,31,17,8,28098780,3607,1373100,175,7838
1003,7,36,16,9,28118760,3608,1374180,175,7845
1004,5,37,15,10,28146900,3609,1381920,176,7850
1005,6,35,21,4,28163820,3610,1428060,181,7856
1006,8,21,25,0,28234860,3611,1693860,215,7864
1007,2,0,13,12,28293240,3602,2054400,261,7866
1008,12,0,18,7,28316580,3602,2054400,260,7878
1009,5,0,14,11,28345740,3602,2054400,260,7883
1010,7,1,16,9,28369200,3603,2054400,260,7890
1011,10,1,18,7,28391520,3602,2054580,260,7900
1012,11,9,16,9,28421700,3604,2056860,260,7911
1013,9,16,14,11,28447200,3605,2060340,260,7920
1014,11,13,25,0,28472760,3607,2102820,265,7931
1015,8,3,25,0,28544280,3608,2174880,273,7939
1016,12,0,23,2,28591080,3606,2196060,276,7951
1017,7,0,17,8,28636200,3606,2196060,275,7958
1018,13,0,16,9,28680960,3605,2196060,275,7971
1019,11,0,15,10,28705440,3603,2196060,275,7982
1020,4,0,14,11,28729920,3603,2196060,274,7986
1021,5,0,15,10,28751520,3604,2196060,274,7991
1022,10,3,16,9,28777200,3605,2197200,274,8001
1023,11,8,18,7,28798620,3606,2203560,275,8012
1024,8,4,25,0,28825200,3607,2223540,277,8020
1025,12,0,23,2,28888920,3607,2247240,279,8032
1026,6,1,18,7,28924260,3606,2248380,279,8038
1027,6,0,15,10,28974120,3608,2251080,279,8044
1028,8,0,15,10,28998960,3608,2251080,279,8052
1029,7,0,15,10,29022360,3607,2251080,279,8059
1030,7,0,15,10,29053860,3608,2251080,279,8066
1031,4,0,14,11,29072400,3608,2251080,278,8070
1032,3,0,13,12,29088120,3608,2251080,278,8073
1033,7,0,14,11,29114340,3609,2251080,278,8080
1034,6,0,14,11,29132580,3609,2251080,278,8086
1035,5,0,13,12,29161860,3610,2251080,278,8091
1036,7,0,14,11,29181420,3609,2251080,277,8098
1037,8,0,15,10,29199960,3608,2251080,277,8106
1038,9,0,16,9,29224560,3608,2251080,277,8115
1039,5,0,14,11,29262600,3609,2251080,277,8120
1040,5,0,14,11,29284200,3610,2251080,277,8125
1041,12,0,16,9,29307960,3608,2251080,276,8137
1042,11,0,18,7,29328300,3607,2251080,276,8148
1043,11,0,22,3,29359320,3608,2251080,275,8159
1044,8,2,18,7,29402340,3608,2252160,275,8167
1045,11,0,15,10,29458500,3608,2255220,275,8178
1046,12,0,15,10,29490300,3607,2255220,275,8190
1047,12,0,21,4,29513040,3607,2255220,274,8202
1048,6,0,15,10,29544540,3606,2255220,274,8208
1049,7,0,14,11,29583060,3607,2255220,274,8215
1050,7,0,14,11,29608380,3607,2255220,274,8222
1051,5,0,15,10,29625060,3607,2255220,274,8227
1052,8,0,17,8,29657460,3608,2255220,273,8235
1053,9,0,14,11,29685960,3607,2255220,273,8244
1054,5,0,14,11,29698140,3606,2255220,273,8249
1055,7,0,16,9,29717760,3606,2255220,273,8256
1056,4,0,12,13,29744280,3606,2255220,273,8260
1057,5,0,13,12,29754720,3605,2255220,272,8265
1058,6,0,14,11,29772060,3605,2255220,272,8271
1059,6,0,12,13,29808660,3606,2255220,272,8277
1060,6,0,13,12,29821860,3606,2255220,272,8283
1061,8,0,18,7,29830080,3605,2255220,272,8291
1062,8,0,18,7,29859000,3605,2255220,271,8299
1063,10,0,20,5,29889840,3605,2255220,271,8309
1064,11,0,21,4,29931900,3606,2255220,271,8320
1065,7,0,17,8,29989200,3608,2255220,270,8327
1066,8,0,21,4,30001380,3608,2255220,270,8335
1067,14,0,18,7,30063900,3608,2255220,270,8349
1068,10,1,17,8,30086820,3607,2255580,269,8359
1069,16,14,15,10,30116880,3608,2257860,269,8375
1070,10,22,13,12,30149880,3610,2259840,269,8385
1071,7,24,16,9,30164220,3611,2283300,272,8392
1072,12,25,24,1,30187200,3613,2336820,278,8404
1073,11,34,19,6,30223200,3614,2338260,278,8415
1074,11,40,14,11,30282720,3618,2347380,278,8426
1075,10,40,13,12,30300420,3619,2354760,279,8436
1076,8,37,16,9,30335700,3621,2392500,283,8444
1077,3,36,19,6,30344160,3621,2421720,287,8447
1078,5,20,24,1,30399900,3621,2854500,338,8452
1079,10,0,23,2,30472320,3616,3302520,390,8462
1080,4,0,15,10,30485100,3613,3302520,390,8466
1081,5,0,11,14,30532380,3615,3302520,390,8471
1082,5,0,13,12,30544380,3615,3302520,390,8476
1083,4,0,11,14,30558840,3614,3302520,390,8480
1084,2,0,10,15,30567000,3613,3302520,390,8482
1085,2,0,11,14,30568260,3613,3302520,389,8484
1086,7,0,17,8,30575880,3614,3302520,389,8491
1087,9,0,17,8,30602160,3613,3302520,389,8500
1088,11,0,21,4,30632460,3614,3302520,388,8511
1089,11,0,21,4,30662640,3612,3302520,388,8522
1090,15,0,20,5,30723900,3613,3302640,387,8537
1091,8,0,19,6,30746400,3612,3302640,387,8545
1092,11,0,14,11,30813300,3613,3302640,386,8556
1093,12,1,20,5,30821040,3611,3302940,386,8568
1094,9,0,21,4,30863580,3613,3309540,386,8577
1095,11,0,19,6,30915720,3613,3309540,385,8588
1096,14,0,21,4,30957180,3613,3309540,385,8602
1097,16,7,17,8,31002780,3613,3309720,384,8618
1098,7,11,16,9,31027620,3614,3312600,384,8625
1099,15,11,25,0,31063800,3616,3347340,388,8640
1100,9,0,21,4,31139220,3614,3411180,395,8649
1101,8,0,14,11,31174800,3612,3411180,394,8657
1102,7,0,13,12,31203060,3612,3411180,394,8664
1103,8,0,17,8,31221660,3613,3411180,393,8672
1104,1,0,11,14,31244400,3612,3411180,393,8673
1105,6,0,11,14,31265040,3612,3411180,393,8679
1106,3,0,11,14,31271820,3612,3411180,393,8682
1107,9,0,14,11,31288680,3611,3411180,393,8691
1108,6,0,16,9,31295580,3610,3411180,392,8697
1109,6,0,17,8,31321620,3611,3411180,392,8703
1110,5,0,13,12,31362060,3612,3411180,392,8708
1111,5,0,12,13,31378860,3612,3411180,392,8713
1112,10,0,17,8,31393320,3611,3411180,391,8723
1113,13,0,23,2,31420140,3611,3411180,391,8736
1114,6,0,13,12,31472640,3611,3411180,390,8742
1115,7,0,13,12,31487220,3610,3411180,390,8749
1116,9,0,17,8,31500000,3609,3411180,390,8758
1117,6,0,17,8,31529280,3610,3411180,389,8764
1118,10,0,17,8,31569180,3610,3411180,389,8774
1119,14,0,20,5,31602960,3610,3411180,388,8788
1120,9,0,18,7,31644300,3610,3412620,388,8797
1121,9,6,17,8,31667580,3611,3415560,388,8806
1122,10,6,22,3,31701300,3613,3427980,389,8816
1123,6,0,15,10,31762140,3612,3449280,391,8822
1124,8,0,18,7,31787040,3612,3449280,391,8830
1125,8,0,14,11,31822920,3612,3449280,390,8838
1126,5,0,13,12,31846980,3612,3449280,390,8843
1127,1,0,10,15,31859640,3612,3449280,390,8844
1128,2,0,10,15,31876380,3613,3449280,390,8846
1129,8,0,16,9,31881180,3613,3449280,390,8854
1130,2,0,13,12,31895040,3612,3449280,390,8856
1131,5,0,14,11,31913100,3612,3449280,389,8861
1132,7,0,13,12,31942440,3612,3449280,389,8868
1133,6,0,13,12,31958640,3612,3449280,389,8874
1134,2,0,10,15,31979820,3612,3449280,389,8876
1135,11,0,17,8,31992720,3612,3449280,388,8887
1136,10,0,17,8,32014740,3610,3449280,388,8897
1137,8,0,18,7,32050680,3612,3449280,387,8905
1138,15,13,15,10,32074740,3612,3449340,387,8920
1139,10,22,12,13,32102880,3614,3452820,387,8930
1140,6,25,13,12,32121780,3615,3464640,388,8936
1141,10,33,14,11,32132520,3616,3469140,388,8946
1142,10,40,14,11,32153160,3617,3493560,390,8956
1143,13,40,13,12,32183940,3619,3511080,392,8969
1144,10,37,13,12,32215380,3621,3539040,395,8979
1145,8,40,13,12,32222820,3622,3553140,397,8987
1146,9,39,14,11,32238660,3622,3624240,404,8996
1147,6,37,16,9,32263800,3624,3735780,417,9002
1148,8,35,24,1,32277060,3625,3895500,434,9010
1149,7,25,25,0,32353620,3627,4181820,466,9017
1150,7,15,25,0,32413200,3626,4430340,493,9024
1151,10,0,16,9,32479140,3620,4884480,543,9034
1152,5,0,13,12,32507940,3620,4884480,543,9039
1153,5,0,13,12,32528940,3620,4884480,542,9044
1154,4,0,13,12,32536380,3619,4884480,542,9048
1155,5,0,14,11,32560920,3621,4884480,542,9053
1156,4,0,14,11,32571060,3620,4884480,542,9057
1157,7,0,14,11,32602860,3621,4884480,541,9064
1158,3,0,12,13,32613600,3620,4884480,541,9067
1159,6,0,15,10,32619300,3619,4884480,541,9073
1160,7,0,16,9,32642700,3620,4884480,540,9080
1161,10,0,19,6,32661660,3619,4884480,540,9090
1162,5,0,17,8,32692140,3619,4884480,539,9095
1163,13,0,20,5,32735280,3620,4884480,539,9108
1164,5,0,16,9,32766780,3620,4884480,538,9113
1165,12,0,16,9,32803860,3619,4884480,538,9125
1166,14,0,22,3,32829660,3619,4884480,537,9139
1167,7,0,16,9,32887320,3620,4884480,536,9146
1168,12,0,18,7,32919060,3620,4884480,536,9158
1169,10,0,20,5,32947740,3620,4884480,535,9168
1170,10,0,19,6,32977440,3619,4884480,534,9178
1171,11,0,16,9,33028800,3619,4884480,534,9189
1172,9,0,14,11,33059580,3618,4884480,533,9198
1173,3,0,11,14,33082020,3618,4884480,533,9201
1174,6,0,12,13,33103140,3618,4884480,533,9207
1175,12,0,19,6,33115800,3618,4884480,532,9219
1176,3,0,11,14,33160380,3618,4884480,532,9222
1177,7,0,13,12,33181200,3618,4884480,531,9229
1178,7,0,14,11,33197940,3618,4884480,531,9236
1179,4,0,11,14,33218340,3617,4884480,531,9240
1180,8,0,13,12,33235440,3617,4884480,530,9248
1181,6,0,11,14,33262860,3617,4884480,530,9254
1182,4,0,13,12,33265320,3616,4884480,530,9258
1183,2,0,10,15,33291240,3617,4884480,530,9260
1184,13,0,16,9,33305520,3616,4884480,529,9273
1185,7,0,12,13,33330840,3614,4884480,529,9280
1186,8,0,15,10,33342660,3613,4884480,528,9288
1187,12,0,18,7,33362880,3612,4884480,527,9300
1188,13,9,17,8,33392700,3613,4888560,527,9313
1189,14,21,15,10,33423960,3615,4891980,527,9327
1190,9,22,17,8,33472140,3618,4931580,530,9336
1191,8,20,25,0,33477480,3618,4953600,532,9344
1192,5,2,25,0,33568860,3619,5142480,552,9349
1193,12,0,18,7,33612840,3615,5154660,553,9361
1194,7,0,17,8,33636300,3615,5154660,553,9368
1195,13,6,16,9,33667320,3615,5155800,552,9381
1196,10,12,15,10,33696900,3616,5161260,552,9391
1197,12,16,20,5,33715800,3617,5170800,552,9403
1198,8,20,17,8,33755340,3619,5179020,553,9411
1199,3,14,20,5,33793140,3620,5222220,557,9414
1200,2,0,18,7,33839640,3618,5403240,576,9416
1201,6,0,12,13,33883440,3618,5403240,576,9422
1202,3,0,12,13,33893040,3618,5403240,576,9425
1203,8,0,16,9,33903660,3618,5403240,575,9433
1204,11,0,18,7,33932220,3617,5403240,574,9444
1205,2,0,10,15,33966300,3617,5403240,574,9446
1206,11,0,15,10,33982020,3617,5403240,574,9457
1207,12,1,21,4,33999060,3616,5403600,573,9469
1208,12,12,16,9,34027380,3617,5405340,573,9481
1209,7,14,15,10,34077780,3620,5413560,573,9488
1210,10,11,25,0,34098120,3621,5467800,578,9498
1211,13,7,25,0,34163580,3622,5511060,582,9511
1212,9,0,19,6,34213980,3618,5564040,587,9520
1213,6,0,11,14,34257480,3618,5564040,586,9526
1214,9,0,16,9,34275000,3618,5564040,586,9535
1215,9,0,17,8,34298340,3617,5564040,585,9544
1216,9,0,19,6,34333980,3619,5567280,585,9553
1217,9,0,20,5,34368660,3619,5567280,585,9562
1218,7,0,16,9,34408200,3619,5567280,584,9569
1219,7,0,12,13,34444320,3619,5567280,584,9576
1220,8,0,13,12,34465320,3618,5567280,583,9584
1221,7,0,14,11,34477800,3617,5567280,583,9591
1222,7,0,12,13,34514940,3618,5567280,582,9598
1223,3,0,10,15,34533120,3618,5567280,582,9601
1224,4,0,11,14,34542540,3618,5567280,582,9605
1225,4,0,14,11,34548180,3618,5567280,582,9609
1226,3,0,16,9,34554960,3618,5567280,582,9612
1227,3,0,11,14,34593420,3619,5567280,581,9615
1228,7,0,17,8,34605240,3620,5567280,581,9622
1229,5,0,14,11,34636380,3620,5567280,581,9627
1230,6,0,14,11,34659480,3620,5567280,580,9633
1231,11,0,16,9,34677720,3619,5567280,580,9644
1232,11,4,16,9,34711020,3620,5568780,579,9655
1233,13,7,20,5,34736880,3620,5581440,580,9668
1234,14,6,25,0,34777440,3621,5589360,580,9682
1235,15,6,25,0,34837500,3621,5618580,582,9697
1236,12,0,23,2,34898160,3620,5664900,586,9709
1237,10,0,18,7,34950540,3620,5664900,585,9719
1238,7,0,16,9,34983000,3620,5664900,585,9726
1239,14,0,21,4,35013900,3620,5664900,584,9740
1240,16,2,25,0,35054460,3620,5665320,583,9756
1241,11,0,22,3,35104860,3619,5671200,583,9767
1242,13,0,19,6,35169180,3620,5671200,582,9780
1243,8,0,16,9,35207940,3620,5671200,582,9788
1244,12,0,18,7,35237400,3619,5671200,581,9800
1245,4,0,14,11,35260980,3619,5671200,581,9804
1246,3,0,12,13,35279280,3619,5671200,581,9807
1247,7,0,15,10,35302560,3620,5671200,580,9814
1248,7,0,14,11,35330880,3619,5671200,580,9821
1249,6,0,15,10,35345100,3619,5671200,579,9827
1250,6,0,13,12,35377920,3619,5671200,579,9833
1251,5,0,12,13,35402100,3620,5671200,579,9838
1252,6,0,14,11,35413740,3619,5671200,578,9844
1253,5,0,11,14,35442720,3619,5671200,578,9849
1254,11,0,19,6,35451180,3619,5671200,577,9860
1255,6,0,19,6,35477580,3620,5673420,577,9866
1256,7,0,18,7,35526360,3622,5673480,577,9873
1257,9,0,18,7,35561460,3622,5673480,576,9882
1258,6,0,15,10,35601240,3623,5673480,576,9888
1259,15,0,20,5,35621160,3621,5673480,575,9903
1260,12,4,17,8,35654880,3620,5674500,575,9915
1261,11,8,18,7,35696100,3622,5680320,574,9926
1262,17,22,17,8,35725200,3624,5684040,574,9943
1263,12,27,18,7,35763000,3625,5706420,575,9955
1264,11,25,25,0,35791680,3626,5754300,580,9966
1265,15,27,25,0,35866320,3629,5803080,584,9981
1266,8,19,25,0,35934420,3630,5928540,596,9989
1267,9,15,20,5,35997120,3630,5974260,600,9998
1268,6,0,19,6,36044160,3626,6203100,622,10004
1269,4,0,14,11,36080700,3627,6203100,622,10008
1270,3,0,11,14,36110520,3628,6203100,622,10011
1271,9,0,15,10,36129120,3628,6203100,621,10020
1272,6,1,16,9,36142440,3628,6204180,621,10026
1273,1,0,15,10,36158760,3628,6206220,621,10027
1274,8,0,14,11,36193620,3628,6206220,621,10035
1275,5,0,13,12,36221700,3629,6206220,621,10040
1276,7,0,15,10,36234720,3628,6206220,620,10047
1277,3,0,13,12,36247680,3628,6206220,620,10050
1278,5,0,13,12,36283320,3630,6206220,620,10055
1279,12,3,18,7,36292320,3629,6206340,619,10067
1280,7,0,21,4,36321060,3629,6210300,619,10074
1281,5,0,12,13,36376560,3630,6210300,619,10079
1282,8,0,16,9,36389040,3630,6210300,618,10087
1283,12,0,18,7,36410820,3628,6210300,617,10099
1284,11,3,21,4,36442080,3630,6213600,617,10110
1285,10,0,22,3,36493320,3630,6229620,618,10120
1286,14,7,15,10,36542460,3630,6229740,617,10134
1287,7,0,17,8,36585360,3630,6251880,619,10141
1288,14,0,23,2,36604440,3629,6251880,618,10155
1289,9,0,15,10,36667920,3629,6251880,617,10164
1290,11,0,14,11,36705000,3629,6251880,617,10175
1291,8,0,18,7,36724020,3629,6251880,616,10183
1292,8,0,18,7,36753780,3629,6251880,616,10191
1293,6,0,13,12,36796500,3629,6251880,615,10197
1294,4,0,13,12,36813420,3630,6251880,615,10201
1295,9,0,14,11,36834960,3629,6251880,615,10210
1296,8,0,14,11,36854220,3628,6251880,614,10218
1297,7,0,15,10,36874920,3628,6251880,614,10225
1298,8,0,15,10,36902460,3628,6251880,613,10233
1299,4,0,11,14,36940920,3629,6251880,613,10237
1300,4,0,13,12,36951960,3629,6251880,613,10241
1301,4,0,11,14,36969420,3629,6251880,613,10245
1302,6,0,12,13,36989040,3629,6251880,612,10251
1303,7,0,14,11,37002540,3628,6251880,612,10258
1304,8,0,17,8,37015320,3628,6251880,611,10266
1305,13,0,22,3,37040820,3627,6251880,611,10279
1306,10,2,19,6,37079940,3627,6254100,610,10289
1307,4,0,15,10,37116900,3627,6256380,610,10293
1308,16,0,20,5,37158120,3628,6256380,609,10309
1309,7,0,18,7,37182060,3627,6256380,609,10316
1310,8,0,15,10,37221240,3627,6256380,608,10324
1311,20,4,19,6,37257360,3626,6256440,607,10344
1312,9,0,21,4,37285500,3625,6264600,607,10353
1313,10,0,17,8,37338420,3625,6264600,607,10363
1314,9,0,18,7,37362600,3624,6264600,606,10372
1315,10,0,18,7,37397400,3624,6264600,606,10382
1316,8,0,17,8,37426260,3624,6264600,605,10390
1317,9,0,16,9,37458660,3624,6264600,605,10399
1318,6,0,16,9,37471080,3623,6264600,604,10405
1319,3,0,14,11,37499460,3624,6264600,604,10408
1320,9,0,12,13,37543260,3624,6264600,604,10417
1321,5,0,12,13,37559460,3624,6264600,603,10422
1322,5,0,11,14,37570920,3623,6264600,603,10427
1323,9,0,14,11,37578900,3622,6264600,603,10436
1324,10,0,15,10,37594980,3620,6264600,602,10446
1325,4,0,13,12,37624260,3621,6264600,602,10450
1326,11,0,16,9,37648140,3620,6264600,601,10461
1327,9,0,17,8,37676040,3620,6264600,601,10470
1328,8,0,18,7,37697940,3620,6264600,600,10478
1329,9,4,15,10,37741920,3621,6266820,600,10487
1330,14,17,13,12,37754700,3621,6271620,599,10501
1331,8,21,14,11,37781940,3623,6282180,600,10509
1332,5,26,14,11,37781940,3623,6282180,600,10514
1333,7,22,20,5,37823880,3625,6347580,606,10521
1334,7,15,25,0,37862760,3626,6459540,616,10528
1335,15,5,16,9,37936320,3621,6644100,633,10543
1336,15,17,13,12,37967820,3622,6649380,632,10558
1337,7,24,13,12,37967820,3622,6649380,632,10565
1338,14,30,15,10,38011320,3624,6672300,633,10579
1339,13,40,15,10,38022060,3624,6677220,633,10592
1340,10,38,19,6,38047320,3626,6736200,638,10602
1341,7,30,25,0,38093160,3627,6882540,652,10609
1342,5,22,25,0,38143200,3627,7072620,669,10614
1343,7,0,21,4,38226600,3624,7384380,698,10621
1344,5,0,13,12,38248680,3622,7384380,698,10626
1345,1,0,14,11,38248680,3622,7384380,698,10627
1346,7,0,20,5,38249760,3621,7384380,697,10634
1347,5,0,17,8,38273940,3621,7384380,697,10639
1348,9,4,17,8,38297460,3621,7386300,697,10648
1349,5,3,21,4,38313240,3622,7399020,698,10653
1350,6,0,18,7,38355900,3622,7410180,698,10659
1351,8,0,18,7,38378100,3621,7410180,698,10667
1352,7,0,22,3,38389380,3621,7410180,697,10674
1353,7,0,19,6,38422380,3621,7410180,697,10681
1354,8,1,19,6,38460900,3622,7410300,696,10689
1355,13,4,22,3,38483100,3622,7412040,696,10702
1356,11,10,20,5,38510460,3622,7415280,695,10713
1357,16,24,15,10,38547300,3623,7419660,694,10729
1358,8,30,16,9,38556240,3624,7426260,695,10737
1359,9,38,16,9,38563320,3624,7427880,695,10746
1360,8,40,15,10,38571180,3625,7427880,695,10754
1361,11,39,16,9,38598720,3626,7466160,697,10765
1362,9,40,16,9,38598720,3626,7466160,697,10774
1363,10,39,21,4,38617980,3627,7566840,706,10784
1364,4,36,25,0,38633640,3627,7665660,715,10788
1365,4,25,25,0,38710260,3629,7993860,746,10792
1366,4,12,25,0,38753820,3628,8355300,779,10796
1367,9,0,17,8,38797800,3622,8616060,803,10805
1368,2,0,14,11,38812800,3622,8616060,803,10807
1369,2,0,15,10,38820300,3622,8616060,802,10809
1370,3,0,15,10,38829900,3622,8616060,802,10812
1371,9,0,17,8,38842140,3621,8616060,802,10821
1372,7,0,18,7,38858040,3620,8617320,801,10828
1373,9,0,21,4,38878020,3620,8617320,800,10837
1374,4,0,18,7,38908140,3621,8617320,800,10841
1375,10,0,22,3,38932620,3621,8617560,799,10851
1376,9,5,16,9,38967720,3621,8618580,799,10860
1377,7,9,17,8,38982060,3621,8627160,799,10867
1378,9,13,20,5,38993280,3622,8641800,800,10876
1379,10,16,18,7,39038940,3623,8649660,800,10886
1380,15,30,16,9,39053640,3623,8650860,799,10901
1381,9,37,16,9,39069780,3624,8656440,799,10910
1382,14,40,15,10,39084600,3625,8657460,799,10924
1383,6,40,16,9,39090720,3625,8666040,799,10930
1384,13,40,15,10,39104640,3626,8670660,800,10943
1385,9,40,15,10,39122340,3627,8671320,799,10952
1386,7,39,15,10,39136260,3627,8678640,800,10959
1387,6,38,17,8,39150360,3628,8748660,806,10965
1388,4,38,21,4,39150360,3628,8826960,813,10969
1389,2,27,23,2,39191940,3628,9187380,846,10971
1390,6,8,25,0,39240060,3625,9906120,912,10977
1391,8,2,15,10,39286260,3621,10120260,931,10985
1392,6,3,17,8,39296880,3621,10125000,931,10991
1393,2,1,19,6,39308700,3621,10134720,932,10993
1394,8,0,17,8,39344940,3621,10144260,932,11001
1395,5,0,19,6,39350100,3621,10144260,931,11006
1396,5,0,18,7,39373680,3621,10146660,931,11011
1397,10,0,22,3,39385020,3620,10146660,930,11021
1398,2,0,18,7,39414840,3621,10148640,930,11023
1399,11,6,17,8,39441840,3621,10149720,930,11034
1400,10,15,14,11,39469140,3622,10151640,929,11044
1401,4,18,15,10,39469140,3622,10157160,929,11048
1402,7,25,14,11,39480960,3623,10157160,929,11055
1403,10,33,15,10,39486420,3623,10161660,929,11065
1404,8,38,17,8,39500700,3624,10177920,929,11073
1405,12,40,16,9,39508680,3624,10177920,929,11085
1406,7,38,16,9,39540840,3626,10217520,932,11092
1407,12,40,22,3,39544080,3626,10284660,937,11104
1408,8,40,16,9,39580500,3627,10284660,937,11112
1409,9,38,24,1,39601200,3628,10345260,942,11121
1410,11,38,19,6,39653220,3630,10387380,946,11132
1411,9,35,25,0,39671400,3629,10576980,962,11141
1412,14,38,23,2,39710160,3629,10708860,973,11155
1413,5,38,18,7,39752880,3630,10718220,973,11160
1414,9,35,25,0,39773460,3630,10750200,975,11169
1415,6,24,25,0,39824700,3629,11299260,1025,11175
1416,3,0,15,10,39879000,3622,12071220,1094,11178
1417,5,0,19,6,39881280,3621,12071220,1094,11183
1418,7,4,16,9,39903540,3621,12071880,1093,11190
1419,7,10,15,10,39924540,3623,12075360,1093,11197
1420,6,13,16,9,39939780,3623,12086820,1093,11203
1421,8,20,15,10,39949860,3624,12088560,1093,11211
1422,7,25,15,10,39966240,3625,12093060,1093,11218
1423,9,32,15,10,39978720,3625,12097260,1092,11227
1424,10,40,14,11,39993120,3626,12102420,1092,11237
1425,10,39,14,11,40001820,3626,12112260,1092,11247
1426,9,40,16,9,40009500,3627,12126600,1093,11256
1427,7,39,20,5,40014840,3627,12229080,1102,11263
1428,6,35,25,0,40041660,3627,12435240,1120,11269
1429,5,29,25,0,40096800,3629,12577560,1133,11274
1430,13,31,23,2,40143180,3629,12663300,1139,11287
1431,11,40,17,8,40175760,3629,12668160,1138,11298
1432,11,39,16,9,40192200,3630,12678960,1139,11309
1433,9,39,17,8,40214640,3631,12705360,1141,11318
1434,8,38,18,7,40224660,3631,12730260,1143,11326
1435,9,34,25,0,40249260,3631,12809400,1149,11335
1436,7,28,25,0,40288980,3630,13046880,1170,11342
1437,4,8,25,0,40347060,3628,13824420,1239,11346
1438,6,0,17,8,40384740,3624,14165580,1269,11352
1439,6,0,17,8,40408980,3624,14165580,1268,11358
1440,8,0,19,6,40422720,3624,14165580,1267,11366
1441,5,0,16,9,40443060,3623,14165580,1267,11371
1442,4,0,16,9,40451880,3622,14165580,1266,11375
1443,4,0,16,9,40463100,3622,14165580,1266,11379
1444,12,2,21,4,40479540,3622,14165580,1265,11391
1445,8,7,16,9,40510800,3622,14174160,1265,11399
1446,4,11,15,10,40516920,3622,14174160,1265,11403
1447,6,15,15,10,40533960,3623,14182440,1264,11409
1448,5,14,20,5,40543260,3624,14221500,1267,11414
1449,14,17,23,2,40572540,3624,14247780,1268,11428
1450,10,27,16,9,40607580,3625,14247780,1268,11438
1451,6,31,15,10,40628040,3625,14257320,1267,11444
1452,4,33,16,9,40638960,3626,14262420,1267,11448
1453,10,40,15,10,40647120,3626,14262420,1267,11458
1454,12,40,15,10,40663680,3627,14272680,1267,11470
1455,12,40,16,9,40671720,3628,14287200,1268,11482
1456,12,37,22,3,40692420,3629,14380440,1275,11494
1457,13,37,25,0,40715820,3629,14407620,1277,11507
1458,11,38,25,0,40762440,3630,14520300,1286,11518
1459,9,33,25,0,40816200,3631,14693580,1300,11527
1460,7,21,25,0,40863120,3629,15112500,1336,11534
1461,7,25,16,9,40903740,3628,15115380,1336,11541
1462,8,32,15,10,40918140,3629,15118860,1335,11549
1463,8,39,16,9,40918140,3629,15123120,1335,11557
1464,1,37,16,9,40942260,3630,15140160,1336,11558
1465,3,39,16,9,40951200,3631,15151500,1337,11561
1466,7,40,18,7,40966260,3631,15181680,1339,11568
1467,4,40,16,9,40983420,3632,15183180,1339,11572
1468,7,38,19,6,41002980,3633,15253920,1344,11579
1469,9,37,25,0,41019120,3633,15328020,1350,11588
1470,7,29,25,0,41075220,3633,15683100,1380,11595
1471,4,0,22,3,41125620,3626,17041920,1499,11599
1472,9,0,21,4,41149140,3625,17041920,1498,11608
1473,4,0,17,8,41170260,3624,17041920,1498,11612
1474,14,11,15,10,41191560,3624,17043180,1497,11626
1475,13,23,15,10,41203680,3625,17046900,1496,11639
1476,5,27,15,10,41210760,3625,17053800,1495,11644
1477,11,36,16,9,41224140,3626,17072520,1495,11655
1478,15,40,16,9,41244120,3627,17079720,1495,11670
1479,16,40,16,9,41256780,3628,17100540,1496,11686
1480,6,39,18,7,41263380,3628,17142060,1499,11692
1481,11,40,25,0,41272680,3629,17226060,1506,11703
1482,9,40,25,0,41316540,3630,17328480,1514,11712
1483,11,39,18,7,41368380,3632,17350560,1515,11723
1484,7,40,18,7,41391480,3632,17372820,1517,11730
1485,5,37,20,5,41417340,3633,17449140,1523,11735
1486,4,26,24,1,41454900,3633,17889540,1561,11739
1487,6,2,25,0,41505540,3628,18549180,1617,11745
1488,6,0,19,6,41524560,3625,18618780,1623,11751
1489,3,0,16,9,41547000,3626,18618780,1622,11754
1490,5,0,18,7,41560140,3626,18618780,1621,11759
1491,4,0,15,10,41592540,3626,18619920,1621,11763
1492,4,0,18,7,41593140,3626,18619920,1620,11767
1493,9,4,18,7,41611080,3626,18620700,1620,11776
1494,9,11,17,8,41634360,3627,18622320,1619,11785
1495,4,14,16,9,41650740,3628,18627540,1618,11789
1496,19,22,25,0,41666820,3629,18651120,1618,11808
1497,7,27,18,7,41711100,3630,18654840,1617,11815
1498,9,22,25,0,41744460,3630,18703740,1620,11824
1499,9,28,17,8,41780940,3630,18726360,1621,11833
1500,9,35,16,9,41800860,3631,18733920,1620,11842
1501,11,40,16,9,41814120,3631,18737400,1620,11853
1502,9,40,15,10,41831040,3632,18748320,1620,11862
1503,12,40,19,6,41838720,3632,18783780,1622,11874
1504,13,40,25,0,41860860,3633,18885840,1630,11887
1505,16,40,20,5,41898240,3633,18993960,1638,11903
1506,10,40,16,9,41930280,3634,18996840,1638,11913
1507,6,38,18,7,41953200,3635,19081200,1645,11919
1508,8,40,16,9,41965740,3635,19082640,1645,11927
1509,6,36,20,5,41984640,3635,19138260,1649,11933
1510,5,30,25,0,42008460,3635,19519860,1681,11938
1511,3,1,25,0,42066600,3630,20509500,1766,11941
1512,3,0,18,7,42082440,3628,20574840,1771,11944
1513,3,0,13,12,42114960,3629,20574840,1770,11947
1514,3,0,15,10,42119880,3629,20574840,1770,11950
1515,8,0,18,7,42128400,3628,20574840,1769,11958
1516,7,0,19,6,42144000,3627,20574840,1768,11965
1517,6,0,19,6,42178320,3628,20574840,1767,11971
1518,6,0,18,7,42197520,3628,20574840,1766,11977
1519,11,5,18,7,42216000,3628,20577960,1765,11988
1520,7,10,16,9,42241440,3628,20583780,1764,11995
1521,11,17,18,7,42254580,3629,20591760,1763,12006
1522,5,19,19,6,42263700,3629,20596800,1763,12011
1523,6,17,22,3,42297120,3630,20627400,1764,12017
1524,11,26,17,8,42332520,3631,20629260,1763,12028
1525,15,39,16,9,42349140,3632,20630820,1762,12043
1526,9,40,15,10,42357300,3632,20630820,1762,12052
1527,11,40,14,11,42365220,3633,20630820,1762,12063
1528,10,38,16,9,42390360,3634,20678760,1764,12073
1529,9,40,16,9,42390360,3634,20678760,1764,12082
1530,8,40,17,8,42408060,3635,20723460,1767,12090
1531,7,40,16,9,42419820,3635,20723760,1767,12097
1532,6,40,14,11,42431520,3635,20723760,1767,12103
1533,16,40,23,2,42449160,3636,20870640,1778,12119
1534,6,40,20,5,42463680,3637,20870640,1778,12125
1535,9,38,23,2,42509640,3638,21013140,1789,12134
1536,6,27,25,0,42561000,3638,21358080,1817,12140
1537,3,18,25,0,42599880,3637,21745200,1850,12143
1538,5,18,15,10,42637740,3636,21970020,1868,12148
1539,7,13,21,4,42656520,3636,22082520,1876,12155
1540,5,0,16,9,42689400,3631,22735980,1931,12160
1541,9,0,20,5,42707040,3631,22735980,1930,12169
1542,8,1,19,6,42734160,3631,22736040,1928,12177
1543,7,0,20,5,42755880,3631,22743420,1928,12184
1544,11,5,17,8,42787680,3631,22748040,1927,12195
1545,11,13,17,8,42804660,3631,22752120,1925,12206
1546,8,21,15,10,42815040,3632,22752120,1925,12214
1547,7,22,19,6,42830100,3632,22769700,1924,12221
1548,14,34,17,8,42853740,3633,22773240,1922,12235
1549,12,40,14,11,42875280,3634,22773240,1922,12247
1550,14,39,15,10,42890460,3635,22791660,1922,12261
1551,11,40,16,9,42890460,3635,22794120,1922,12272
1552,12,40,16,9,42905820,3635,22822800,1925,12284
1553,15,40,20,5,42923880,3636,22895520,1930,12299
1554,7,36,25,0,42956340,3637,23025780,1939,12306
1555,10,40,21,4,42995520,3638,23083920,1943,12316
1556,8,38,22,3,43038120,3639,23091900,1942,12324
1557,7,33,25,0,43069380,3639,23337720,1962,12331
1558,9,25,25,0,43114500,3637,23748120,1995,12340
1559,4,19,15,10,43166100,3635,23939220,2010,12344
1560,4,19,18,7,43171440,3636,23939280,2010,12348
1561,6,8,24,1,43197900,3634,24330780,2041,12354
1562,3,0,15,10,43230420,3631,24585360,2062,12357
1563,8,0,19,6,43247280,3631,24585360,2061,12365
1564,7,0,21,4,43259280,3631,24585360,2060,12372
1565,9,5,17,8,43293960,3631,24586620,2059,12381
1566,8,10,16,9,43321320,3632,24594960,2057,12389
1567,7,16,16,9,43327500,3633,24597480,2058,12396
1568,4,18,16,9,43339020,3633,24607920,2057,12400
1569,14,29,17,8,43352940,3633,24615900,2056,12414
1570,7,30,19,6,43375500,3634,24641340,2056,12421
1571,5,27,24,1,43392720,3635,24680280,2058,12426
1572,9,25,25,0,43435740,3635,24811380,2068,12435
1573,4,8,25,0,43492860,3634,25044240,2087,12439
1574,9,3,18,7,43530600,3630,25164660,2095,12448
1575,13,14,16,9,43551780,3631,25167360,2093,12461
1576,21,34,16,9,43559580,3631,25170360,2090,12482
1577,12,40,15,10,43567500,3632,25170360,2090,12494
1578,19,40,15,10,43586220,3633,25186980,2090,12513
1579,8,40,16,9,43596660,3633,25217280,2092,12521
1580,6,39,20,5,43611300,3634,25308600,2098,12527
1581,6,36,25,0,43632180,3634,25427700,2107,12533
1582,7,34,25,0,43681140,3636,25549800,2116,12540
1583,4,26,25,0,43741620,3637,25710240,2129,12544
1584,3,12,25,0,43788780,3636,25981440,2150,12547
1585,3,0,14,11,43831800,3632,26318580,2178,12550
1586,5,0,16,9,43843800,3632,26318580,2177,12555
1587,6,0,16,9,43855680,3631,26318580,2176,12561
1588,7,0,17,8,43875540,3631,26318580,2175,12568
1589,7,4,17,8,43887420,3631,26318640,2174,12575
1590,6,7,16,9,43905120,3631,26321220,2173,12581
1591,8,1,24,1,43921620,3631,26359260,2174,12589
1592,14,5,18,7,43964400,3629,26360940,2173,12603
1593,11,15,15,10,43988460,3630,26362560,2172,12614
1594,11,22,16,9,44009040,3631,26372520,2169,12625
1595,12,34,16,9,44009040,3631,26372520,2169,12637
1596,9,40,15,10,44031660,3632,26397900,2168,12646
1597,11,40,15,10,44041440,3632,26400780,2168,12657
1598,10,40,15,10,44057400,3633,26419320,2169,12667
1599,10,39,15,10,44063220,3633,26424780,2169,12677
1600,19,40,16,9,44078340,3633,26467080,2172,12696
1601,9,39,18,7,44084460,3634,26528760,2176,12705
1602,9,40,25,0,44092440,3634,26724600,2191,12714
1603,6,40,19,6,44132280,3635,26725500,2191,12720
1604,5,35,21,4,44171160,3636,26912700,2205,12725
1605,5,27,25,0,44205540,3636,27279960,2234,12730
1606,7,22,23,2,44252880,3636,27402240,2243,12737
1607,11,32,16,9,44275620,3636,27403320,2243,12748
1608,8,37,16,9,44299260,3637,27413700,2240,12756
1609,8,40,16,9,44308140,3637,27415860,2240,12764
1610,3,39,16,9,44326200,3638,27428940,2241,12767
1611,6,38,22,3,44334840,3638,27476760,2243,12773
1612,3,21,25,0,44387580,3637,27926520,2280,12776
1613,9,0,19,6,44434200,3630,28808820,2350,12785
1614,3,0,17,8,44447700,3630,28808820,2349,12788
1615,7,0,21,4,44460720,3630,28808820,2348,12795
1616,8,0,20,5,44485740,3630,28808820,2346,12803
1617,9,3,19,6,44514780,3630,28810020,2345,12812
1618,10,13,15,10,44533920,3630,28810020,2345,12822
1619,9,17,17,8,44558760,3631,28830180,2343,12831
1620,14,23,20,5,44576580,3631,28833840,2340,12845
1621,16,25,25,0,44616060,3632,28856220,2339,12861
1622,12,31,22,3,44658600,3633,28889520,2340,12873
1623,6,30,21,4,44687100,3633,28949820,2344,12879
1624,9,33,19,6,44723340,3633,28981440,2345,12888
1625,7,39,16,9,44747220,3634,28984260,2344,12895
1626,11,40,15,10,44779980,3635,29001600,2344,12906
1627,5,40,15,10,44779980,3635,29001600,2344,12911
1628,5,38,18,7,44799720,3636,29044620,2347,12916
1629,6,32,24,1,44816340,3636,29236260,2361,12922
1630,4,14,25,0,44864580,3633,29774100,2404,12926
1631,6,0,16,9,44902200,3628,30148920,2433,12932
1632,1,0,15,10,44913780,3628,30148920,2432,12933
1633,6,0,20,5,44914920,3628,30148920,2431,12939
1634,5,0,17,8,44945100,3628,30148920,2430,12944
1635,6,0,18,7,44957640,3628,30148920,2429,12950
1636,7,0,20,5,44976780,3628,30148920,2428,12957
1637,10,0,20,5,45009780,3628,30148920,2426,12967
1638,7,0,17,8,45035040,3627,30148920,2424,12974
1639,6,0,18,7,45052620,3627,30148920,2423,12980
1640,6,0,20,5,45068280,3627,30148920,2422,12986
1641,11,2,18,7,45108660,3627,30151140,2420,12997
1642,14,10,17,8,45123900,3626,30154740,2419,13011
1643,17,24,17,8,45145200,3627,30160560,2415,13028
1644,13,36,15,10,45164640,3627,30162300,2414,13041
1645,14,37,22,3,45184860,3628,30218580,2415,13055
1646,10,40,25,0,45190260,3628,30236880,2416,13065
1647,3,26,25,0,45270000,3630,30410220,2428,13068
1648,5,17,25,0,45305340,3629,30530820,2437,13073
1649,9,4,25,0,45357840,3626,30815340,2458,13082
1650,11,3,18,7,45388740,3623,30863760,2460,13093
1651,9,8,19,6,45409380,3624,30871440,2458,13102
1652,2,5,20,5,45436500,3625,30891480,2460,13104
1653,6,0,18,7,45471540,3624,30919920,2461,13110
1654,5,2,17,8,45490800,3625,30927000,2460,13115
1655,6,8,15,10,45508380,3625,30927000,2460,13121
1656,5,9,16,9,45531120,3626,30942180,2459,13126
1657,1,10,15,10,45537420,3627,30942180,2459,13127
1658,8,17,16,9,45537420,3627,30943320,2459,13135
1659,6,15,22,3,45554520,3627,30997560,2461,13141
1660,3,2,25,0,45599700,3627,31132620,2471,13144
1661,10,0,23,2,45629880,3626,31152360,2471,13154
1662,7,6,17,8,45659520,3626,31153620,2470,13161
1663,4,4,18,7,45687300,3627,31167000,2470,13165
1664,11,5,24,1,45695820,3626,31182360,2469,13176
1665,8,7,20,5,45742680,3627,31188180,2468,13184
1666,6,9,17,8,45769680,3627,31194660,2467,13190
1667,5,14,14,11,45788160,3628,31194660,2467,13195
1668,8,18,15,10,45809580,3629,31202460,2465,13203
1669,3,19,16,9,45814620,3629,31212660,2465,13206
1670,10,16,25,0,45834000,3629,31268700,2468,13216
1671,6,7,25,0,45873720,3628,31427280,2479,13222
1672,7,11,16,9,45909780,3627,31429260,2478,13229
1673,11,14,21,4,45927000,3628,31438560,2476,13240
1674,9,21,19,6,45944340,3628,31440900,2475,13249
1675,5,26,15,10,45968520,3629,31440900,2475,13254
1676,7,22,22,3,45991500,3629,31489800,2476,13261
1677,5,6,25,0,46035420,3628,31801200,2500,13266
1678,8,4,19,6,46060680,3625,31896780,2506,13274
1679,4,6,17,8,46083840,3626,31905120,2506,13278
1680,6,10,16,9,46107660,3627,31910280,2505,13284
1681,4,11,17,8,46118760,3627,31928220,2505,13288
1682,5,11,20,5,46133460,3628,31943340,2506,13293
1683,10,19,18,7,46157880,3629,31944600,2505,13303
1684,4,23,16,9,46175280,3629,31944600,2505,13307
1685,9,30,15,10,46198620,3630,31956060,2502,13316
1686,11,40,15,10,46198620,3630,31956060,2502,13327
1687,8,40,16,9,46225860,3632,31973340,2501,13335
1688,4,40,16,9,46225860,3632,31973340,2501,13339
1689,6,40,16,9,46253520,3633,32011440,2503,13345
1690,8,40,15,10,46258920,3633,32011440,2503,13353
1691,9,37,23,2,46276860,3633,32167500,2514,13362
1692,9,31,25,0,46319040,3634,32362080,2527,13371
1693,4,22,25,0,46361220,3633,32686140,2552,13375
1694,10,0,21,4,46414320,3627,33339480,2601,13385
1695,7,0,17,8,46446840,3626,33339480,2599,13392
1696,17,2,23,2,46462680,3625,33339660,2596,13409
1697,10,10,16,9,46500600,3626,33342300,2595,13419
1698,3,9,18,7,46512960,3626,33350340,2594,13422
1699,13,15,21,4,46536540,3627,33366660,2594,13435
1700,6,21,17,8,46558260,3627,33366660,2594,13441
1701,6,25,15,10,46587300,3628,33376620,2592,13447
1702,6,27,16,9,46611360,3629,33399540,2592,13453
1703,6,32,16,9,46615380,3629,33404880,2591,13459
1704,1,32,16,9,46624200,3630,33413160,2591,13460
1705,6,29,21,4,46648680,3631,33508500,2598,13466
1706,5,29,22,3,46663200,3631,33592560,2604,13471
1707,5,22,22,3,46709640,3631,33736920,2613,13476
1708,7,19,23,2,46729080,3630,33906120,2625,13483
1709,7,16,23,2,46774320,3630,33991860,2630,13490
1710,10,0,21,4,46819980,3626,34345620,2656,13500
1711,4,0,16,9,46845060,3626,34345620,2655,13504
1712,4,0,16,9,46858140,3625,34345620,2654,13508
1713,8,7,16,9,46860600,3625,34345920,2654,13516
1714,8,14,15,10,46876680,3626,34347420,2652,13524
1715,9,21,15,10,46896120,3627,34360380,2650,13533
1716,11,32,15,10,46896120,3627,34360380,2650,13544
1717,18,40,14,11,46908060,3627,34364580,2647,13562
1718,25,40,14,11,46908060,3627,34364580,2647,13587
1719,8,40,15,10,46927500,3629,34393560,2648,13595
1720,7,40,15,10,46927500,3629,34393560,2648,13602
1721,9,40,16,9,46953360,3630,34466340,2653,13611
1722,5,40,16,9,46959180,3630,34496940,2655,13616
1723,5,37,21,4,46982640,3631,34588680,2661,13621
1724,7,39,25,0,46987380,3631,34710360,2669,13628
1725,5,31,25,0,47062080,3633,34955820,2687,13633
1726,13,33,25,0,47102700,3633,35051520,2692,13646
1727,5,28,25,0,47136900,3633,35253300,2706,13651
1728,6,16,25,0,47210940,3634,35616960,2733,13657
1729,6,0,17,8,47248320,3628,36120840,2770,13663
1730,5,0,17,8,47265060,3628,36120840,2769,13668
1731,10,0,18,7,47292660,3628,36123540,2767,13678
1732,6,0,19,6,47304840,3627,36123540,2766,13684
1733,6,0,18,7,47318460,3626,36123540,2764,13690
1734,5,0,17,8,47336040,3626,36123540,2763,13695
1735,10,0,20,5,47366940,3626,36123540,2761,13705
1736,15,12,18,7,47384220,3626,36125880,2759,13720
1737,14,25,16,9,47399940,3627,36130680,2756,13734
1738,12,26,24,1,47420820,3627,36170520,2756,13746
1739,17,40,23,2,47433780,3627,36182100,2755,13763
1740,15,40,16,9,47491320,3629,36192060,2754,13778
1741,16,40,17,8,47505180,3630,36210960,2755,13794
1742,8,38,25,0,47516160,3630,36263700,2757,13802
1743,6,40,15,10,47558520,3630,36275160,2758,13808
1744,10,40,16,9,47566080,3630,36282720,2757,13818
1745,6,38,20,5,47582820,3631,36379200,2764,13824
1746,9,40,17,8,47611920,3631,36458280,2769,13833
1747,9,40,15,10,47631240,3631,36460980,2768,13842
1748,5,38,16,9,47644320,3632,36499080,2771,13847
1749,6,33,22,3,47663760,3632,36752220,2789,13853
1750,4,18,25,0,47704080,3631,37434720,2840,13857
1751,6,0,18,7,47739420,3625,37940700,2877,13863
1752,4,0,17,8,47756160,3625,37940700,2876,13867
1753,4,0,16,9,47778540,3625,37940700,2875,13871
1754,8,4,16,9,47785680,3624,37940820,2874,13879
1755,7,9,16,9,47800680,3625,37944000,2873,13886
1756,8,16,15,10,47818560,3626,37945440,2872,13894
1757,7,18,18,7,47834760,3626,37961640,2870,13901
1758,2,15,20,5,47848020,3627,37974900,2871,13903
1759,11,6,25,0,47890020,3626,38097600,2877,13914
1760,5,0,20,5,47916660,3623,38172660,2882,13919
1761,7,1,19,6,47946960,3624,38173260,2881,13926
1762,17,15,16,9,47981460,3625,38176080,2879,13943
1763,8,22,16,9,47987520,3625,38180880,2876,13951
1764,12,32,15,10,48011880,3626,38193360,2875,13963
1765,13,40,16,9,48016380,3626,38209920,2875,13976
1766,17,39,16,9,48035220,3626,38239320,2875,13993
1767,10,40,16,9,48046560,3627,38248440,2875,14003
1768,13,39,17,8,48059460,3627,38273820,2876,14016
1769,9,40,21,4,48068940,3628,38301480,2877,14025
1770,6,35,25,0,48106980,3629,38458380,2888,14031
1771,7,35,25,0,48139560,3629,38553360,2894,14038
1772,11,37,16,9,48211080,3630,38695140,2903,14049
1773,3,38,15,10,48231000,3631,38733780,2904,14052
1774,6,40,14,11,48239040,3631,38733960,2904,14058
1775,7,39,16,9,48245220,3631,38746320,2904,14065
1776,8,37,22,3,48263400,3631,38841780,2909,14073
1777,5,37,19,6,48291360,3631,38940960,2916,14078
1778,3,25,22,3,48324000,3630,39452880,2953,14081
1779,4,0,19,6,48361500,3625,40293720,3015,14085
1780,5,0,16,9,48381000,3624,40293720,3014,14090
1781,9,0,18,7,48395700,3623,40293720,3012,14099
1782,7,0,18,7,48424200,3623,40293720,3011,14106
1783,8,0,21,4,48436200,3623,40293720,3009,14114
1784,3,0,18,7,48452820,3622,40293720,3008,14117
1785,6,0,17,8,48488040,3623,40293720,3007,14123
1786,6,2,17,8,48499020,3623,40294200,3006,14129
1787,15,13,17,8,48522720,3624,40298880,3003,14144
1788,8,19,17,8,48535560,3624,40303800,3002,14152
1789,11,28,15,10,48562920,3625,40308000,2999,14163
1790,8,30,20,5,48569040,3625,40361700,3001,14171
1791,5,30,23,2,48580080,3625,40403640,3003,14176
1792,9,29,25,0,48624480,3627,40451640,3005,14185
1793,7,31,18,7,48676140,3627,40504320,3008,14192
1794,12,40,14,11,48706140,3628,40504320,3008,14204
1795,7,40,15,10,48716280,3629,40519380,3006,14211
1796,11,39,16,9,48732540,3629,40544940,3007,14222
1797,3,39,18,7,48739020,3630,40554060,3007,14225
1798,5,38,22,3,48752220,3630,40602240,3010,14230
1799,5,36,19,6,48796740,3631,40709160,3017,14235
1800,4,36,17,8,48825240,3631,40713480,3016,14239
1801,9,40,16,9,48831180,3631,40713480,3016,14248
1802,10,37,24,1,48854160,3632,40834860,3022,14258
1803,6,31,25,0,48896640,3632,41068380,3038,14264
1804,3,5,25,0,48940140,3628,42183720,3120,14267
1805,12,2,19,6,48979740,3625,42334140,3128,14279
1806,7,6,18,7,48999660,3625,42335160,3127,14286
1807,9,9,19,6,49028820,3626,42345720,3126,14295
1808,10,18,17,8,49037280,3626,42346500,3125,14305
1809,4,19,16,9,49069800,3627,42357660,3123,14309
1810,9,22,20,5,49083480,3628,42366600,3122,14318
1811,11,24,23,2,49110900,3628,42398340,3121,14329
1812,12,32,18,7,49146180,3628,42422880,3121,14341
1813,7,37,16,9,49171680,3629,42427860,3119,14348
1814,12,40,15,10,49180560,3630,42427860,3119,14360
1815,6,40,16,9,49188900,3630,42442860,3119,14366
1816,10,40,15,10,49208100,3631,42451800,3120,14376
1817,7,40,15,10,49222440,3631,42454980,3120,14383
1818,8,40,16,9,49227480,3631,42478860,3121,14391
1819,7,40,20,5,49244700,3632,42538020,3124,14398
1820,6,40,19,6,49247460,3632,42538020,3124,14404
1821,9,31,25,0,49306320,3634,42851700,3145,14413
1822,4,3,25,0,49356840,3629,43984440,3227,14417
1823,4,0,15,10,49390380,3627,44063520,3232,14421
1824,5,0,18,7,49400220,3627,44063520,3231,14426
1825,4,0,14,11,49424220,3626,44063520,3230,14430
1826,5,0,17,8,49428180,3626,44063520,3229,14435
1827,4,0,18,7,49437660,3626,44063520,3228,14439
1828,4,0,17,8,49450380,3626,44063520,3227,14443
1829,5,0,19,6,49466160,3626,44063520,3225,14448
1830,4,0,14,11,49501500,3626,44063520,3225,14452
1831,11,0,20,5,49510500,3626,44063520,3222,14463
1832,8,0,20,5,49532220,3625,44063520,3220,14471
1833,7,0,20,5,49564680,3626,44063520,3218,14478
1834,9,4,18,7,49591080,3626,44065560,3216,14487
1835,7,10,16,9,49605180,3626,44067360,3216,14494
1836,12,20,15,10,49625040,3627,44069580,3213,14506
1837,11,28,16,9,49638960,3627,44079420,3211,14517
1838,10,37,16,9,49647780,3627,44085240,3209,14527
1839,11,40,16,9,49662840,3628,44091540,3208,14538
1840,13,39,16,9,49678260,3629,44115720,3209,14551
1841,8,40,17,8,49684080,3629,44143560,3211,14559
1842,11,38,18,7,49709460,3630,44205180,3214,14570
1843,7,39,22,3,49719360,3630,44239680,3215,14577
1844,5,37,18,7,49763760,3631,44328780,3221,14582
1845,7,35,25,0,49776420,3631,44460840,3229,14589
1846,9,29,25,0,49828740,3631,44772720,3250,14598
1847,9,20,25,0,49871340,3629,45049500,3268,14607
1848,5,0,18,7,49921860,3624,45554040,3303,14612
1849,5,0,17,8,49942080,3624,45554040,3302,14617
1850,9,0,19,6,49956600,3623,45554040,3300,14626
1851,6,0,18,7,49974240,3623,45554040,3298,14632
1852,5,0,17,8,49996380,3623,45554040,3297,14637
1853,3,0,16,9,50013660,3623,45554040,3296,14640
1854,4,0,16,9,50023500,3623,45554040,3295,14644
1855,12,1,21,4,50039220,3622,45554100,3292,14656
1856,13,6,18,7,50077260,3622,45555300,3290,14669
1857,6,11,15,10,50101740,3623,45559500,3289,14675
1858,8,10,22,3,50115780,3623,45574080,3288,14683
1859,5,4,25,0,50147400,3624,45628380,3290,14688
1860,14,8,17,8,50193060,3622,45658620,3291,14702
1861,13,20,16,9,50205360,3623,45662340,3287,14715
1862,19,37,15,10,50234160,3624,45669420,3284,14734
1863,9,40,15,10,50240820,3624,45673380,3282,14743
1864,11,40,15,10,50254080,3625,45682740,3282,14754
1865,14,40,15,10,50267820,3625,45706140,3283,14768
1866,6,37,20,5,50287080,3626,45821580,3290,14774
1867,10,39,25,0,50296380,3626,45859440,3291,14784
1868,7,37,24,1,50341740,3627,45948540,3296,14791
1869,4,27,25,0,50391360,3627,46177920,3311,14795
1870,5,20,25,0,50432400,3627,46397940,3326,14800
1871,9,0,18,7,50494860,3622,46881120,3358,14809
1872,4,0,18,7,50502720,3622,46881480,3358,14813
1873,1,0,15,10,50521260,3622,46881480,3357,14814
1874,3,0,13,12,50543520,3622,46881480,3357,14817
1875,5,0,15,10,50550060,3622,46881480,3355,14822
1876,3,0,17,8,50554920,3622,46881480,3355,14825
1877,7,0,20,5,50566260,3622,46881480,3353,14832
1878,9,0,19,6,50602680,3622,46881480,3351,14841
1879,6,0,17,8,50628480,3622,46881480,3349,14847
1880,8,0,18,7,50649720,3621,46881480,3347,14855
1881,8,0,22,3,50664840,3621,46881840,3346,14863
1882,14,2,24,1,50691840,3621,46882440,3342,14877
1883,13,14,17,8,50723700,3621,46883040,3342,14890
1884,4,9,21,4,50753700,3622,46909320,3340,14894
1885,13,17,21,4,50782560,3622,46915500,3338,14907
1886,16,31,16,9,50819940,3623,46919520,3334,14923
1887,9,38,16,9,50833860,3624,46926780,3333,14932
1888,15,39,15,10,50848200,3624,46931940,3332,14947
1889,15,40,20,5,50860620,3625,46958280,3332,14962
1890,11,40,18,7,50868780,3625,46958280,3332,14973
1891,8,35,23,2,50909640,3626,47113680,3342,14981
1892,7,29,25,0,50950860,3626,47265180,3351,14988
1893,8,14,25,0,51010080,3624,47665800,3377,14996
1894,6,0,18,7,51040020,3620,47968860,3397,15002
1895,5,0,18,7,51051900,3619,47968860,3396,15007
1896,3,0,16,9,51066780,3619,47968860,3396,15010
1897,7,0,18,7,51089040,3619,47968860,3394,15017
1898,7,0,18,7,51098940,3618,47968860,3392,15024
1899,5,0,16,9,51117840,3618,47968860,3391,15029
1900,4,0,18,7,51119520,3617,47968860,3390,15033
1901,5,0,18,7,51143040,3618,47968860,3389,15038
1902,10,2,20,5,51165360,3618,47969220,3387,15048
1903,2,2,17,8,51190200,3618,47973240,3386,15050
1904,11,8,16,9,51212880,3618,47977920,3385,15061
1905,11,18,15,10,51227100,3619,47978280,3384,15072
1906,8,24,15,10,51242700,3619,47993100,3380,15080
1907,12,36,15,10,51242700,3619,47993100,3380,15092
1908,8,40,15,10,51268500,3620,48009960,3377,15100
1909,8,39,15,10,51274740,3621,48013380,3377,15108
1910,5,40,17,8,51274740,3621,48020100,3377,15113
1911,18,40,25,0,51299520,3621,48156360,3385,15131
1912,12,37,25,0,51340140,3622,48238260,3388,15143
1913,7,33,25,0,51391500,3623,48348180,3395,15150
1914,6,24,25,0,51449340,3623,48621060,3412,15156
1915,8,6,25,0,51495000,3620,49101600,3444,15164
1916,5,5,18,7,51528600,3619,49108080,3443,15169
1917,10,0,19,6,51554460,3617,49254420,3451,15179
1918,3,0,16,9,51574560,3617,49254420,3450,15182
1919,4,0,15,10,51593040,3617,49254420,3449,15186
1920,4,0,16,9,51602100,3617,49254420,3448,15190
1921,9,0,17,8,51628500,3617,49254420,3446,15199
1922,6,0,16,9,51651540,3617,49254420,3445,15205
1923,5,0,18,7,51658560,3616,49254420,3444,15210
1924,5,0,16,9,51683160,3616,49254420,3442,15215
1925,4,0,17,8,51692340,3616,49255560,3442,15219
1926,7,0,20,5,51706440,3616,49255560,3440,15226
1927,9,8,16,9,51730800,3617,49257780,3439,15235
1928,4,11,16,9,51741900,3617,49263840,3438,15239
1929,7,17,15,10,51758160,3618,49270980,3437,15246
1930,11,28,15,10,51758160,3618,49270980,3437,15257
1931,11,35,16,9,51790260,3619,49296600,3433,15268
1932,19,40,16,9,51790260,3619,49296600,3433,15287
1933,8,40,16,9,51800340,3619,49319340,3433,15295
1934,12,40,16,9,51817800,3620,49336680,3434,15307
1935,6,37,21,4,51835860,3621,49454940,3440,15313
1936,7,39,20,5,51865680,3621,49501620,3442,15320
1937,8,39,19,6,51898020,3622,49557600,3445,15328
1938,7,37,22,3,51908580,3622,49592280,3446,15335
1939,7,31,25,0,51955320,3623,49803660,3459,15342
1940,6,21,25,0,52003740,3622,50206860,3486,15348
1941,5,0,23,2,52061220,3619,50799900,3526,15353
1942,9,0,19,6,52080960,3617,50799900,3523,15362
1943,8,0,20,5,52107420,3617,50799900,3521,15370
1944,7,0,19,6,52135380,3617,50799900,3520,15377
1945,5,0,19,6,52163040,3618,50799900,3518,15382
1946,5,0,18,7,52186740,3618,50799900,3517,15387
1947,9,4,17,8,52204860,3618,50799960,3516,15396
1948,6,7,17,8,52232520,3619,50812320,3514,15402
1949,7,9,19,6,52251960,3619,50815020,3513,15409
1950,6,14,15,10,52277520,3620,50816400,3513,15415
1951,6,19,15,10,52286400,3620,50824380,3511,15421
1952,7,25,15,10,52295640,3621,50827740,3509,15428
1953,11,34,16,9,52308420,3621,50835600,3507,15439
1954,12,40,14,11,52324740,3622,50835600,3507,15451
1955,11,39,15,10,52331160,3622,50861520,3507,15462
1956,7,40,14,11,52340820,3622,50861520,3507,15469
1957,20,40,14,11,52340820,3622,50861520,3507,15489
1958,11,39,15,10,52360260,3623,50914740,3510,15500
1959,13,40,16,9,52360260,3623,50936640,3511,15513
1960,14,38,22,3,52381260,3624,51130440,3523,15527
1961,7,40,24,1,52393140,3624,51168060,3524,15534
1962,12,40,16,9,52437540,3625,51168060,3524,15546
1963,2,40,13,12,52466460,3626,51173640,3524,15548
1964,3,40,13,12,52466460,3626,51173640,3524,15551
1965,8,39,18,7,52480800,3627,51216420,3526,15559
1966,3,36,21,4,52489440,3627,51418320,3539,15562
1967,4,25,25,0,52525980,3627,52082280,3584,15566
1968,7,23,18,7,52564800,3625,52435380,3606,15573
1969,7,25,19,6,52585680,3626,52440720,3605,15580
1970,5,15,24,1,52605360,3625,52922100,3637,15585
1971,1,0,13,12,52653060,3621,53372040,3667,15586
1972,4,0,14,11,52670040,3622,53372040,3666,15590
1973,5,0,16,9,52675620,3621,53372040,3665,15595
1974,5,0,15,10,52689960,3621,53372040,3664,15600
1975,2,0,14,11,52696560,3621,53372040,3663,15602
1976,5,0,16,9,52708260,3621,53372040,3662,15607
1977,7,0,19,6,52721640,3620,53372040,3660,15614
1978,14,11,17,8,52737540,3620,53373480,3658,15628
1979,12,22,15,10,52754700,3621,53378400,3655,15640
1980,10,31,15,10,52765020,3621,53387700,3652,15650
1981,17,40,16,9,52774440,3622,53401200,3652,15667
1982,12,40,15,10,52793580,3622,53422320,3652,15679
1983,10,40,16,9,52801680,3623,53448600,3653,15689
1984,10,38,23,2,52816560,3623,53552100,3658,15699
1985,22,40,25,0,52839180,3624,53590980,3659,15721
1986,6,33,25,0,52905780,3625,53737500,3667,15727
1987,10,38,17,8,52957020,3625,53774100,3668,15737
1988,9,40,15,10,52969020,3626,53774100,3668,15746
1989,7,40,15,10,52985160,3626,53787120,3667,15753
1990,3,39,15,10,52999680,3627,53805600,3668,15756
1991,11,40,20,5,53004720,3627,53895180,3673,15767
1992,3,35,21,4,53023680,3626,54035760,3682,15770
1993,5,33,18,7,53073660,3627,54134580,3687,15775
1994,6,37,16,9,53088360,3627,54135960,3686,15781
1995,3,37,16,9,53107260,3628,54148740,3686,15784
1996,4,35,20,5,53124720,3628,54234960,3690,15788
1997,8,31,25,0,53143020,3628,54475740,3705,15796
1998,5,33,18,7,53176620,3628,54537780,3708,15801
1999,10,40,14,11,53214180,3629,54538380,3707,15811
2000,8,40,14,11,53214180,3629,54538380,3707,15819
2001,13,40,15,10,53223540,3630,54557400,3707,15832
2002,6,40,14,11,53228820,3630,54557400,3707,15838
2003,6,39,15,10,53245740,3631,54583620,3708,15844
2004,8,40,14,11,53255880,3631,54583620,3708,15852
2005,12,40,14,11,53255880,3631,54583620,3708,15864
2006,9,38,19,6,53274300,3632,54709680,3715,15873
2007,12,38,21,4,53287080,3632,54723480,3715,15885
2008,13,40,21,4,53318220,3632,54796380,3718,15898
2009,7,37,22,3,53355660,3633,54831180,3718,15905
2010,9,33,25,0,53398680,3633,54875100,3719,15914
2011,11,30,18,7,53447580,3631,55342080,3748,15925
2012,8,37,16,9,53460780,3632,55346220,3746,15933
2013,8,39,18,7,53481480,3632,55352280,3745,15941
2014,4,40,15,10,53511480,3633,55357440,3744,15945
2015,5,40,16,9,53523240,3633,55376100,3745,15950
2016,6,39,16,9,53537520,3634,55391580,3745,15956
2017,2,38,18,7,53539020,3633,55398780,3745,15958
2018,12,40,18,7,53545440,3633,55399080,3745,15970
2019,8,40,17,8,53549880,3633,55399080,3745,15978
2020,5,36,22,3,53568840,3634,55486740,3749,15983
2021,4,38,20,5,53585880,3634,55520880,3751,15987
2022,4,39,16,9,53612220,3634,55526100,3750,15991
2023,9,40,17,8,53612220,3634,55529160,3750,16000
2024,11,40,17,8,53618100,3635,55537860,3751,16011
2025,5,40,17,8,53626500,3635,55540440,3750,16016
2026,10,40,17,8,53626500,3635,55540440,3750,16026
2027,19,39,18,7,53643600,3636,55566180,3751,16045
2028,9,40,16,9,53647560,3635,55566180,3751,16054
2029,10,39,21,4,53654340,3636,55595580,3752,16064
2030,6,37,18,7,53669160,3634,55962660,3776,16070
2031,7,40,16,9,53684940,3634,55962660,3776,16077
2032,6,40,16,9,53684940,3634,55962660,3776,16083
2033,12,39,19,6,53695020,3635,55981920,3775,16095
2034,5,35,24,1,53699160,3634,56314860,3796,16100
2035,5,29,19,6,53726340,3632,57496800,3875,16105
2036,8,34,19,6,53746080,3633,57498780,3874,16113
2037,9,40,17,8,53755140,3633,57498780,3874,16122
2038,8,40,16,9,53768760,3633,57503460,3871,16130
2039,2,39,16,9,53774940,3633,57513480,3872,16132
2040,6,40,16,9,53774940,3633,57513480,3872,16138
2041,9,40,17,8,53781060,3634,57531600,3872,16147
2042,8,40,17,8,53781060,3634,57531600,3872,16155
2043,6,39,22,3,53787540,3634,57585540,3874,16161
2044,4,36,25,0,53803740,3634,57698160,3881,16165
2045,8,34,19,6,53850900,3633,58113360,3907,16173
2046,7,40,17,8,53865120,3633,58116240,3906,16180
2047,5,40,16,9,53871300,3634,58116240,3906,16185
2048,9,40,15,10,53877840,3634,58116240,3906,16194
2049,7,40,15,10,53877840,3634,58116240,3906,16201
2050,7,40,15,10,53877840,3634,58116240,3906,16208
2051,16,40,15,10,53877840,3634,58116240,3906,16224
2052,14,40,15,10,53877840,3634,58116240,3906,16238
2053,11,40,15,10,53877840,3634,58116240,3906,16249
2054,8,40,15,10,53877840,3634,58116240,3906,16257
2055,13,40,15,10,53877840,3634,58116240,3906,16270
2056,8,40,15,10,53877840,3634,58116240,3906,16278
2057,1,40,15,10,53877840,3634,58116240,3906,16279
2058,13,40,15,10,53877840,3634,58116240,3906,16292
2059,9,40,15,10,53877840,3634,58116240,3906,16301
2060,6,40,15,10,53877840,3634,58116240,3906,16307
2061,7,40,15,10,53877840,3634,58116240,3906,16314
2062,8,40,15,10,53877840,3634,58116240,3906,16322
2063,7,40,15,10,53877840,3634,58116240,3906,16329
2064,4,40,15,10,53877840,3634,58116240,3906,16333
2065,4,40,15,10,53877840,3634,58116240,3906,16337
2066,2,40,15,10,53877840,3634,58116240,3906,16339
2067,12,40,15,10,53877840,3634,58116240,3906,16351
2068,6,40,15,10,53877840,3634,58116240,3906,16357
2069,7,40,15,10,53877840,3634,58116240,3906,16364
2070,7,40,15,10,53877840,3634,58116240,3906,16371
2071,8,40,15,10,53877840,3634,58116240,3906,16379
2072,7,40,15,10,53877840,3634,58116240,3906,16386
2073,15,40,15,10,53877840,3634,58116240,3906,16401
2074,12,40,15,10,53877840,3634,58116240,3906,16413
2075,17,40,15,10,53877840,3634,58116240,3906,16430
2076,8,40,15,10,53877840,3634,58116240,3906,16438
2077,6,40,15,10,53877840,3634,58116240,3906,16444
2078,12,40,15,10,53877840,3634,58116240,3906,16456
2079,9,40,15,10,53877840,3634,58116240,3906,16465
2080,8,40,15,10,53877840,3634,58116240,3906,16473
2081,9,40,15,10,53877840,3634,58116240,3906,16482
2082,7,40,15,10,53877840,3634,58116240,3906,16489
2083,5,40,15,10,53877840,3634,58116240,3906,16494
2084,4,40,15,10,53877840,3634,58116240,3906,16498
2085,8,40,15,10,53877840,3634,58116240,3906,16506
2086,10,40,15,10,53877840,3634,58116240,3906,16516
2087,7,40,15,10,53877840,3634,58116240,3906,16523
2088,10,40,15,10,53877840,3634,58116240,3906,16533
2089,5,40,15,10,53877840,3634,58116240,3906,16538
2090,5,40,15,10,53877840,3634,58116240,3906,16543
2091,4,40,15,10,53877840,3634,58116240,3906,16547
2092,9,40,15,10,53877840,3634,58116240,3906,16556
2093,3,40,15,10,53877840,3634,58116240,3906,16559
2094,5,40,15,10,53877840,3634,58116240,3906,16564
2095,5,40,15,10,53877840,3634,58116240,3906,16569
2096,5,40,15,10,53877840,3634,58116240,3906,16574
2097,13,40,15,10,53877840,3634,58116240,3906,16587
2098,11,40,15,10,53877840,3634,58116240,3906,16598
2099,11,40,15,10,53877840,3634,58116240,3906,16609
2100,16,40,15,10,53877840,3634,58116240,3906,16625
2101,18,40,15,10,53877840,3634,58116240,3906,16643
2102,5,40,15,10,53877840,3634,58116240,3906,16648
2103,9,40,15,10,53877840,3634,58116240,3906,16657
2104,8,40,15,10,53877840,3634,58116240,3906,16665
2105,10,40,15,10,53877840,3634,58116240,3906,16675
2106,11,40,15,10,53877840,3634,58116240,3906,16686
2107,7,40,15,10,53877840,3634,58116240,3906,16693
2108,7,40,15,10,53877840,3634,58116240,3906,16700
2109,8,40,15,10,53877840,3634,58116240,3906,16708
2110,7,40,15,10,53877840,3634,58116240,3906,16715
2111,5,40,15,10,53877840,3634,58116240,3906,16720
2112,9,40,15,10,53877840,3634,58116240,3906,16729
2113,3,40,15,10,53877840,3634,58116240,3906,16732
2114,2,40,15,10,53877840,3634,58116240,3906,16734
2115,7,40,15,10,53877840,3634,58116240,3906,16741
2116,1,40,15,10,53877840,3634,58116240,3906,16742
2117,8,40,15,10,53877840,3634,58116240,3906,16750
2118,8,40,15,10,53877840,3634,58116240,3906,16758
2119,6,40,15,10,53877840,3634,58116240,3906,16764
2120,6,40,15,10,53877840,3634,58116240,3906,16770
2121,11,40,15,10,53877840,3634,58116240,3906,16781
2122,14,40,15,10,53877840,3634,58116240,3906,16795
2123,10,40,15,10,53877840,3634,58116240,3906,16805
2124,8,40,15,10,53877840,3634,58116240,3906,16813
2125,10,40,15,10,53877840,3634,58116240,3906,16823
2126,7,40,15,10,53877840,3634,58116240,3906,16830
2127,14,40,15,10,53877840,3634,58116240,3906,16844
2128,11,40,15,10,53877840,3634,58116240,3906,16855
2129,7,40,15,10,53877840,3634,58116240,3906,16862
2130,10,40,15,10,53877840,3634,58116240,3906,16872
2131,4,40,15,10,53877840,3634,58116240,3906,16876
2132,6,40,15,10,53877840,3634,58116240,3906,16882
2133,9,40,15,10,53877840,3634,58116240,3906,16891
2134,4,40,15,10,53877840,3634,58116240,3906,16895
2135,8,40,15,10,53877840,3634,58116240,3906,16903
2136,8,40,15,10,53877840,3634,58116240,3906,16911
2137,4,40,15,10,53877840,3634,58116240,3906,16915
2138,3,40,15,10,53877840,3634,58116240,3906,16918
2139,8,40,15,10,53877840,3634,58116240,3906,16926
2140,7,40,15,10,53877840,3634,58116240,3906,16933
2141,3,40,15,10,53877840,3634,58116240,3906,16936
2142,7,40,15,10,53877840,3634,58116240,3906,16943
2143,15,40,15,10,53877840,3634,58116240,3906,16958
2144,12,40,15,10,53877840,3634,58116240,3906,16970
2145,8,40,15,10,53877840,3634,58116240,3906,16978
2146,10,40,15,10,53877840,3634,58116240,3906,16988
2147,8,40,15,10,53877840,3634,58116240,3906,16996
2148,9,40,15,10,53877840,3634,58116240,3906,17005
2149,7,40,15,10,53877840,3634,58116240,3906,17012
2150,10,40,15,10,53877840,3634,58116240,3906,17022
2151,16,40,15,10,53877840,3634,58116240,3906,17038
2152,10,40,15,10,53877840,3634,58116240,3906,17048
2153,6,40,15,10,53877840,3634,58116240,3906,17054
2154,8,40,15,10,53877840,3634,58116240,3906,17062
2155,7,40,15,10,53877840,3634,58116240,3906,17069
2156,11,40,15,10,53877840,3634,58116240,3906,17080
2157,8,40,15,10,53877840,3634,58116240,3906,17088
2158,7,40,15,10,53877840,3634,58116240,3906,17095
2159,8,40,15,10,53877840,3634,58116240,3906,17103
2160,4,40,15,10,53877840,3634,58116240,3906,17107
2161,4,40,15,10,53877840,3634,58116240,3906,17111
2162,6,40,15,10,53877840,3634,58116240,3906,17117
2163,7,40,15,10,53877840,3634,58116240,3906,17124
2164,3,40,15,10,53877840,3634,58116240,3906,17127
2165,5,40,15,10,53877840,3634,58116240,3906,17132
2166,6,40,15,10,53877840,3634,58116240,3906,17138
2167,7,40,15,10,53877840,3634,58116240,3906,17145
2168,9,40,15,10,53877840,3634,58116240,3906,17154
2169,8,40,15,10,53877840,3634,58116240,3906,17162
2170,8,40,15,10,53877840,3634,58116240,3906,17170
2171,9,40,15,10,53877840,3634,58116240,3906,17179
2172,8,40,15,10,53877840,3634,58116240,3906,17187
2173,10,40,15,10,53877840,3634,58116240,3906,17197
2174,7,40,15,10,53877840,3634,58116240,3906,17204
2175,13,40,15,10,53877840,3634,58116240,3906,17217
2176,6,40,15,10,53877840,3634,58116240,3906,17223
2177,15,40,15,10,53877840,3634,58116240,3906,17238
2178,2,40,15,10,53877840,3634,58116240,3906,17240
2179,5,40,15,10,53877840,3634,58116240,3906,17245
2180,2,40,15,10,53877840,3634,58116240,3906,17247
2181,4,40,15,10,53877840,3634,58116240,3906,17251
2182,2,40,15,10,53877840,3634,58116240,3906,17253
2183,7,40,15,10,53877840,3634,58116240,3906,17260
2184,9,40,15,10,53877840,3634,58116240,3906,17269
2185,5,40,15,10,53877840,3634,58116240,3906,17274
2186,10,40,15,10,53877840,3634,58116240,3906,17284
2187,2,40,15,10,53877840,3634,58116240,3906,17286
2188,5,40,15,10,53877840,3634,58116240,3906,17291
2189,8,40,15,10,53877840,3634,58116240,3906,17299
2190,7,40,15,10,53877840,3634,58116240,3906,17306
2191,11,40,15,10,53877840,3634,58116240,3906,17317
2192,10,40,15,10,53877840,3634,58116240,3906,17327
2193,10,40,15,10,53877840,3634,58116240,3906,17337
2194,5,40,15,10,53877840,3634,58116240,3906,17342
2195,8,40,15,10,53877840,3634,58116240,3906,17350
2196,10,40,15,10,53877840,3634,58116240,3906,17360
2197,7,40,15,10,53877840,3634,58116240,3906,17367
2198,4,40,15,10,53877840,3634,58116240,3906,17371
2199,8,40,15,10,53877840,3634,58116240,3906,17379
2200,11,40,15,10,53877840,3634,58116240,3906,17390
2201,10,40,15,10,53877840,3634,58116240,3906,17400
2202,7,40,15,10,53877840,3634,58116240,3906,17407
2203,13,40,15,10,53877840,3634,58116240,3906,17420
2204,5,40,15,10,53877840,3634,58116240,3906,17425
2205,2,40,15,10,53877840,3634,58116240,3906,17427
2206,5,40,15,10,53877840,3634,58116240,3906,17432
2207,6,40,15,10,53877840,3634,58116240,3906,17438
2208,5,40,15,10,53877840,3634,58116240,3906,17443
2209,4,40,15,10,53877840,3634,58116240,3906,17447
2210,1,40,15,10,53877840,3634,58116240,3906,17448
2211,7,40,15,10,53877840,3634,58116240,3906,17455
2212,4,40,15,10,53877840,3634,58116240,3906,17459
2213,11,40,15,10,53877840,3634,58116240,3906,17470
2214,6,40,15,10,53877840,3634,58116240,3906,17476
2215,10,40,15,10,53877840,3634,58116240,3906,17486
2216,8,40,15,10,53877840,3634,58116240,3906,17494
2217,8,40,15,10,53877840,3634,58116240,3906,17502
2218,10,40,15,10,53877840,3634,58116240,3906,17512
2219,8,40,15,10,53877840,3634,58116240,3906,17520
2220,5,40,15,10,53877840,3634,58116240,3906,17525
2221,13,40,15,10,53877840,3634,58116240,3906,17538
2222,10,40,15,10,53877840,3634,58116240,3906,17548
2223,9,40,15,10,53877840,3634,58116240,3906,17557
2224,8,40,15,10,53877840,3634,58116240,3906,17565
2225,12,40,15,10,53877840,3634,58116240,3906,17577
2226,7,40,15,10,53877840,3634,58116240,3906,17584
2227,8,40,15,10,53877840,3634,58116240,3906,17592
2228,6,40,15,10,53877840,3634,58116240,3906,17598
2229,6,40,15,10,53877840,3634,58116240,3906,17604
2230,7,40,15,10,53877840,3634,58116240,3906,17611
2231,9,40,15,10,53877840,3634,58116240,3906,17620
2232,6,40,15,10,53877840,3634,58116240,3906,17626
2233,7,40,15,10,53877840,3634,58116240,3906,17633
2234,4,40,15,10,53877840,3634,58116240,3906,17637
2235,6,40,15,10,53877840,3634,58116240,3906,17643
2236,6,40,15,10,53877840,3634,58116240,3906,17649
2237,6,40,15,10,53877840,3634,58116240,3906,17655
2238,8,40,15,10,53877840,3634,58116240,3906,17663
2239,11,40,15,10,53877840,3634,58116240,3906,17674
2240,6,40,15,10,53877840,3634,58116240,3906,17680
2241,21,40,15,10,53877840,3634,58116240,3906,17701
2242,3,40,15,10,53877840,3634,58116240,3906,17704
2243,8,40,15,10,53877840,3634,58116240,3906,17712
2244,6,40,15,10,53877840,3634,58116240,3906,17718
2245,14,40,15,10,53877840,3634,58116240,3906,17732
2246,10,40,15,10,53877840,3634,58116240,3906,17742
2247,14,40,15,10,53877840,3634,58116240,3906,17756
2248,11,40,15,10,53877840,3634,58116240,3906,17767
2249,7,40,15,10,53877840,3634,58116240,3906,17774
2250,8,40,15,10,53877840,3634,58116240,3906,17782
2251,5,40,15,10,53877840,3634,58116240,3906,17787
2252,3,40,15,10,53877840,3634,58116240,3906,17790
2253,7,40,15,10,53877840,3634,58116240,3906,17797
2254,7,40,15,10,53877840,3634,58116240,3906,17804
2255,10,40,15,10,53877840,3634,58116240,3906,17814
2256,5,40,15,10,53877840,3634,58116240,3906,17819
2257,4,40,15,10,53877840,3634,58116240,3906,17823
2258,1,40,15,10,53877840,3634,58116240,3906,17824
2259,3,40,15,10,53877840,3634,58116240,3906,17827
2260,2,40,15,10,53877840,3634,58116240,3906,17829
2261,6,40,15,10,53877840,3634,58116240,3906,17835
2262,6,40,15,10,53877840,3634,58116240,3906,17841
2263,7,40,15,10,53877840,3634,58116240,3906,17848
2264,10,40,15,10,53877840,3634,58116240,3906,17858
2265,18,40,15,10,53877840,3634,58116240,3906,17876
2266,4,40,15,10,53877840,3634,58116240,3906,17880
2267,10,40,15,10,53877840,3634,58116240,3906,17890
2268,12,40,15,10,53877840,3634,58116240,3906,17902
2269,10,40,15,10,53877840,3634,58116240,3906,17912
2270,7,40,15,10,53877840,3634,58116240,3906,17919
2271,12,40,15,10,53877840,3634,58116240,3906,17931
2272,6,40,15,10,53877840,3634,58116240,3906,17937
2273,13,40,15,10,53877840,3634,58116240,3906,17950
2274,12,40,15,10,53877840,3634,58116240,3906,17962
2275,5,40,15,10,53877840,3634,58116240,3906,17967
2276,1,40,15,10,53877840,3634,58116240,3906,17968
2277,10,40,15,10,53877840,3634,58116240,3906,17978
2278,7,40,15,10,53877840,3634,58116240,3906,17985
2279,5,40,15,10,53877840,3634,58116240,3906,17990
2280,6,40,15,10,53877840,3634,58116240,3906,17996
2281,4,40,15,10,53877840,3634,58116240,3906,18000
2282,3,40,15,10,53877840,3634,58116240,3906,18003
2283,4,40,15,10,53877840,3634,58116240,3906,18007
2284,5,40,15,10,53877840,3634,58116240,3906,18012
2285,7,40,15,10,53877840,3634,58116240,3906,18019
2286,4,40,15,10,53877840,3634,58116240,3906,18023
2287,6,40,15,10,53877840,3634,58116240,3906,18029
2288,7,40,15,10,53877840,3634,58116240,3906,18036
2289,17,40,15,10,53877840,3634,58116240,3906,18053
2290,3,40,15,10,53877840,3634,58116240,3906,18056
2291,11,40,15,10,53877840,3634,58116240,3906,18067
2292,15,40,15,10,53877840,3634,58116240,3906,18082
2293,11,40,15,10,53877840,3634,58116240,3906,18093
2294,8,40,15,10,53877840,3634,58116240,3906,18101
2295,6,40,15,10,53877840,3634,58116240,3906,18107
2296,8,40,15,10,53877840,3634,58116240,3906,18115
2297,14,40,15,10,53877840,3634,58116240,3906,18129
2298,3,40,15,10,53877840,3634,58116240,3906,18132
2299,10,40,15,10,53877840,3634,58116240,3906,18142
2300,10,40,15,10,53877840,3634,58116240,3906,18152
2301,9,40,15,10,53877840,3634,58116240,3906,18161
2302,8,40,15,10,53877840,3634,58116240,3906,18169
2303,3,40,15,10,53877840,3634,58116240,3906,18172
2304,7,40,15,10,53877840,3634,58116240,3906,18179
2305,3,40,15,10,53877840,3634,58116240,3906,18182
2306,6,40,15,10,53877840,3634,58116240,3906,18188
2307,6,40,15,10,53877840,3634,58116240,3906,18194
2308,8,40,15,10,53877840,3634,58116240,3906,18202
2309,6,40,15,10,53877840,3634,58116240,3906,18208
2310,9,40,15,10,53877840,3634,58116240,3906,18217
2311,11,40,15,10,53877840,3634,58116240,3906,18228
2312,7,40,15,10,53877840,3634,58116240,3906,18235
2313,8,40,15,10,53877840,3634,58116240,3906,18243
2314,8,40,15,10,53877840,3634,58116240,3906,18251
2315,9,40,15,10,53877840,3634,58116240,3906,18260
2316,17,40,15,10,53877840,3634,58116240,3906,18277
2317,13,40,15,10,53877840,3634,58116240,3906,18290
2318,6,40,15,10,53877840,3634,58116240,3906,18296
2319,12,40,15,10,53877840,3634,58116240,3906,18308
2320,9,40,15,10,53877840,3634,58116240,3906,18317
2321,7,40,15,10,53877840,3634,58116240,3906,18324
2322,7,40,15,10,53877840,3634,58116240,3906,18331
2323,7,40,15,10,53877840,3634,58116240,3906,18338
2324,7,40,15,10,53877840,3634,58116240,3906,18345
2325,10,40,15,10,53877840,3634,58116240,3906,18355
2326,7,40,15,10,53877840,3634,58116240,3906,18362
2327,3,40,15,10,53877840,3634,58116240,3906,18365
2328,4,40,15,10,53877840,3634,58116240,3906,18369
2329,9,40,15,10,53877840,3634,58116240,3906,18378
2330,5,40,15,10,53877840,3634,58116240,3906,18383
2331,6,40,15,10,53877840,3634,58116240,3906,18389
2332,6,40,15,10,53877840,3634,58116240,3906,18395
2333,2,40,15,10,53877840,3634,58116240,3906,18397
2334,5,40,15,10,53877840,3634,58116240,3906,18402
2335,8,40,15,10,53877840,3634,58116240,3906,18410
2336,15,40,15,10,53877840,3634,58116240,3906,18425
2337,9,40,15,10,53877840,3634,58116240,3906,18434
2338,12,40,15,10,53877840,3634,58116240,3906,18446
2339,14,40,15,10,53877840,3634,58116240,3906,18460
2340,11,40,15,10,53877840,3634,58116240,3906,18471
2341,14,40,15,10,53877840,3634,58116240,3906,18485
2342,15,40,15,10,53877840,3634,58116240,3906,18500
2343,16,40,15,10,53877840,3634,58116240,3906,18516
2344,12,40,15,10,53877840,3634,58116240,3906,18528
2345,7,40,15,10,53877840,3634,58116240,3906,18535
2346,11,40,15,10,53877840,3634,58116240,3906,18546
2347,10,40,15,10,53877840,3634,58116240,3906,18556
2348,7,40,15,10,53877840,3634,58116240,3906,18563
2349,11,40,15,10,53877840,3634,58116240,3906,18574
2350,7,40,15,10,53877840,3634,58116240,3906,18581
2351,6,40,15,10,53877840,3634,58116240,3906,18587
2352,9,40,15,10,53877840,3634,58116240,3906,18596
2353,3,40,15,10,53877840,3634,58116240,3906,18599
2354,3,40,15,10,53877840,3634,58116240,3906,18602
2355,4,40,15,10,53877840,3634,58116240,3906,18606
2356,10,40,15,10,53877840,3634,58116240,3906,18616
2357,5,40,15,10,53877840,3634,58116240,3906,18621
2358,9,40,15,10,53877840,3634,58116240,3906,18630
2359,4,40,15,10,53877840,3634,58116240,3906,18634
2360,11,40,15,10,53877840,3634,58116240,3906,18645
2361,8,40,15,10,53877840,3634,58116240,3906,18653
2362,11,40,15,10,53877840,3634,58116240,3906,18664
2363,3,40,15,10,53877840,3634,58116240,3906,18667
2364,14,40,15,10,53877840,3634,58116240,3906,18681
2365,14,40,15,10,53877840,3634,58116240,3906,18695
2366,4,40,15,10,53877840,3634,58116240,3906,18699
2367,21,40,15,10,53877840,3634,58116240,3906,18720
2368,10,40,15,10,53877840,3634,58116240,3906,18730
2369,13,40,15,10,53877840,3634,58116240,3906,18743
2370,9,40,15,10,53877840,3634,58116240,3906,18752
2371,10,40,15,10,53877840,3634,58116240,3906,18762
2372,8,40,15,10,53877840,3634,58116240,3906,18770
2373,8,40,15,10,53877840,3634,58116240,3906,18778
2374,6,40,15,10,53877840,3634,58116240,3906,18784
2375,5,40,15,10,53877840,3634,58116240,3906,18789
2376,11,40,15,10,53877840,3634,58116240,3906,18800
2377,3,40,15,10,53877840,3634,58116240,3906,18803
2378,5,40,15,10,53877840,3634,58116240,3906,18808
2379,1,40,15,10,53877840,3634,58116240,3906,18809
2380,7,40,15,10,53877840,3634,58116240,3906,18816
2381,8,40,15,10,53877840,3634,58116240,3906,18824
2382,11,40,15,10,53877840,3634,58116240,3906,18835
2383,8,40,15,10,53877840,3634,58116240,3906,18843
2384,5,40,15,10,53877840,3634,58116240,3906,18848
2385,9,40,15,10,53877840,3634,58116240,3906,18857
2386,14,40,15,10,53877840,3634,58116240,3906,18871
2387,8,40,15,10,53877840,3634,58116240,3906,18879
2388,12,40,15,10,53877840,3634,58116240,3906,18891
2389,10,40,15,10,53877840,3634,58116240,3906,18901
2390,10,40,15,10,53877840,3634,58116240,3906,18911
2391,9,40,15,10,53877840,3634,58116240,3906,18920
2392,11,40,15,10,53877840,3634,58116240,3906,18931
2393,3,40,15,10,53877840,3634,58116240,3906,18934
2394,10,40,15,10,53877840,3634,58116240,3906,18944
2395,9,40,15,10,53877840,3634,58116240,3906,18953
2396,11,40,15,10,53877840,3634,58116240,3906,18964
2397,12,40,15,10,53877840,3634,58116240,3906,18976
2398,9,40,15,10,53877840,3634,58116240,3906,18985
2399,9,40,15,10,53877840,3634,58116240,3906,18994

