Hour,Arrivals,Waiting,Treating,Available Rooms,Total Treatment Time,Average Treatment Time,Total Wait Time,Average Wait Time,Total Arrivals
1,7,0,5,20,1380,690,0,0,7
2,5,0,5,20,10320,1474,0,0,12
3,4,0,6,19,24780,2478,0,0,16
4,4,0,4,21,44580,2786,0,0,20
5,4,0,6,19,49860,2770,0,0,24
6,6,0,6,19,72360,3015,0,0,30
7,9,0,10,15,86460,2981,0,0,39
8,4,0,6,19,127380,3442,0,0,43
9,6,0,6,19,152820,3553,0,0,49
10,14,0,15,10,166260,3463,0,0,63
11,17,0,14,11,216180,3275,0,0,80
12,15,0,14,11,270420,3338,0,0,95
13,10,0,11,14,312600,3325,0,0,105
14,11,0,15,10,353160,3496,0,0,116
15,7,0,9,16,407040,3570,0,0,123
16,4,0,7,18,440040,3667,0,0,127
17,10,0,9,16,473820,3701,0,0,137
18,10,0,11,14,491700,3615,0,0,147
19,4,0,6,19,530580,3659,0,0,151
20,8,0,9,16,548820,3658,0,0,159
21,8,0,7,18,581820,3636,0,0,167
22,4,0,6,19,599760,3634,0,0,171
23,7,0,8,17,620340,3649,0,0,178
24,5,0,6,19,660720,3732,0,0,183
25,5,0,8,17,671880,3732,0,0,188
26,9,0,8,17,710340,3758,0,0,197
27,8,0,9,16,733920,3744,0,0,205
28,5,0,6,19,768480,3767,0,0,210
29,5,0,6,19,786840,3764,0,0,215
30,5,0,4,21,817800,3786,0,0,220
31,4,0,4,21,831240,3778,0,0,224
32,15,0,16,9,838440,3759,0,0,239
33,11,0,10,15,887340,3697,0,0,250
34,10,0,7,18,932580,3686,0,0,260
35,7,0,7,18,953340,3666,0,0,267
36,11,0,9,16,991860,3687,0,0,278
37,10,0,11,14,1018260,3676,0,0,288
38,10,0,8,17,1059660,3654,0,0,298
39,12,0,14,11,1087080,3672,0,0,310
40,6,0,8,17,1124340,3650,0,0,316
41,6,0,8,17,1147500,3654,0,0,322
42,7,0,6,19,1186080,3672,0,0,329
43,9,0,7,18,1211940,3661,0,0,338
44,5,0,7,18,1232580,3668,0,0,343
45,6,0,4,21,1271460,3685,0,0,349
46,6,0,5,20,1286700,3676,0,0,355
47,7,0,5,20,1308480,3665,0,0,362
48,5,0,6,19,1327620,3677,0,0,367
49,4,0,4,21,1342920,3659,0,0,371
50,2,0,3,22,1361460,3679,0,0,373
51,6,0,5,20,1380660,3691,0,0,379
52,8,0,6,19,1396260,3664,0,0,387
53,4,0,7,18,1405380,3659,0,0,391
54,13,0,14,11,1427100,3659,0,0,404
55,6,0,7,18,1476300,3663,0,0,410
56,14,0,15,10,1507500,3685,0,0,424
57,4,0,7,18,1551120,3684,0,0,428
58,9,0,8,17,1592100,3711,0,0,437
59,7,0,10,15,1617660,3727,0,0,444
60,12,0,11,14,1653480,3715,0,0,456
61,9,0,9,16,1708860,3747,0,0,465
62,12,0,18,7,1714020,3734,0,0,477
63,6,0,9,16,1788120,3772,0,0,483
64,8,0,7,18,1831560,3784,0,0,491
65,13,0,12,13,1853460,3767,0,0,504
66,11,0,9,16,1898400,3751,0,0,515
67,11,0,11,14,1925100,3738,0,0,526
68,6,0,8,17,1963260,3746,0,0,532
69,10,0,13,12,1989540,3760,0,0,542
70,7,0,6,19,2046960,3769,0,0,549
71,6,0,5,20,2066580,3757,0,0,555
72,5,0,4,21,2087340,3754,0,0,560
73,5,0,7,18,2092500,3750,0,0,565
74,6,0,6,19,2122320,3756,0,0,571
75,4,0,3,22,2141040,3743,0,0,575
76,6,0,4,21,2152500,3730,0,0,581
77,10,0,9,16,2167980,3725,0,0,591
78,9,0,10,15,2195880,3721,0,0,600
79,10,0,10,15,2221860,3703,0,0,610
80,11,0,6,19,2280300,3707,0,0,621
81,7,0,10,15,2289540,3704,0,0,628
82,7,0,11,14,2314500,3709,0,0,635
83,4,0,5,20,2359680,3721,0,0,639
84,11,0,7,18,2388480,3714,0,0,650
85,9,0,9,16,2401080,3693,0,0,659
86,7,0,8,17,2435760,3701,0,0,666
87,11,0,10,15,2463840,3693,0,0,677
88,7,0,9,16,2487300,3684,0,0,684
89,15,0,16,9,2526660,3699,0,0,699
90,7,0,12,13,2564640,3695,0,0,706
91,5,0,6,19,2628300,3728,0,0,711
92,3,0,5,20,2646120,3732,0,0,714
93,7,0,6,19,2677020,3744,0,0,721
94,11,0,8,17,2692560,3719,0,0,732
95,9,0,9,16,2721900,3718,0,0,741
96,6,0,6,19,2761860,3727,0,0,747
97,6,0,7,18,2780460,3727,0,0,753
98,4,0,2,23,2813280,3726,0,0,757
99,9,0,4,21,2826300,3709,0,0,766
100,4,0,7,18,2833020,3713,0,0,770
101,11,0,13,12,2866320,3732,0,0,781
102,8,0,11,14,2899740,3727,0,0,789
103,11,0,9,16,2953140,3733,0,0,800
104,4,0,7,18,2974080,3731,0,0,804
105,9,0,11,14,2985780,3722,0,0,813
106,9,0,7,18,3034260,3723,0,0,822
107,10,0,9,16,3062640,3721,0,0,832
108,8,0,8,17,3095700,3720,0,0,840
109,6,0,7,18,3112200,3709,0,0,846
110,12,0,10,15,3149880,3714,0,0,858
111,11,0,14,11,3168060,3705,0,0,869
112,11,0,12,13,3214080,3702,0,0,880
113,11,0,13,12,3251400,3703,0,0,891
114,9,0,11,14,3303120,3715,0,0,900
115,6,0,7,18,3347280,3723,0,0,906
116,4,0,3,22,3380340,3726,0,0,910
117,8,0,7,18,3392700,3724,0,0,918
118,5,0,4,21,3419640,3721,0,0,923
119,6,0,7,18,3429060,3719,0,0,929
120,3,0,4,21,3449280,3716,0,0,932
121,5,0,4,21,3466440,3715,0,0,937
122,7,0,5,20,3482100,3708,0,0,944
123,8,0,5,20,3506820,3703,0,0,952
124,8,0,12,13,3509880,3702,0,0,960
125,8,0,9,16,3559620,3711,0,0,968
126,12,0,12,13,3588660,3707,0,0,980
127,12,0,13,12,3638580,3716,0,0,992
128,13,0,12,13,3695640,3721,0,0,1005
129,6,0,9,16,3746040,3738,0,0,1011
130,11,0,13,12,3769020,3735,0,0,1022
131,9,0,8,17,3832500,3746,0,0,1031
132,9,0,7,18,3863100,3739,0,0,1040
133,12,0,9,16,3889800,3729,0,0,1052
134,14,0,13,12,3918420,3721,0,0,1066
135,13,0,16,9,3955680,3721,0,0,1079
136,8,0,11,14,4014180,3730,0,0,1087
137,9,0,11,14,4053540,3735,0,0,1096
138,5,0,6,19,4096020,3740,0,0,1101
139,9,0,9,16,4115280,3737,0,0,1110
140,8,0,6,19,4153260,3734,0,0,1118
141,6,0,2,23,4184760,3729,0,0,1124
142,4,0,6,19,4184760,3729,0,0,1128
143,5,0,3,22,4203180,3719,0,0,1133
144,4,0,3,22,4214280,3716,0,0,1137
145,6,0,7,18,4217700,3712,0,0,1143
146,7,0,8,17,4237740,3710,0,0,1150
147,4,0,6,19,4255920,3707,0,0,1154
148,3,0,3,22,4281900,3710,0,0,1157
149,6,0,4,21,4298580,3708,0,0,1163
150,5,0,8,17,4302660,3709,0,0,1168
151,11,0,7,18,4340820,3703,0,0,1179
152,12,0,13,12,4352280,3694,0,0,1191
153,8,0,10,15,4390320,3692,0,0,1199
154,8,0,10,15,4419840,3692,0,0,1207
155,15,0,12,13,4462440,3687,0,0,1222
156,8,0,12,13,4491600,3687,0,0,1230
157,17,0,16,9,4547700,3694,0,0,1247
158,11,0,12,13,4601340,3692,0,0,1258
159,15,0,13,12,4643460,3685,0,0,1273
160,8,0,11,14,4685880,3689,0,0,1281
161,7,0,7,18,4731360,3693,0,0,1288
162,9,0,7,18,4761300,3690,0,0,1297
163,4,0,5,20,4787940,3694,0,0,1301
164,7,0,8,17,4796460,3689,0,0,1308
165,9,0,6,19,4825200,3680,0,0,1317
166,9,0,6,19,4851120,3675,0,0,1326
167,3,0,3,22,4885500,3684,0,0,1329
168,6,0,5,20,4900380,3684,0,0,1335
169,3,0,3,22,4918620,3684,0,0,1338
170,3,0,3,22,4930560,3685,0,0,1341
171,4,0,4,21,4941360,3684,0,0,1345
172,3,0,3,22,4956480,3685,0,0,1348
173,4,0,6,19,4958520,3683,0,0,1352
174,10,0,7,18,4990620,3683,0,0,1362
175,6,0,6,19,5016840,3683,0,0,1368
176,6,0,7,18,5040060,3686,0,0,1374
177,12,0,11,14,5059980,3679,0,0,1386
178,8,0,5,20,5108160,3677,0,0,1394
179,13,0,12,13,5126700,3675,0,0,1407
180,10,0,11,14,5163480,3672,0,0,1417
181,8,0,12,13,5197380,3678,0,0,1425
182,9,0,11,14,5238180,3681,0,0,1434
183,10,0,11,14,5286420,3689,0,0,1444
184,13,0,16,9,5329080,3698,0,0,1457
185,9,0,11,14,5386440,3702,0,0,1466
186,10,0,10,15,5427060,3701,0,0,1476
187,3,0,4,21,5471040,3709,0,0,1479
188,8,0,10,15,5481840,3711,0,0,1487
189,5,0,7,18,5507640,3708,0,0,1492
190,3,0,4,21,5529720,3708,0,0,1495
191,9,0,7,18,5554020,3710,0,0,1504
192,10,0,11,14,5568420,3704,0,0,1514
193,3,0,8,17,5596500,3708,0,0,1517
194,7,0,3,22,5652300,3716,0,0,1524
195,8,0,6,19,5664540,3712,0,0,1532
196,7,0,4,21,5690700,3707,0,0,1539
197,7,0,9,16,5695380,3705,0,0,1546
198,13,0,10,15,5727840,3697,0,0,1559
199,3,0,6,19,5761500,3702,0,0,1562
200,6,0,7,18,5790300,3709,0,0,1568
201,8,0,7,18,5818740,3708,0,0,1576
202,13,0,10,15,5844240,3701,0,0,1589
203,15,0,11,14,5889780,3697,0,0,1604
204,16,0,13,12,5928420,3689,0,0,1620
205,6,0,9,16,5963280,3687,0,0,1626
206,5,0,8,17,5995980,3694,0,0,1631
207,9,0,12,13,6015720,3695,0,0,1640
208,9,0,12,13,6055080,3698,0,0,1649
209,11,0,10,15,6108240,3701,0,0,1660
210,7,0,9,16,6135120,3700,0,0,1667
211,8,0,6,19,6183540,3704,0,0,1675
212,7,0,7,18,6198660,3700,0,0,1682
213,10,0,9,16,6222000,3696,0,0,1692
214,3,0,9,16,6234120,3697,0,0,1695
215,3,0,8,17,6259560,3703,0,0,1698
216,4,0,4,21,6314220,3718,0,0,1702
217,8,0,6,19,6332100,3716,0,0,1710
218,8,0,8,17,6345540,3710,0,0,1718
219,8,0,9,16,6360600,3704,0,0,1726
220,5,0,8,17,6390300,3708,0,0,1731
221,8,0,8,17,6429900,3714,0,0,1739
222,5,0,5,20,6460980,3715,0,0,1744
223,7,0,9,16,6477960,3718,0,0,1751
224,10,0,9,16,6511260,3716,0,0,1761
225,14,0,17,8,6530940,3714,0,0,1775
226,12,0,12,13,6588600,3711,0,0,1787
227,5,0,7,18,6641700,3720,0,0,1792
228,16,0,15,10,6657120,3712,0,0,1808
229,3,0,5,20,6698160,3708,0,0,1811
230,10,0,9,16,6722100,3709,0,0,1821
231,14,0,11,14,6762060,3707,0,0,1835
232,15,0,14,11,6795000,3700,0,0,1850
233,8,0,12,13,6826680,3698,0,0,1858
234,6,0,4,21,6891180,3704,0,0,1864
235,4,0,3,22,6915360,3707,0,0,1868
236,4,0,4,21,6927780,3708,0,0,1872
237,6,0,4,21,6946080,3706,0,0,1878
238,5,0,3,22,6954720,3699,0,0,1883
239,6,0,6,19,6972780,3703,0,0,1889
240,9,0,9,16,6984660,3697,0,0,1898
241,1,0,2,23,7018140,3699,0,0,1899
242,6,0,3,22,7036920,3699,0,0,1905
243,9,0,8,17,7043640,3695,0,0,1914
244,1,0,3,22,7074240,3699,0,0,1915
245,8,0,8,17,7086600,3700,0,0,1923
246,5,0,6,19,7112280,3700,0,0,1928
247,15,0,14,11,7122000,3692,0,0,1943
248,7,0,8,17,7174680,3694,0,0,1950
249,11,0,6,19,7218780,3692,0,0,1961
250,15,0,13,12,7244820,3690,0,0,1976
251,9,0,15,10,7263960,3687,0,0,1985
252,7,0,7,18,7341540,3698,0,0,1992
253,13,0,14,11,7355400,3694,0,0,2005
254,17,0,19,6,7387800,3688,0,0,2022
255,12,0,13,12,7461120,3691,120,0,2034
256,10,0,8,17,7523940,3695,120,0,2044
257,9,0,6,19,7568340,3697,120,0,2053
258,17,0,17,8,7583280,3693,120,0,2070
259,9,0,12,13,7628640,3690,120,0,2079
260,9,0,9,16,7687920,3697,120,0,2088
261,10,0,11,14,7712040,3695,120,0,2098
262,6,0,11,14,7741080,3698,120,0,2104
263,6,0,8,17,7791000,3706,120,0,2110
264,8,0,8,17,7825020,3708,120,0,2118
265,5,0,4,21,7862280,3710,120,0,2123
266,5,0,6,19,7872240,3709,120,0,2128
267,5,0,6,19,7896780,3712,120,0,2133
268,8,0,7,18,7917600,3710,120,0,2141
269,6,0,5,20,7939980,3706,120,0,2147
270,12,0,11,14,7954440,3703,120,0,2159
271,5,0,5,20,7991460,3701,120,0,2164
272,6,0,8,17,8009760,3704,120,0,2170
273,12,0,7,18,8051400,3701,120,0,2182
274,11,0,11,14,8067180,3697,120,0,2193
275,12,0,10,15,8099700,3690,120,0,2205
276,15,0,15,10,8126220,3685,120,0,2220
277,7,0,12,13,8169540,3688,120,0,2227
278,13,0,13,12,8220060,3691,120,0,2240
279,11,0,10,15,8281800,3695,120,0,2251
280,15,0,11,14,8306760,3683,120,0,2266
281,9,0,11,14,8344920,3685,120,0,2275
282,7,0,11,14,8376480,3688,120,0,2282
283,10,0,13,12,8417760,3693,120,0,2292
284,8,0,8,17,8461800,3691,120,0,2300
285,7,0,7,18,8499840,3695,120,0,2307
286,4,0,5,20,8527140,3697,120,0,2311
287,3,0,4,21,8545080,3699,120,0,2314
288,3,0,2,23,8563740,3699,120,0,2317
289,8,0,9,16,8564160,3697,120,0,2325
290,7,0,6,19,8596560,3695,120,0,2332
291,5,0,7,18,8617560,3698,120,0,2337
292,9,0,5,20,8659860,3699,120,0,2346
293,8,0,9,16,8675340,3699,120,0,2354
294,4,0,5,20,8705100,3699,120,0,2358
295,10,0,7,18,8728440,3696,120,0,2368
296,9,0,8,17,8767440,3700,120,0,2377
297,11,0,10,15,8792220,3697,120,0,2388
298,11,0,11,14,8828040,3696,120,0,2399
299,16,0,12,13,8881140,3695,120,0,2415
300,8,0,9,16,8919300,3694,120,0,2423
301,13,0,13,12,8951460,3694,120,0,2436
302,14,0,15,10,9001740,3696,120,0,2450
303,5,0,7,18,9045780,3695,120,0,2455
304,10,0,5,20,9088080,3694,120,0,2465
305,7,0,7,18,9105240,3693,120,0,2472
306,4,0,5,20,9128640,3694,120,0,2476
307,14,0,13,12,9149520,3693,120,0,2490
308,8,0,11,14,9184740,3693,120,0,2498
309,8,0,10,15,9223260,3695,120,0,2506
310,6,0,8,17,9270060,3702,120,0,2512
311,5,0,5,20,9309480,3706,120,0,2517
312,5,0,5,20,9323220,3704,120,0,2522
313,4,0,3,22,9348960,3705,120,0,2526
314,5,0,5,20,9359940,3705,120,0,2531
315,13,0,11,14,9375120,3701,120,0,2544
316,4,0,9,16,9393000,3699,120,0,2548
317,3,0,7,18,9413580,3700,120,0,2551
318,7,0,6,19,9462780,3707,120,0,2558
319,9,0,10,15,9473460,3704,120,0,2567
320,10,0,13,12,9493740,3702,120,0,2577
321,4,0,6,19,9555240,3710,120,0,2581
322,7,0,7,18,9583260,3713,120,0,2588
323,13,0,15,10,9612540,3717,120,0,2601
324,17,0,13,12,9669960,3712,120,0,2618
325,18,0,20,5,9698520,3707,120,0,2636
326,13,0,21,4,9749940,3710,900,0,2649
327,10,0,12,13,9841740,3718,900,0,2659
328,7,0,7,18,9903960,3724,900,0,2666
329,11,0,8,17,9927900,3719,900,0,2677
330,7,0,6,19,9952680,3716,900,0,2684
331,6,0,4,21,9979020,3715,900,0,2690
332,16,0,14,11,9994740,3712,900,0,2706
333,4,0,9,16,10032180,3714,900,0,2710
334,4,0,3,22,10079520,3718,900,0,2714
335,5,0,3,22,10096620,3717,900,0,2719
336,3,0,4,21,10104480,3717,900,0,2722
337,7,0,6,19,10120380,3716,900,0,2729
338,10,0,14,11,10126800,3716,900,0,2739
339,23,0,16,9,10188360,3710,900,0,2762
340,17,0,16,9,10243320,3707,900,0,2779
341,33,9,25,0,10301760,3708,3480,1,2812
342,31,23,25,0,10365300,3708,10680,3,2843
343,39,40,25,0,10468680,3722,27000,9,2882
344,29,38,25,0,10542720,3730,58980,20,2911
345,31,40,25,0,10648740,3739,130740,44,2942
346,28,36,25,0,10738920,3743,156480,53,2970
347,27,29,25,0,10833060,3731,280380,94,2997
348,32,22,25,0,10933440,3716,550200,184,3029
349,36,30,25,0,11019720,3710,572100,189,3065
350,28,39,25,0,11100420,3713,578820,189,3093
351,28,38,25,0,11178660,3716,628680,204,3121
352,40,37,25,0,11248740,3711,673500,217,3161
353,37,39,25,0,11379600,3721,717780,229,3198
354,24,40,24,1,11432160,3717,738960,235,3222
355,25,35,18,7,11528100,3725,808080,256,3247
356,27,36,20,5,11601660,3720,1074420,338,3274
357,17,29,25,0,11673600,3724,1168500,366,3291
358,22,10,25,0,11752500,3701,1833840,571,3313
359,31,11,25,0,11854140,3698,1939740,598,3344
360,37,40,15,10,11905320,3699,1943280,594,3381
361,35,40,25,0,11981940,3710,2003220,608,3416
362,27,38,25,0,12036720,3715,2024940,613,3443
363,35,37,22,3,12154800,3723,2076840,624,3478
364,35,40,20,5,12210540,3721,2087760,625,3513
365,24,29,25,0,12316800,3723,2297880,683,3537
366,29,38,17,8,12386940,3724,2309460,683,3566
367,35,40,25,0,12445260,3726,2332320,685,3601
368,34,38,25,0,12560040,3731,2369160,691,3635
369,25,39,24,1,12636060,3727,2434260,705,3660
370,22,40,13,12,12728640,3732,2442000,705,3682
371,26,38,20,5,12759900,3735,2464980,709,3708
372,39,37,25,0,12847080,3725,2681520,765,3747
373,28,39,23,2,12929520,3722,2800500,792,3775
374,28,34,18,7,13026420,3729,2872080,810,3803
375,36,40,16,9,13095300,3726,2908500,814,3839
376,36,38,25,0,13148220,3732,2939760,820,3875
377,25,32,25,0,13234200,3728,3172140,879,3900
378,33,35,25,0,13328580,3724,3227340,887,3933
379,25,35,25,0,13404420,3725,3308460,904,3958
380,26,30,25,0,13508760,3724,3485100,946,3984
381,27,34,23,2,13583100,3719,3675840,991,4011
382,32,39,13,12,13668960,3724,3681600,989,4043
383,29,37,23,2,13718220,3730,3722040,995,4072
384,28,37,23,2,13798980,3730,3787080,1007,4100
385,38,40,13,12,13878540,3733,3796920,1007,4138
386,38,39,22,3,13929720,3740,3812400,1007,4176
387,41,40,25,0,13987980,3740,3834000,1007,4217
388,36,36,25,0,14087700,3741,3954840,1033,4253
389,31,17,25,0,14200620,3722,5443200,1411,4284
390,35,35,20,5,14256660,3715,5529180,1426,4319
391,25,33,19,6,14344860,3723,5579520,1428,4344
392,35,40,25,0,14383140,3725,5595240,1425,4379
393,27,35,25,0,14483760,3730,5655060,1434,4406
394,32,36,25,0,14580660,3725,5764380,1450,4438
395,27,40,23,2,14643240,3726,5770680,1445,4465
396,27,37,25,0,14748600,3731,5826180,1451,4492
397,31,40,18,7,14844120,3729,5859360,1451,4523
398,35,40,19,6,14922480,3731,5881980,1449,4558
399,37,38,25,0,15003120,3724,5952060,1455,4595
400,34,38,25,0,15088680,3719,6098040,1480,4629
401,29,36,25,0,15181920,3722,6143400,1484,4658
402,31,30,25,0,15290280,3715,6417780,1539,4689
403,36,40,25,0,15373320,3715,6427620,1529,4725
404,33,35,25,0,15461880,3715,6484980,1535,4758
405,31,39,23,2,15529560,3712,6503880,1532,4789
406,25,35,25,0,15642000,3716,6564360,1538,4814
407,39,39,25,0,15721020,3711,6591540,1532,4853
408,35,38,24,1,15823260,3709,6675180,1542,4888
409,23,40,13,12,15883440,3711,6680280,1542,4911
410,37,40,25,0,15939480,3717,6710220,1542,4948
411,21,37,25,0,16021260,3719,6748500,1544,4969
412,27,22,25,0,16125480,3707,7988280,1817,4996
413,32,20,25,0,16210980,3698,8314680,1878,5028
414,34,32,25,0,16292640,3698,8323980,1866,5062
415,33,35,22,3,16391820,3701,8353500,1862,5095
416,33,40,12,13,16462140,3702,8354520,1858,5128
417,25,35,16,9,16527180,3708,8400060,1863,5153
418,25,18,25,0,16581300,3692,9231420,2036,5178
419,31,25,25,0,16650900,3688,9410280,2061,5209
420,32,18,25,0,16768320,3682,9502620,2068,5241
421,32,25,25,0,16854420,3681,9513720,2055,5273
422,24,35,23,2,16909200,3680,9522600,2046,5297
423,32,39,25,0,17009940,3687,9538740,2039,5329
424,25,38,25,0,17098020,3691,9571620,2038,5354
425,26,26,25,0,17215140,3686,9965160,2111,5380
426,28,40,15,10,17269200,3686,9968940,2105,5408
427,32,36,16,9,17340600,3692,10014960,2109,5440
428,34,40,25,0,17384100,3694,10033020,2104,5474
429,36,35,25,0,17497320,3693,10169160,2119,5510
430,31,29,25,0,17595900,3685,10495080,2174,5541
431,34,40,16,9,17661660,3687,10498140,2167,5575
432,24,35,21,4,17733120,3693,10548000,2171,5599
433,26,32,24,1,17807400,3689,10703700,2192,5625
434,32,40,21,4,17864640,3692,10710540,2187,5657
435,23,39,25,0,17947980,3698,10750200,2186,5680
436,27,23,25,0,18079620,3694,11296740,2286,5707
437,34,23,25,0,18174900,3688,11476260,2306,5741
438,37,40,25,0,18226140,3686,11484000,2293,5778
439,23,39,25,0,18304560,3691,11503980,2291,5801
440,32,35,24,1,18432600,3690,11697300,2314,5833
441,34,40,21,4,18470220,3691,11698500,2310,5867
442,30,37,25,0,18584280,3698,11743140,2309,5897
443,34,36,25,0,18675840,3690,12041760,2352,5931
444,26,35,22,3,18760140,3692,12059700,2347,5957
445,33,34,25,0,18852060,3688,12207960,2362,5990
446,34,40,25,0,18925020,3690,12215880,2352,6024
447,30,34,25,0,19027380,3693,12300000,2360,6054
448,26,32,25,0,19111560,3689,12410640,2370,6080
449,31,40,18,7,19199640,3692,12428280,2365,6111
450,26,37,17,8,19277220,3694,12457860,2363,6137
451,23,10,25,0,19359120,3680,13397640,2530,6160
452,39,21,22,3,19423320,3671,13496640,2533,6199
453,37,40,25,0,19495500,3674,13511640,2519,6236
454,32,40,25,0,19581180,3680,13538220,2514,6268
455,34,39,25,0,19700580,3685,13616340,2516,6302
456,24,32,25,0,19787400,3684,13833120,2549,6326
457,32,40,14,11,19854840,3679,13878360,2546,6358
458,22,40,25,0,19915080,3684,13906620,2543,6380
459,34,40,19,6,20005020,3685,13939740,2540,6414
460,33,40,23,2,20078940,3686,13999980,2541,6447
461,36,40,25,0,20140620,3689,14005500,2536,6483
462,25,28,25,0,20244480,3690,14268000,2576,6508
463,31,21,25,0,20346300,3683,14720220,2643,6539
464,30,23,25,0,20428680,3680,14774640,2639,6569
465,32,40,16,9,20501100,3679,14781360,2633,6601
466,28,39,25,0,20573100,3684,14815680,2623,6629
467,37,40,25,0,20660580,3687,14829780,2616,6666
468,30,37,25,0,20771400,3686,15039720,2640,6696
469,29,37,17,8,20829360,3687,15056100,2640,6725
470,25,28,25,0,20921100,3686,15319980,2674,6750
471,32,38,25,0,20999460,3687,15345840,2666,6782
472,27,38,25,0,21087660,3691,15377760,2664,6809
473,39,40,25,0,21186180,3694,15398220,2655,6848
474,26,36,25,0,21269640,3692,15472920,2657,6874
475,29,35,25,0,21347580,3686,15693420,2682,6903
476,32,39,25,0,21439260,3690,15706560,2673,6935
477,27,40,25,0,21511140,3692,15715560,2668,6962
478,39,40,25,0,21637020,3698,15770460,2667,7001
479,33,36,22,3,21702120,3698,15795540,2665,7034
480,26,36,25,0,21774660,3696,15969420,2683,7060
481,39,39,25,0,21884820,3698,16023240,2679,7099
482,26,30,25,0,21980160,3694,16168200,2692,7125
483,37,40,21,4,22051020,3689,16269240,2695,7162
484,25,38,25,0,22119960,3692,16287240,2690,7187
485,30,33,25,0,22226160,3690,16483980,2712,7217
486,38,40,25,0,22301760,3687,16508640,2701,7255
487,35,40,17,8,22388760,3688,16535760,2699,7290
488,36,39,23,2,22462980,3692,16607820,2702,7326
489,26,34,19,6,22534980,3695,16673520,2710,7352
490,30,29,25,0,22606680,3689,17321820,2805,7382
491,26,26,25,0,22701060,3687,17558880,2828,7408
492,27,40,15,10,22763940,3688,17564700,2821,7435
493,40,39,25,0,22848660,3693,17589780,2814,7475
494,31,33,25,0,22944300,3691,17851080,2846,7506
495,33,38,25,0,23008920,3688,17908440,2842,7539
496,36,39,25,0,23070060,3688,17926140,2837,7575
497,31,22,25,0,23215260,3685,18722580,2950,7606
498,31,15,25,0,23289060,3675,19155480,3004,7637
499,31,16,25,0,23361000,3669,19190220,2995,7668
500,25,24,25,0,23454240,3673,19233360,2991,7693
501,34,38,25,0,23534520,3674,19240320,2976,7727
502,23,37,25,0,23649480,3679,19257780,2967,7750
503,16,34,25,0,23727960,3681,19292580,2966,7766
504,13,10,25,0,23828820,3676,20071920,3080,7779
505,8,0,12,13,23903100,3670,20213160,3097,7787
506,4,0,9,16,23928060,3669,20213160,3095,7791
507,11,0,14,11,23958060,3671,20213160,3090,7802
508,4,0,9,16,24010980,3674,20213160,3088,7806
509,6,0,7,18,24050580,3675,20213160,3085,7812
510,7,0,5,20,24084900,3675,20213160,3082,7819
511,8,0,7,18,24105360,3675,20213160,3078,7827
512,7,0,9,16,24119220,3675,20213160,3075,7834
513,9,0,7,18,24157740,3674,20213160,3071,7843
514,7,0,11,14,24164280,3674,20213160,3068,7850
515,17,0,16,9,24192780,3671,20213160,3060,7867
516,5,0,5,20,24250200,3671,20213160,3057,7872
517,12,0,9,16,24288780,3672,20213160,3052,7884
518,8,0,6,19,24321660,3671,20213160,3048,7892
519,9,0,10,15,24338280,3671,20213160,3044,7901
520,6,0,7,18,24382260,3673,20213160,3041,7907
521,8,0,8,17,24406020,3672,20213160,3038,7915
522,13,0,8,17,24444300,3671,20213160,3032,7928
523,8,0,9,16,24467040,3670,20213160,3028,7936
524,7,0,6,19,24504840,3671,20213160,3025,7943
525,9,0,9,16,24531000,3671,20213160,3021,7952
526,4,0,4,21,24563700,3671,20213160,3019,7956
527,4,0,5,20,24578400,3672,20213160,3017,7960
528,4,0,6,19,24591060,3672,20213160,3015,7964
529,3,0,3,22,24605580,3671,20213160,3014,7967
530,6,0,4,21,24620100,3670,20213160,3011,7973
531,6,0,7,18,24634020,3671,20213160,3009,7979
532,6,0,8,17,24651540,3671,20213160,3006,7985
533,5,0,9,16,24669960,3671,20213160,3004,7990
534,12,0,6,19,24724620,3671,20213160,2998,8002
535,9,0,8,17,24747180,3671,20213160,2994,8011
536,12,0,13,12,24761760,3669,20213160,2989,8023
537,7,0,11,14,24801720,3670,20213160,2986,8030
538,6,0,8,17,24851340,3672,20213160,2983,8036
539,13,0,14,11,24867120,3671,20213160,2978,8049
540,5,0,8,17,24931740,3675,20213160,2976,8054
541,13,0,11,14,24977520,3676,20213160,2970,8067
542,8,0,10,15,25003080,3675,20213160,2966,8075
543,8,0,9,16,25039260,3675,20213160,2963,8083
544,15,0,14,11,25062840,3673,20213160,2956,8098
545,7,0,8,17,25111020,3673,20213160,2953,8105
546,17,0,15,10,25149540,3674,20213160,2946,8122
547,10,0,11,14,25192440,3672,20213160,2942,8132
548,6,0,9,16,25231380,3674,20213160,2939,8138
549,9,0,10,15,25276440,3676,20213160,2935,8147
550,4,0,5,20,25313580,3677,20213160,2934,8151
551,6,0,5,20,25334580,3677,20213160,2931,8157
552,0,0,3,22,25344900,3677,20213160,2931,8157
553,6,0,4,21,25367520,3678,20213160,2929,8163
554,2,0,4,21,25375140,3678,20213160,2928,8165
555,7,0,9,16,25381500,3677,20213160,2925,8172
556,10,0,11,14,25398660,3676,20213160,2920,8182
557,13,0,13,12,25450980,3677,20213160,2915,8195
558,10,0,11,14,25494660,3677,20213160,2911,8205
559,4,0,6,19,25537260,3679,20213160,2909,8209
560,5,0,6,19,25562760,3680,20213160,2907,8214
561,7,0,5,20,25591260,3680,20213160,2904,8221
562,7,0,5,20,25620720,3680,20213160,2901,8228
563,6,0,7,18,25626960,3679,20213160,2899,8234
564,7,0,5,20,25660260,3679,20213160,2896,8241
565,12,0,10,15,25680060,3678,20213160,2891,8253
566,5,0,8,17,25695780,3677,20213160,2889,8258
567,6,0,6,19,25735320,3678,20213160,2886,8264
568,15,0,13,12,25754880,3677,20213160,2880,8279
569,7,0,11,14,25790880,3677,20213160,2877,8286
570,9,0,11,14,25832520,3678,20213160,2874,8295
571,11,0,9,16,25879080,3678,20213160,2869,8306
572,7,0,6,19,25924980,3679,20213160,2866,8313
573,6,0,7,18,25940280,3679,20213160,2864,8319
574,4,0,3,22,25969140,3679,20213160,2862,8323
575,9,0,4,21,25985820,3677,20213160,2859,8332
576,4,0,3,22,25998180,3676,20213160,2857,8336
577,9,0,7,18,26011800,3676,20213160,2853,8345
578,7,0,5,20,26031660,3674,20213160,2850,8352
579,8,0,9,16,26041740,3673,20213160,2847,8360
580,5,0,6,19,26063220,3672,20213160,2845,8365
581,6,0,6,19,26095560,3673,20213160,2843,8371
582,2,0,3,22,26112600,3673,20213160,2842,8373
583,5,0,3,22,26133360,3674,20213160,2840,8378
584,6,0,5,20,26146800,3673,20213160,2838,8384
585,4,0,4,21,26163300,3673,20213160,2836,8388
586,10,0,8,17,26183220,3673,20213160,2832,8398
587,11,0,12,13,26205600,3672,20213160,2828,8409
588,11,0,12,13,26247960,3673,20213160,2823,8420
589,13,0,11,14,26309100,3674,20213160,2818,8433
590,12,0,10,15,26354580,3674,20213160,2814,8445
591,14,0,13,12,26392140,3673,20213160,2808,8459
592,9,0,14,11,26426880,3674,20213160,2805,8468
593,12,0,14,11,26467680,3674,20213160,2800,8480
594,15,0,16,9,26515740,3674,20213160,2794,8495
595,9,0,11,14,26565600,3673,20213160,2791,8504
596,8,0,8,17,26622420,3676,20213160,2788,8512
597,2,0,3,22,26658420,3677,20213160,2787,8514
598,6,0,7,18,26671140,3678,20213160,2784,8520
599,8,0,10,15,26682480,3677,20213160,2781,8528
600,7,0,8,17,26712840,3676,20213160,2779,8535
601,7,0,6,19,26754780,3678,20213160,2776,8542
602,6,0,6,19,26772660,3677,20213160,2774,8548
603,6,0,5,20,26798520,3677,20213160,2771,8554
604,2,0,1,24,26820720,3677,20213160,2771,8556
605,5,0,3,22,26826300,3676,20213160,2769,8561
606,10,0,10,15,26831040,3675,20213160,2765,8571
607,10,0,9,16,26856300,3673,20213160,2761,8581
608,6,0,4,21,26898600,3674,20213160,2759,8587
609,9,0,9,16,26903940,3672,20213160,2756,8596
610,8,0,7,18,26943840,3673,20213160,2753,8604
611,5,0,6,19,26965740,3673,20213160,2751,8609
612,7,0,6,19,26990040,3673,20213160,2748,8616
613,15,0,8,17,27016920,3670,20213160,2742,8631
614,16,0,11,14,27047100,3667,20213160,2737,8647
615,9,0,10,15,27077340,3667,20213160,2733,8656
616,11,0,11,14,27105540,3665,20213160,2729,8667
617,7,0,11,14,27135000,3666,20213160,2727,8674
618,2,0,4,21,27180300,3668,20213160,2726,8676
619,10,0,11,14,27185460,3667,20213160,2722,8686
620,8,0,8,17,27231240,3668,20213160,2719,8694
621,9,0,10,15,27257460,3668,20213160,2716,8703
622,4,0,2,23,27297660,3667,20213160,2714,8707
623,2,0,1,24,27303060,3666,20213160,2714,8709
624,4,0,2,23,27313560,3666,20213160,2712,8713
625,5,0,5,20,27320640,3666,20213160,2710,8718
626,2,0,6,19,27324420,3666,20213160,2710,8720
627,2,0,3,22,27342420,3666,20213160,2709,8722
628,5,0,5,20,27357660,3667,20213160,2707,8727
629,5,0,3,22,27380940,3666,20213160,2705,8732
630,9,0,7,18,27397920,3666,20213160,2702,8741
631,2,0,6,19,27409440,3666,20213160,2701,8743
632,8,0,8,17,27429780,3666,20213160,2699,8751
633,8,0,6,19,27453060,3664,20213160,2696,8759
634,8,0,6,19,27483420,3664,20213160,2693,8767
635,7,0,8,17,27501720,3664,20213160,2690,8774
636,12,0,7,18,27541440,3663,20213160,2686,8786
637,10,0,11,14,27550980,3662,20213160,2682,8796
638,16,0,14,11,27586260,3660,20213160,2677,8812
639,9,0,9,16,27642960,3661,20213160,2674,8821
640,8,0,5,20,27695280,3662,20213160,2671,8829
641,11,0,12,13,27708360,3662,20213160,2667,8840
642,8,0,8,17,27753120,3662,20213160,2664,8848
643,11,0,11,14,27773760,3661,20213160,2660,8859
644,11,0,16,9,27800280,3661,20213160,2656,8870
645,8,0,8,17,27878100,3664,20213160,2654,8878
646,8,0,9,16,27905280,3664,20213160,2651,8886
647,9,0,9,16,27936360,3664,20213160,2648,8895
648,8,0,6,19,27973680,3663,20213160,2645,8903
649,7,0,4,21,28003020,3663,20213160,2642,8910
650,7,0,5,20,28016040,3662,20213160,2640,8917
651,4,0,4,21,28036440,3662,20213160,2639,8921
652,5,0,5,20,28045620,3661,20213160,2637,8926
653,9,0,8,17,28067340,3661,20213160,2634,8935
654,4,0,5,20,28086900,3660,20213160,2632,8939
655,8,0,7,18,28112460,3661,20213160,2630,8947
656,8,0,7,18,28135200,3660,20213160,2627,8955
657,13,0,7,18,28169040,3658,20213160,2623,8968
658,7,0,5,20,28193460,3657,20213160,2620,8975
659,12,0,9,16,28220940,3657,20213160,2616,8987
660,10,0,9,16,28257900,3657,20213160,2613,8997
661,10,0,11,14,28282260,3656,20213160,2609,9007
662,10,0,7,18,28331520,3656,20213160,2606,9017
663,6,0,5,20,28352220,3655,20213160,2604,9023
664,8,0,11,14,28364340,3656,20213160,2601,9031
665,10,0,11,14,28396200,3655,20213160,2598,9041
666,7,0,9,16,28437840,3656,20213160,2596,9048
667,5,0,6,19,28473120,3657,20213160,2594,9053
668,14,0,11,14,28496460,3656,20213160,2589,9067
669,10,0,11,14,28535580,3656,20213160,2586,9077
670,8,0,7,18,28575000,3655,20213160,2583,9085
671,4,0,4,21,28602060,3656,20213160,2582,9089
672,2,0,1,24,28621020,3656,20213160,2581,9091
673,7,0,5,20,28624680,3655,20213160,2579,9098
674,3,0,4,21,28638120,3655,20213160,2578,9101
675,7,0,5,20,28661880,3655,20213160,2576,9108
676,9,0,8,17,28679820,3654,20213160,2573,9117
677,5,0,6,19,28703400,3654,20213160,2571,9122
678,10,0,7,18,28737060,3654,20213160,2568,9132
679,5,0,5,20,28759080,3654,20213160,2566,9137
680,5,0,7,18,28772280,3654,20213160,2565,9142
681,7,0,7,18,28791420,3653,20213160,2562,9149
682,16,0,15,10,28825020,3654,20213160,2557,9165
683,10,0,12,13,28862820,3653,20213160,2554,9175
684,12,0,15,10,28890540,3652,20213160,2550,9187
685,15,0,18,7,28939380,3653,20213160,2545,9202
686,14,0,12,13,29018820,3653,20213160,2541,9216
687,8,0,9,16,29059380,3653,20213160,2538,9224
688,9,0,13,12,29088660,3655,20213160,2535,9233
689,0,0,4,21,29133180,3656,20213160,2535,9233
690,6,0,8,17,29144880,3657,20213160,2533,9239
691,5,0,6,19,29188200,3659,20213160,2532,9244
692,4,0,3,22,29208600,3658,20213160,2531,9248
693,9,0,9,16,29213220,3658,20213160,2528,9257
694,7,0,9,16,29238480,3658,20213160,2526,9264
695,2,0,5,20,29271720,3659,20213160,2525,9266
696,1,0,2,23,29293080,3660,20213160,2525,9267
697,5,0,6,19,29300220,3660,20213160,2523,9272
698,3,0,4,21,29317560,3660,20213160,2522,9275
699,6,0,5,20,29329740,3659,20213160,2520,9281
700,9,0,6,19,29349780,3658,20213160,2517,9290
701,10,0,8,17,29368260,3657,20213160,2514,9300
702,3,0,7,18,29382360,3657,20213160,2513,9303
703,6,0,6,19,29425200,3659,20213160,2511,9309
704,9,0,10,15,29437860,3658,20213160,2509,9318
705,9,0,11,14,29461140,3657,20213160,2506,9327
706,6,0,6,19,29512800,3659,20213160,2504,9333
707,8,0,8,17,29524800,3658,20213160,2501,9341
708,5,0,8,17,29537220,3657,20213160,2500,9346
709,7,0,8,17,29559900,3657,20213160,2498,9353
710,7,0,9,16,29588580,3657,20213160,2496,9360
711,13,0,12,13,29624400,3657,20213160,2492,9373
712,9,0,12,13,29661240,3658,20213160,2489,9382
713,11,0,12,13,29701320,3658,20213160,2485,9393
714,10,0,12,13,29743380,3658,20213160,2482,9403
715,5,0,10,15,29780220,3660,20213160,2481,9408
716,13,0,12,13,29837400,3662,20213160,2477,9421
717,11,0,8,17,29887440,3661,20213160,2474,9432
718,7,0,8,17,29919360,3662,20213160,2471,9439
719,6,0,8,17,29938320,3662,20213160,2470,9445
720,4,0,2,23,29978160,3662,20213160,2468,9449
721,3,0,3,22,29979780,3661,20213160,2468,9452
722,7,0,6,19,29996820,3662,20213160,2465,9459
723,2,0,3,22,30012780,3661,20213160,2465,9461
724,7,0,5,20,30023220,3660,20213160,2463,9468
725,3,0,3,22,30038760,3660,20213160,2462,9471
726,10,0,8,17,30046800,3659,20213160,2459,9481
727,10,0,9,16,30067020,3657,20213160,2456,9491
728,10,0,9,16,30090120,3656,20213160,2453,9501
729,10,0,8,17,30137040,3656,20213160,2450,9511
730,18,0,16,9,30161220,3655,20213160,2445,9529
731,4,0,7,18,30217020,3656,20213160,2443,9533
732,7,0,5,20,30251400,3656,20213160,2441,9540
733,12,0,10,15,30262140,3654,20213160,2438,9552
734,15,0,14,11,30306000,3655,20213160,2433,9567
735,10,0,8,17,30350640,3653,20213160,2430,9577
736,14,0,11,14,30394380,3654,20213160,2426,9591
737,16,0,17,8,30431760,3654,20213160,2422,9607
738,10,0,9,16,30479820,3652,20213160,2419,9617
739,13,0,12,13,30512760,3651,20213160,2415,9630
740,9,0,10,15,30554520,3651,20213160,2412,9639
741,6,0,7,18,30590700,3652,20213160,2411,9645
742,7,0,4,21,30621180,3651,20213160,2409,9652
743,2,0,4,21,30628560,3651,20213160,2408,9654
744,10,0,8,17,30645300,3650,20213160,2405,9664
745,8,0,11,14,30664920,3651,20213160,2403,9672
746,4,0,4,21,30711480,3651,20213160,2402,9676
747,7,0,8,17,30727560,3652,20213160,2400,9683
748,3,0,7,18,30753300,3653,20213160,2399,9686
749,2,0,3,22,30774600,3653,20213160,2398,9688
750,6,0,6,19,30793260,3654,20213160,2397,9694
751,6,0,5,20,30813060,3653,20213160,2395,9700
752,9,0,7,18,30836220,3653,20213160,2392,9709
753,9,0,11,14,30854580,3653,20213160,2390,9718
754,7,0,6,19,30908760,3654,20213160,2388,9725
755,7,0,7,18,30923340,3653,20213160,2386,9732
756,16,0,13,12,30951660,3652,20213160,2381,9748
757,16,0,15,10,31005780,3653,20213160,2377,9764
758,12,0,11,14,31043220,3650,20213160,2374,9776
759,5,0,7,18,31078320,3651,20213160,2372,9781
760,14,0,12,13,31096080,3649,20213160,2368,9795
761,8,0,8,17,31151580,3650,20213160,2366,9803
762,9,0,10,15,31177260,3650,20213160,2364,9812
763,13,0,12,13,31210440,3649,20213160,2360,9825
764,6,0,11,14,31238460,3650,20213160,2358,9831
765,6,0,7,18,31282800,3651,20213160,2357,9837
766,9,0,7,18,31309560,3650,20213160,2354,9846
767,5,0,6,19,31323360,3649,20213160,2353,9851
768,4,0,3,22,31348740,3649,20213160,2352,9855
769,9,0,8,17,31359240,3648,20213160,2349,9864
770,7,0,9,16,31378320,3648,20213160,2347,9871
771,4,0,3,22,31410720,3648,20213160,2346,9875
772,4,0,1,24,31431900,3648,20213160,2345,9879
773,7,0,5,20,31442340,3648,20213160,2343,9886
774,8,0,4,21,31462020,3646,20213160,2341,9894
775,9,0,8,17,31470060,3645,20213160,2339,9903
776,8,0,11,14,31486860,3645,20213160,2337,9911
777,12,0,6,19,31552380,3645,20213160,2333,9923
778,10,0,7,18,31574220,3644,20213160,2331,9933
779,5,0,4,21,31596300,3643,20213160,2329,9938
780,2,0,2,23,31620960,3644,20213160,2329,9940
781,15,0,10,15,31630380,3642,20213160,2325,9955
782,14,0,13,12,31659960,3641,20213160,2321,9969
783,9,0,11,14,31695480,3641,20213160,2319,9978
784,8,0,8,17,31751820,3642,20213160,2316,9986
785,5,0,4,21,31782720,3642,20213160,2315,9991
786,10,0,11,14,31792620,3642,20213160,2312,10001
787,6,0,4,21,31840500,3642,20213160,2311,10007
788,7,0,7,18,31859160,3643,20213160,2309,10014
789,3,0,6,19,31874340,3643,20213160,2308,10017
790,4,0,6,19,31895520,3643,20213160,2307,10021
791,6,0,6,19,31928940,3645,20213160,2306,10027
792,7,0,7,18,31951680,3645,20213160,2304,10034
793,7,0,8,17,31974300,3645,20213160,2302,10041
794,5,0,5,20,32009400,3646,20213160,2301,10046
795,5,0,5,20,32028300,3646,20213160,2299,10051
796,7,0,11,14,32033760,3646,20213160,2297,10058
797,8,0,11,14,32061720,3646,20213160,2295,10066
798,14,0,12,13,32111580,3646,20213160,2292,10080
799,7,0,10,15,32139960,3646,20213160,2290,10087
800,11,0,10,15,32196120,3647,20213160,2287,10098
801,7,0,6,19,32237220,3647,20213160,2285,10105
802,13,0,10,15,32256660,3646,20213160,2282,10118
803,10,0,11,14,32295120,3647,20213160,2279,10128
804,14,0,11,14,32332440,3645,20213160,2276,10142
805,15,0,16,9,32361360,3644,20213160,2272,10157
806,14,0,13,12,32440980,3646,20213160,2268,10171
807,9,0,11,14,32473980,3645,20213160,2266,10180
808,7,0,13,12,32505840,3647,20213160,2264,10187
809,13,0,13,12,32545260,3646,20213160,2261,10200
810,13,0,14,11,32596740,3647,20213160,2258,10213
811,4,0,7,18,32637660,3647,20213160,2257,10217
812,8,0,8,17,32660760,3647,20213160,2255,10225
813,12,0,8,17,32699460,3646,20213160,2252,10237
814,7,0,11,14,32717580,3647,20213160,2250,10244
815,8,0,6,19,32779080,3648,20213160,2248,10252
816,5,0,7,18,32790360,3648,20213160,2247,10257
817,2,0,3,22,32824740,3649,20213160,2246,10259
818,3,0,4,21,32838240,3650,20213160,2245,10262
819,6,0,6,19,32845020,3649,20213160,2244,10268
820,12,0,9,16,32870760,3648,20213160,2241,10280
821,5,0,5,20,32900520,3648,20213160,2240,10285
822,10,0,12,13,32910660,3648,20213160,2237,10295
823,10,0,10,15,32943600,3647,20213160,2235,10305
824,6,0,7,18,32991120,3648,20213160,2233,10311
825,14,0,12,13,33026400,3648,20213160,2230,10325
826,13,0,11,14,33063780,3647,20213160,2227,10338
827,9,0,12,13,33098340,3648,20213160,2224,10347
828,13,0,14,11,33138900,3648,20213160,2221,10360
829,12,0,15,10,33188820,3649,20213160,2218,10372
830,9,0,10,15,33239100,3649,20213160,2216,10381
831,12,0,11,14,33284820,3649,20213160,2213,10393
832,13,0,15,10,33309900,3648,20213160,2210,10406
833,6,0,7,18,33369780,3649,20213160,2209,10412
834,13,0,15,10,33393540,3650,20213160,2205,10425
835,10,0,9,16,33450960,3650,20213160,2203,10435
836,4,0,2,23,33494580,3650,20213160,2202,10439
837,7,0,8,17,33496620,3650,20213160,2200,10446
838,5,0,5,20,33524700,3650,20213160,2199,10451
839,3,0,6,19,33531660,3650,20213160,2198,10454
840,8,0,8,17,33562020,3651,20213160,2197,10462
841,5,0,10,15,33573960,3651,20213160,2195,10467
842,9,0,9,16,33617100,3652,20213160,2193,10476
843,6,0,5,20,33649440,3651,20213160,2192,10482
844,4,0,5,20,33659700,3651,20213160,2191,10486
845,4,0,7,18,33679440,3652,20213160,2190,10490
846,10,0,11,14,33700560,3652,20213160,2188,10500
847,5,0,7,18,33738540,3652,20213160,2186,10505
848,10,0,10,15,33762480,3652,20213160,2184,10515
849,5,0,9,16,33786480,3652,20213160,2183,10520
850,10,0,10,15,33823020,3653,20213160,2180,10530
851,10,0,8,17,33871140,3653,20213160,2178,10540
852,10,0,9,16,33903720,3653,20213160,2176,10550
853,5,0,8,17,33921660,3653,20213160,2175,10555
854,9,0,8,17,33964320,3654,20213160,2172,10564
855,8,0,6,19,33983040,3652,20213160,2171,10572
856,13,0,10,15,34004460,3651,20213160,2168,10585
857,7,0,9,16,34040280,3651,20213160,2166,10592
858,10,0,9,16,34079820,3652,20213160,2164,10602
859,7,0,10,15,34104180,3652,20213160,2162,10609
860,7,0,10,15,34135740,3653,20213160,2160,10616
861,7,0,7,18,34179600,3654,20213160,2159,10623
862,9,0,8,17,34202700,3653,20213160,2157,10632
863,4,0,3,22,34232760,3653,20213160,2156,10636
864,6,0,4,21,34249680,3652,20213160,2154,10642
865,6,0,6,19,34255140,3651,20213160,2153,10648
866,4,0,5,20,34263780,3650,20213160,2152,10652
867,2,0,4,21,34290600,3652,20213160,2152,10654
868,5,0,5,20,34308540,3652,20213160,2151,10659
869,9,0,9,16,34323000,3652,20213160,2148,10668
870,6,0,7,18,34348200,3652,20213160,2147,10674
871,8,0,6,19,34378740,3651,20213160,2145,10682
872,8,0,8,17,34398900,3651,20213160,2143,10690
873,11,0,13,12,34417140,3651,20213160,2141,10701
874,12,0,13,12,34471560,3652,20213160,2138,10713
875,9,0,16,9,34503960,3653,20213160,2136,10722
876,12,0,14,11,34569240,3655,20213160,2133,10734
877,10,0,10,15,34633200,3656,20213160,2131,10744
878,11,0,11,14,34674720,3656,20213160,2129,10755
879,16,0,14,11,34714560,3656,20213160,2125,10771
880,11,0,13,12,34751520,3655,20213160,2123,10782
881,15,0,16,9,34805580,3656,20213160,2119,10797
882,6,0,10,15,34860720,3657,20213160,2118,10803
883,7,0,6,19,34908780,3658,20213160,2117,10810
884,6,0,7,18,34928520,3658,20213160,2115,10816
885,4,0,3,22,34960560,3658,20213160,2114,10820
886,4,0,4,21,34972020,3658,20213160,2113,10824
887,6,0,5,20,34986060,3658,20213160,2112,10830
888,6,0,6,19,34996440,3657,20213160,2111,10836
889,8,0,8,17,35019180,3657,20213160,2109,10844
890,6,0,6,19,35052480,3658,20213160,2108,10850
891,4,0,5,20,35071380,3658,20213160,2107,10854
892,6,0,3,22,35095500,3657,20213160,2105,10860
893,3,0,4,21,35105040,3657,20213160,2105,10863
894,8,0,7,18,35122320,3657,20213160,2103,10871
895,10,0,11,14,35130420,3656,20213160,2101,10881
896,10,0,11,14,35155920,3655,20213160,2099,10891
897,7,0,7,18,35195400,3655,20213160,2097,10898
898,11,0,7,18,35239860,3655,20213160,2095,10909
899,16,0,14,11,35259000,3654,20213160,2091,10925
900,6,0,12,13,35280360,3653,20213160,2090,10931
901,11,0,8,17,35342220,3654,20213160,2088,10942
902,16,0,13,12,35369040,3652,20213160,2084,10958
903,10,0,8,17,35417700,3652,20213160,2082,10968
904,7,0,3,22,35457000,3651,20213160,2081,10975
905,6,0,6,19,35470380,3651,20213160,2079,10981
906,8,0,9,16,35485680,3651,20213160,2078,10989
907,6,0,5,20,35520960,3651,20213160,2076,10995
908,8,0,7,18,35539560,3651,20213160,2075,11003
909,4,0,4,21,35562900,3650,20213160,2074,11007
910,9,0,8,17,35575620,3650,20213160,2072,11016
911,3,0,3,22,35602320,3650,20213160,2071,11019
912,2,0,2,23,35618460,3650,20213160,2071,11021
913,4,0,6,19,35618460,3650,20213160,2070,11025
914,8,0,8,17,35635740,3650,20213160,2068,11033
915,2,0,7,18,35646240,3650,20213160,2068,11035
916,7,0,7,18,35674260,3650,20213160,2066,11042
917,5,0,5,20,35718300,3652,20213160,2065,11047
918,3,0,5,20,35724540,3651,20213160,2065,11050
919,8,0,8,17,35751240,3652,20213160,2063,11058
920,10,0,10,15,35768940,3651,20213160,2061,11068
921,13,0,13,12,35809860,3651,20213160,2058,11081
922,6,0,7,18,35853420,3651,20213160,2057,11087
923,14,0,12,13,35888160,3651,20213160,2054,11101
924,8,0,10,15,35926680,3652,20213160,2052,11109
925,11,0,10,15,35979180,3653,20213160,2050,11120
926,10,0,12,13,36003960,3652,20213160,2048,11130
927,11,0,11,14,36032100,3651,20213160,2046,11141
928,11,0,9,16,36086820,3652,20213160,2043,11152
929,9,0,11,14,36109080,3651,20213160,2041,11161
930,5,0,7,18,36157440,3653,20213160,2040,11166
931,12,0,10,15,36184260,3652,20213160,2038,11178
932,5,0,6,19,36227820,3653,20213160,2037,11183
933,1,0,3,22,36241620,3653,20213160,2037,11184
934,5,0,2,23,36268140,3654,20213160,2036,11189
935,4,0,2,23,36274200,3653,20213160,2035,11193
936,3,0,1,24,36281340,3652,20213160,2034,11196
937,8,0,6,19,36285120,3651,20213160,2033,11204
938,8,0,8,17,36298680,3651,20213160,2031,11212
939,8,0,7,18,36327180,3650,20213160,2029,11220
940,12,0,12,13,36351900,3650,20213160,2027,11232
941,7,0,9,16,36383340,3650,20213160,2025,11239
942,4,0,4,21,36421440,3650,20213160,2025,11243
943,7,0,6,19,36445020,3651,20213160,2023,11250
944,9,0,9,16,36456720,3650,20213160,2021,11259
945,6,0,5,20,36488400,3649,20213160,2020,11265
946,10,0,10,15,36508380,3649,20213160,2018,11275
947,9,0,10,15,36537240,3649,20213160,2016,11284
948,8,0,7,18,36580860,3649,20213160,2015,11292
949,11,0,9,16,36612780,3649,20213160,2013,11303
950,7,0,8,17,36630180,3648,20213160,2011,11310
951,15,0,15,10,36654840,3647,20213160,2008,11325
952,4,0,9,16,36699180,3648,20213160,2007,11329
953,4,0,3,22,36746160,3649,20213160,2007,11333
954,11,0,8,17,36756660,3648,20213160,2004,11344
955,11,0,13,12,36780000,3648,20213160,2002,11355
956,6,0,11,14,36818220,3649,20213160,2001,11361
957,3,0,4,21,36866760,3650,20213160,2000,11364
958,11,0,8,17,36876240,3649,20213160,1998,11375
959,3,0,2,23,36903000,3648,20213160,1998,11378
960,3,0,3,22,36906540,3648,20213160,1997,11381
961,7,0,5,20,36929220,3648,20213160,1996,11388
962,7,0,4,21,36952500,3648,20213160,1994,11395
963,5,0,5,20,36963840,3647,20213160,1993,11400
964,7,0,8,17,36971940,3647,20213160,1992,11407
965,8,0,10,15,37000920,3647,20213160,1990,11415
966,5,0,7,18,37032060,3648,20213160,1989,11420
967,6,0,7,18,37065120,3649,20213160,1988,11426
968,11,0,13,12,37079100,3648,20213160,1986,11437
969,8,0,12,13,37116360,3649,20213160,1984,11445
970,8,0,11,14,37146540,3648,20213160,1983,11453
971,12,0,13,12,37188540,3649,20213160,1981,11465
972,17,0,14,11,37236840,3648,20213160,1977,11482
973,10,0,8,17,37273140,3646,20213160,1975,11492
974,7,0,7,18,37311480,3647,20213160,1974,11499
975,9,0,9,16,37345680,3648,20213160,1972,11508
976,5,0,6,19,37366080,3647,20213160,1971,11513
977,14,0,10,15,37397580,3646,20213160,1969,11527
978,3,0,4,21,37419480,3645,20213160,1968,11530
979,6,0,6,19,37440120,3646,20213160,1967,11536
980,4,0,8,17,37445880,3646,20213160,1966,11540
981,3,0,2,23,37493520,3647,20213160,1966,11543
982,6,0,5,20,37498500,3647,20213160,1964,11549
983,6,0,6,19,37512000,3646,20213160,1963,11555
984,5,0,4,21,37531380,3645,20213160,1962,11560
985,5,0,6,19,37542120,3645,20213160,1961,11565
986,3,0,2,23,37565400,3645,20213160,1961,11568
987,3,0,3,22,37573620,3645,20213160,1960,11571
988,6,0,6,19,37579860,3645,20213160,1959,11577
989,10,0,9,16,37600620,3644,20213160,1957,11587
990,7,0,13,12,37611660,3644,20213160,1956,11594
991,6,0,6,19,37665060,3645,20213160,1955,11600
992,11,0,9,16,37696200,3645,20213160,1953,11611
993,12,0,14,11,37707360,3644,20213160,1950,11623
994,12,0,12,13,37746960,3643,20213160,1948,11635
995,9,0,13,12,37786500,3644,20213160,1946,11644
996,10,0,14,11,37811880,3643,20213160,1945,11654
997,17,0,16,9,37876560,3644,20213160,1941,11671
998,10,0,12,13,37934280,3645,20213160,1940,11681
999,12,0,11,14,37989180,3645,20213160,1937,11693
1000,8,0,9,16,38035980,3646,20213160,1936,11701
1001,9,0,10,15,38070420,3647,20213160,1934,11710
1002,7,0,7,18,38122440,3648,20213160,1933,11717
1003,8,0,10,15,38132220,3647,20213160,1931,11725
1004,9,0,12,13,38166240,3648,20213160,1930,11734
1005,10,0,12,13,38204820,3648,20213160,1928,11744
1006,8,0,9,16,38251740,3649,20213160,1926,11752
1007,3,0,6,19,38283240,3650,20213160,1926,11755
1008,2,0,4,21,38316240,3652,20213160,1925,11757
1009,2,0,4,21,38319060,3651,20213160,1925,11759
1010,11,0,8,17,38355120,3652,20213160,1923,11770
1011,24,0,22,3,38377680,3651,20213160,1919,11794
1012,35,14,19,6,38449020,3649,20215200,1914,11829
1013,33,40,14,11,38508420,3652,20217840,1909,11862
1014,33,40,25,0,38554860,3654,20258220,1908,11895
1015,29,39,25,0,38658720,3657,20305800,1909,11924
1016,33,38,25,0,38771340,3660,20377620,1912,11957
1017,32,40,25,0,38846820,3659,20434200,1913,11989
1018,29,40,22,3,38934120,3659,20493960,1916,12018
1019,28,31,24,1,39017820,3660,20623200,1924,12046
1020,29,11,25,0,39110700,3652,21020880,1956,12075
1021,27,0,25,0,39178920,3646,21236220,1971,12102
1022,34,13,25,0,39263160,3646,21241440,1966,12136
1023,31,34,17,8,39342660,3648,21248400,1961,12167
1024,32,40,14,11,39415620,3651,21260760,1959,12199
1025,32,40,25,0,39460560,3652,21300060,1960,12231
1026,36,36,21,4,39537720,3654,21332100,1961,12267
1027,29,39,25,0,39621000,3654,21447120,1966,12296
1028,26,38,25,0,39706080,3656,21518820,1970,12322
1029,34,36,25,0,39812220,3657,21595380,1973,12356
1030,35,40,21,4,39884760,3657,21650160,1974,12391
1031,35,40,23,2,39940800,3657,21694260,1975,12426
1032,27,34,25,0,40048620,3659,21806820,1981,12453
1033,32,35,25,0,40134600,3656,21948540,1988,12485
1034,36,32,25,0,40238220,3654,22012320,1989,12521
1035,28,14,25,0,40331340,3647,22591980,2036,12549
1036,34,33,25,0,40377840,3647,22641240,2034,12583
1037,38,36,25,0,40485480,3649,22661880,2031,12621
1038,32,40,25,0,40582680,3651,22700880,2031,12653
1039,28,36,25,0,40684140,3652,22776240,2033,12681
1040,35,40,17,8,40759860,3650,22809540,2032,12716
1041,35,40,24,1,40823280,3649,22900740,2036,12751
1042,33,40,25,0,40899180,3651,22932420,2035,12784
1043,25,29,25,0,40996140,3648,23163480,2052,12809
1044,25,27,25,0,41092500,3648,23337180,2062,12834
1045,33,39,25,0,41171460,3648,23343720,2058,12867
1046,35,40,25,0,41237940,3649,23358840,2055,12902
1047,32,40,25,0,41336520,3650,23378760,2053,12934
1048,35,40,22,3,41447580,3651,23455980,2055,12969
1049,29,40,17,8,41523120,3648,23603100,2064,12998
1050,38,39,16,9,41573160,3649,23620080,2063,13036
1051,31,37,25,0,41625600,3651,23709240,2068,13067
1052,30,34,25,0,41740140,3650,23815320,2072,13097
1053,31,37,23,2,41832480,3649,23948100,2078,13128
1054,27,40,25,0,41883960,3650,23959020,2076,13155
1055,21,26,25,0,42009660,3651,24309300,2103,13176
1056,23,0,22,3,42105180,3642,25506960,2202,13199
1057,34,30,11,14,42163200,3643,25509300,2198,13233
1058,28,40,11,14,42198180,3644,25520220,2194,13261
1059,39,36,25,0,42263340,3647,25616400,2199,13300
1060,32,40,25,0,42287100,3647,25634160,2199,13332
1061,27,35,25,0,42414540,3651,25698780,2201,13359
1062,32,38,25,0,42495240,3650,25801440,2204,13391
1063,38,40,25,0,42578640,3651,25904700,2209,13429
1064,35,38,25,0,42678780,3651,25964880,2210,13464
1065,35,40,25,0,42766320,3651,25984860,2206,13499
1066,28,40,22,3,42833460,3649,26039040,2207,13527
1067,39,40,25,0,42935160,3650,26093640,2206,13566
1068,30,34,25,0,43042740,3651,26178300,2209,13596
1069,24,20,21,4,43125600,3645,26720340,2250,13620
1070,25,22,25,0,43209960,3646,26794260,2252,13645
1071,28,28,25,0,43300980,3647,26808240,2248,13673
1072,40,40,15,10,43362300,3647,26813580,2245,13713
1073,37,37,25,0,43450920,3649,26859720,2244,13750
1074,31,40,22,3,43534740,3647,27042240,2254,13781
1075,33,40,20,5,43588020,3649,27050820,2253,13814
1076,27,36,25,0,43706580,3652,27123360,2255,13841
1077,30,36,25,0,43766700,3653,27148260,2254,13871
1078,32,36,22,3,43869900,3655,27173280,2253,13903
1079,23,24,25,0,43961040,3653,27813120,2302,13926
1080,27,13,25,0,44059920,3649,28279440,2335,13953
1081,36,33,18,7,44129100,3648,28292460,2330,13989
1082,38,40,10,15,44170380,3649,28292460,2330,14027
1083,29,40,21,4,44242560,3652,28358340,2330,14056
1084,21,40,14,11,44290140,3654,28366440,2330,14077
1085,32,37,25,0,44383200,3658,28494300,2336,14109
1086,34,40,25,0,44428920,3657,28581540,2340,14143
1087,31,37,21,4,44549820,3656,28692540,2343,14174
1088,29,37,25,0,44633100,3656,28745400,2343,14203
1089,35,38,25,0,44713320,3656,28777620,2341,14238
1090,29,37,25,0,44785980,3655,28844220,2342,14267
1091,35,39,25,0,44905620,3656,28920240,2342,14302
1092,26,40,25,0,44969460,3655,28954860,2341,14328
1093,30,40,25,0,45070800,3655,29001540,2340,14358
1094,35,40,25,0,45157740,3653,29099040,2342,14393
1095,31,38,25,0,45238200,3652,29148300,2342,14424
1096,29,38,25,0,45336960,3653,29240760,2344,14453
1097,27,37,25,0,45437640,3654,29301960,2345,14480
1098,28,40,20,5,45502800,3652,29364180,2346,14508
1099,26,23,25,0,45627180,3652,30269940,2414,14534
1100,32,33,25,0,45677880,3650,30275220,2408,14566
1101,34,39,25,0,45756900,3651,30291240,2405,14600
1102,37,37,25,0,45856260,3653,30324420,2404,14637
1103,22,16,25,0,45976080,3650,31025820,2455,14659
1104,27,33,15,10,46036020,3649,31028220,2452,14686
1105,31,37,14,11,46106520,3652,31049760,2449,14717
1106,34,40,16,9,46130880,3653,31058520,2449,14751
1107,31,38,25,0,46225800,3656,31137900,2451,14782
1108,30,38,25,0,46299420,3656,31172580,2449,14812
1109,41,39,25,0,46404060,3655,31266780,2450,14853
1110,35,39,25,0,46477500,3654,31347300,2452,14888
1111,27,35,25,0,46570680,3654,31393920,2451,14915
1112,35,39,25,0,46664040,3652,31587480,2460,14950
1113,36,39,25,0,46730880,3653,31616580,2459,14986
1114,28,30,25,0,46848240,3652,31892040,2476,15014
1115,33,26,25,0,46934520,3648,32268960,2499,15047
1116,25,25,25,0,47025540,3648,32514780,2513,15072
1117,35,39,14,11,47101080,3649,32520180,2509,15107
1118,37,40,11,14,47153520,3651,32534400,2509,15144
1119,32,40,13,12,47178840,3652,32574720,2511,15176
1120,34,40,25,0,47250000,3655,32642040,2512,15210
1121,31,40,25,0,47315160,3654,32686800,2512,15241
1122,32,40,18,7,47385960,3655,32708580,2511,15273
1123,26,26,25,0,47493240,3655,33325740,2555,15299
1124,27,26,25,0,47562480,3653,33472260,2561,15326
1125,27,31,25,0,47665740,3655,33590640,2564,15353
1126,29,35,25,0,47736060,3653,33769980,2573,15382
1127,34,40,19,6,47821320,3653,33800700,2570,15416
1128,29,35,25,0,47910120,3655,33849960,2571,15445
1129,33,37,23,2,47999820,3653,33966300,2574,15478
1130,27,34,25,0,48062100,3652,34041600,2575,15505
1131,36,38,25,0,48161880,3652,34157340,2578,15541
1132,41,40,25,0,48234300,3653,34202760,2578,15582
1133,35,39,25,0,48346080,3652,34360740,2583,15617
1134,29,40,17,8,48411660,3649,34382280,2581,15646
1135,34,38,17,8,48483240,3651,34405380,2580,15680
1136,30,38,16,9,48564120,3651,34473420,2581,15710
1137,37,40,25,0,48602040,3651,34501800,2580,15747
1138,34,39,21,4,48690720,3651,34530420,2578,15781
1139,22,31,25,0,48771600,3651,34804140,2595,15803
1140,26,23,25,0,48892380,3651,35232540,2621,15829
1141,28,17,25,0,48958680,3646,35684520,2649,15857
1142,39,31,25,0,49035120,3645,35760420,2647,15896
1143,28,40,19,6,49106940,3646,35769780,2645,15924
1144,29,34,25,0,49215660,3651,35803680,2644,15953
1145,34,40,17,8,49282320,3651,35813460,2642,15987
1146,32,40,25,0,49360560,3653,35912520,2645,16019
1147,31,39,25,0,49460820,3652,36092280,2653,16050
1148,34,39,25,0,49527900,3652,36122160,2651,16084
1149,40,40,25,0,49634580,3653,36155220,2648,16124
1150,25,20,25,0,49734120,3648,37025640,2707,16149
1151,26,24,25,0,49815000,3648,37033560,2703,16175
1152,30,31,25,0,49906080,3649,37076940,2700,16205
1153,30,40,16,9,49974900,3650,37079340,2698,16235
1154,40,40,18,7,50036460,3652,37099500,2696,16275
1155,25,39,25,0,50095020,3653,37171620,2698,16300
1156,28,33,25,0,50220960,3654,37304280,2702,16328
1157,24,4,25,0,50328540,3647,38035620,2751,16352
1158,31,1,25,0,50407980,3644,38130000,2751,16383
1159,26,9,23,2,50484300,3644,38135940,2746,16409
1160,28,23,15,10,50573280,3645,38142540,2741,16437
1161,25,32,25,0,50608980,3646,38160780,2739,16462
1162,27,37,25,0,50698860,3648,38181660,2735,16489
1163,26,40,25,0,50786220,3651,38220180,2735,16515
1164,32,40,25,0,50887800,3652,38301960,2736,16547
1165,36,40,25,0,50991360,3652,38366160,2736,16583
1166,32,35,23,2,51063000,3652,38423580,2737,16615
1167,28,36,25,0,51123720,3651,38448120,2734,16643
1168,38,40,25,0,51208620,3651,38533080,2734,16681
1169,26,38,25,0,51294840,3651,38566980,2733,16707
1170,30,38,24,1,51382140,3651,38647620,2734,16737
1171,33,36,25,0,51482340,3651,38726460,2735,16770
1172,36,38,25,0,51590220,3650,38764620,2731,16806
1173,38,35,25,0,51667800,3649,38800020,2729,16844
1174,36,40,15,10,51733560,3647,39065400,2743,16880
1175,20,34,25,0,51791040,3648,39107340,2743,16900
1176,19,31,25,0,51867900,3648,39172500,2744,16919
1177,9,0,15,10,51975300,3643,40371720,2826,16928
1178,4,0,7,18,52030320,3644,40371720,2826,16932
1179,8,0,5,20,52080960,3645,40371720,2824,16940
1180,5,0,5,20,52089600,3644,40371720,2823,16945
1181,8,0,6,19,52117020,3644,40371720,2822,16953
1182,11,0,11,14,52135800,3644,40371720,2819,16964
1183,8,0,10,15,52162800,3643,40371720,2818,16972
1184,7,0,7,18,52192500,3643,40371720,2816,16979
1185,16,0,13,12,52215900,3642,40371720,2813,16995
1186,16,0,18,7,52264380,3643,40371720,2810,17011
1187,11,0,16,9,52319160,3643,40371720,2808,17022
1188,11,0,13,12,52379640,3644,40371720,2806,17033
1189,9,0,8,17,52437420,3644,40371720,2804,17042
1190,12,0,11,14,52469700,3644,40371720,2802,17054
1191,11,0,12,13,52496940,3644,40371720,2800,17065
1192,10,0,8,17,52566060,3645,40371720,2798,17075
1193,4,0,9,16,52580340,3645,40371720,2797,17079
1194,10,0,10,15,52623420,3646,40371720,2795,17089
1195,5,0,6,19,52656780,3646,40371720,2794,17094
1196,6,0,5,20,52687800,3646,40371720,2793,17100
1197,6,0,3,22,52709160,3646,40371720,2792,17106
1198,4,0,4,21,52721160,3646,40371720,2791,17110
1199,5,0,7,18,52732680,3646,40371720,2790,17115
1200,6,0,4,21,52766580,3646,40371720,2789,17121
1201,4,0,4,21,52778700,3646,40371720,2788,17125
1202,5,0,3,22,52798680,3646,40371720,2787,17130
1203,6,0,5,20,52807620,3645,40371720,2786,17136
1204,7,0,5,20,52831080,3645,40371720,2785,17143
1205,3,0,5,20,52845660,3646,40371720,2784,17146
1206,12,0,9,16,52869660,3645,40371720,2782,17158
1207,3,0,4,21,52899300,3645,40371720,2781,17161
1208,6,0,6,19,52922520,3646,40371720,2780,17167
1209,14,0,12,13,52933980,3645,40371720,2777,17181
1210,4,0,7,18,52967940,3645,40371720,2776,17185
1211,9,0,5,20,53012580,3645,40371720,2775,17194
1212,13,0,12,13,53024340,3644,40371720,2772,17207
1213,7,0,13,12,53040060,3644,40371720,2771,17214
1214,14,0,13,12,53103180,3645,40371720,2768,17228
1215,6,0,12,13,53134620,3645,40371720,2767,17234
1216,11,0,8,17,53194500,3645,40371720,2765,17245
1217,8,0,8,17,53221260,3645,40371720,2764,17253
1218,8,0,8,17,53249040,3645,40371720,2762,17261
1219,9,0,12,13,53272800,3646,40371720,2760,17270
1220,6,0,2,23,53335500,3646,40371720,2759,17276
1221,6,0,4,21,53347260,3646,40371720,2758,17282
1222,6,0,6,19,53352600,3645,40371720,2757,17288
1223,5,0,4,21,53375400,3645,40371720,2756,17293
1224,4,0,3,22,53396700,3645,40371720,2755,17297
1225,3,0,4,21,53403180,3645,40371720,2755,17300
1226,8,0,9,16,53413080,3645,40371720,2753,17308
1227,5,0,6,19,53429760,3644,40371720,2752,17313
1228,2,0,3,22,53454720,3645,40371720,2752,17315
1229,4,0,4,21,53467320,3645,40371720,2751,17319
1230,5,0,3,22,53482740,3644,40371720,2750,17324
1231,8,0,8,17,53490420,3644,40371720,2749,17332
1232,5,0,5,20,53518980,3644,40371720,2748,17337
1233,9,0,7,18,53542680,3644,40371720,2746,17346
1234,12,0,7,18,53567880,3643,40371720,2744,17358
1235,6,0,3,22,53595060,3642,40371720,2743,17364
1236,9,0,8,17,53604840,3642,40371720,2741,17373
1237,10,0,12,13,53620080,3641,40371720,2739,17383
1238,7,0,8,17,53675160,3642,40371720,2738,17390
1239,9,0,6,19,53707740,3642,40371720,2736,17399
1240,7,0,4,21,53735400,3641,40371720,2735,17406
1241,6,0,5,20,53750880,3641,40371720,2734,17412
1242,7,0,7,18,53768460,3641,40371720,2732,17419
1243,7,0,7,18,53792160,3641,40371720,2731,17426
1244,9,0,11,14,53813640,3641,40371720,2730,17435
1245,6,0,8,17,53846760,3641,40371720,2728,17441
1246,1,0,2,23,53878320,3642,40371720,2728,17442
1247,4,0,5,20,53883600,3642,40371720,2728,17446
1248,8,0,7,18,53902980,3642,40371720,2726,17454
1249,4,0,6,19,53924520,3642,40371720,2725,17458
1250,4,0,5,20,53953260,3643,40371720,2725,17462
1251,3,0,4,21,53969340,3643,40371720,2724,17465
1252,4,0,8,17,53969340,3643,40371720,2723,17469
1253,7,0,7,18,53999400,3643,40371720,2722,17476
1254,4,0,4,21,54026760,3643,40371720,2721,17480
1255,10,0,9,16,54046440,3643,40371720,2719,17490
1256,7,0,8,17,54067260,3642,40371720,2718,17497
1257,15,0,16,9,54088680,3642,40371720,2715,17512
1258,9,0,14,11,54132060,3642,40371720,2714,17521
1259,10,0,12,13,54190500,3643,40371720,2712,17531
1260,8,0,5,20,54241920,3643,40371720,2710,17539
1261,16,0,12,13,54255480,3642,40371720,2708,17555
1262,17,0,15,10,54293580,3641,40371720,2704,17572
1263,5,0,12,13,54328620,3641,40371720,2704,17577
1264,12,0,10,15,54389640,3642,40371720,2701,17589
1265,5,0,8,17,54423420,3643,40371720,2700,17594
1266,7,0,6,19,54460740,3643,40371720,2699,17601
1267,11,0,9,16,54482220,3642,40371720,2697,17612
1268,1,0,6,19,54501720,3643,40371720,2697,17613
1269,6,0,6,19,54531960,3643,40371720,2696,17619
1270,7,0,6,19,54565560,3644,40371720,2695,17626
1271,4,0,6,19,54575280,3643,40371720,2694,17630
1272,7,0,9,16,54595380,3644,40371720,2693,17637
1273,4,0,3,22,54636360,3644,40371720,2692,17641
1274,7,0,8,17,54645480,3644,40371720,2691,17648
1275,6,0,4,21,54674220,3644,40371720,2690,17654
1276,4,0,4,21,54682500,3643,40371720,2689,17658
1277,6,0,7,18,54698700,3644,40371720,2688,17664
1278,7,0,7,18,54719940,3643,40371720,2687,17671
1279,7,0,8,17,54737400,3643,40371720,2685,17678
1280,10,0,11,14,54767940,3643,40371720,2684,17688
1281,7,0,12,13,54791820,3644,40371720,2682,17695
1282,9,0,10,15,54831660,3644,40371720,2681,17704
1283,10,0,6,19,54889020,3644,40371720,2679,17714
1284,11,0,9,16,54910680,3643,40371720,2677,17725
1285,8,0,10,15,54927480,3643,40371720,2676,17733
1286,9,0,11,14,54956220,3643,40371720,2674,17742
1287,14,0,16,9,54990300,3643,40371720,2672,17756
1288,10,0,11,14,55038840,3643,40371720,2670,17766
1289,8,0,13,12,55060560,3643,40371720,2668,17774
1290,8,0,6,19,55119480,3643,40371720,2667,17782
1291,6,0,8,17,55127880,3642,40371720,2666,17788
1292,11,0,9,16,55169040,3643,40371720,2664,17799
1293,7,0,9,16,55193580,3643,40371720,2663,17806
1294,13,0,11,14,55232640,3643,40371720,2660,17819
1295,4,0,7,18,55259640,3642,40371720,2660,17823
1296,9,0,9,16,55284540,3642,40371720,2658,17832
1297,4,0,5,20,55313280,3642,40371720,2657,17836
1298,6,0,7,18,55342980,3643,40371720,2656,17842
1299,6,0,5,20,55368780,3643,40371720,2655,17848
1300,3,0,5,20,55378920,3643,40371720,2655,17851
1301,5,0,5,20,55396980,3643,40371720,2654,17856
1302,8,0,7,18,55418460,3643,40371720,2653,17864
1303,7,0,8,17,55440540,3643,40371720,2651,17871
1304,4,0,6,19,55463460,3643,40371720,2651,17875
1305,12,0,12,13,55487100,3643,40371720,2649,17887
1306,8,0,7,18,55527120,3643,40371720,2647,17895
1307,13,0,12,13,55551240,3642,40371720,2645,17908
1308,12,0,14,11,55568280,3641,40371720,2643,17920
1309,10,0,8,17,55622880,3641,40371720,2641,17930
1310,13,0,11,14,55657380,3641,40371720,2639,17943
1311,11,0,9,16,55696500,3640,40371720,2637,17954
1312,14,0,13,12,55732380,3640,40371720,2635,17968
1313,18,0,16,9,55773480,3639,40371720,2631,17986
1314,8,0,9,16,55826160,3639,40371720,2630,17994
1315,9,0,7,18,55868700,3639,40371720,2629,18003
1316,6,0,6,19,55888260,3639,40371720,2628,18009
1317,6,0,5,20,55918560,3639,40371720,2626,18015
1318,6,0,5,20,55940160,3639,40371720,2625,18021
1319,3,0,6,19,55950240,3639,40371720,2625,18024
1320,1,0,2,23,55980960,3640,40371720,2625,18025
1321,3,0,3,22,55987320,3640,40371720,2624,18028
1322,4,0,6,19,55995180,3641,40371720,2624,18032
1323,2,0,4,21,56012700,3641,40371720,2623,18034
1324,5,0,5,20,56029620,3641,40371720,2622,18039
1325,7,0,8,17,56039040,3641,40371720,2621,18046
1326,4,0,2,23,56073000,3640,40371720,2621,18050
1327,2,0,2,23,56085060,3641,40371720,2620,18052
1328,10,0,8,17,56088000,3640,40371720,2618,18062
1329,12,0,15,10,56099700,3640,40371720,2616,18074
1330,7,0,9,16,56152920,3640,40371720,2615,18081
1331,11,0,10,15,56189460,3640,40371720,2613,18092
1332,11,0,11,14,56223960,3640,40371720,2612,18103
1333,12,0,11,14,56276760,3640,40371720,2610,18115
1334,9,0,6,19,56318760,3640,40371720,2608,18124
1335,9,0,10,15,56338620,3640,40371720,2606,18133
1336,5,0,10,15,56359920,3640,40371720,2606,18138
1337,6,0,7,18,56404980,3641,40371720,2605,18144
1338,11,0,8,17,56435040,3640,40371720,2603,18155
1339,6,0,6,19,56460120,3640,40371720,2602,18161
1340,6,0,5,20,56480460,3640,40371720,2601,18167
1341,6,0,5,20,56501580,3640,40371720,2600,18173
1342,13,0,10,15,56518680,3639,40371720,2598,18186
1343,1,0,3,22,56549280,3639,40371720,2597,18187
1344,3,0,4,21,56561760,3639,40371720,2597,18190
1345,2,0,5,20,56564100,3639,40371720,2597,18192
1346,5,0,9,16,56565600,3639,40371720,2596,18197
1347,9,0,13,12,56586780,3639,40371720,2594,18206
1348,5,0,10,15,56614260,3639,40371720,2593,18211
1349,11,0,14,11,56642280,3640,40371720,2592,18222
1350,9,0,9,16,56692620,3639,40371720,2590,18231
1351,5,0,7,18,56706900,3639,40371720,2589,18236
1352,10,0,9,16,56727180,3638,40371720,2588,18246
1353,14,0,15,10,56744100,3637,40371720,2585,18260
1354,15,0,15,10,56782200,3636,40371720,2583,18275
1355,7,0,13,12,56815500,3636,40371720,2582,18282
1356,7,0,12,13,56851020,3637,40371720,2580,18289
1357,10,0,10,15,56906400,3638,40371720,2579,18299
1358,9,0,11,14,56933340,3637,40371720,2577,18308
1359,19,0,17,8,56970240,3637,40371720,2574,18327
1360,8,0,14,11,57003300,3636,40371720,2573,18335
1361,16,0,13,12,57067320,3636,40371720,2570,18351
1362,10,0,15,10,57090600,3636,40371720,2569,18361
1363,13,0,20,5,57129120,3637,40371720,2567,18374
1364,5,0,17,8,57156960,3637,40371720,2566,18379
1365,8,0,12,13,57226500,3638,40371720,2564,18387
1366,7,0,11,14,57267720,3639,40371720,2563,18394
1367,4,0,8,17,57302460,3639,40371720,2563,18398
1368,5,0,8,17,57318060,3639,40371720,2562,18403
1369,4,0,8,17,57334980,3639,40371720,2561,18407
1370,12,0,14,11,57348600,3639,40371720,2559,18419
1371,6,0,7,18,57389700,3638,40371720,2558,18425
1372,5,0,6,19,57411180,3638,40371720,2557,18430
1373,6,0,8,17,57418800,3638,40371720,2556,18436
1374,9,0,14,11,57433380,3638,40371720,2555,18445
1375,9,0,8,17,57479820,3638,40371720,2554,18454
1376,10,0,10,15,57497340,3637,40371720,2552,18464
1377,4,0,9,16,57513120,3637,40371720,2551,18468
1378,5,0,8,17,57540660,3637,40371720,2550,18473
1379,4,0,7,18,57562620,3637,40371720,2550,18477
1380,12,0,12,13,57579780,3637,40371720,2548,18489
1381,8,0,11,14,57605460,3636,40371720,2547,18497
1382,6,0,9,16,57637140,3637,40371720,2546,18503
1383,8,0,9,16,57669240,3637,40371720,2544,18511
1384,10,0,11,14,57687840,3636,40371720,2543,18521
1385,10,0,11,14,57716460,3636,40371720,2541,18531
1386,3,0,9,16,57734520,3636,40371720,2541,18534
1387,8,0,10,15,57765720,3636,40371720,2539,18542
1388,10,0,14,11,57786660,3636,40371720,2538,18552
1389,7,0,12,13,57830100,3637,40371720,2537,18559
1390,4,0,9,16,57863760,3637,40371720,2536,18563
1391,6,0,6,19,57896760,3637,40371720,2535,18569
1392,5,0,8,17,57910800,3637,40371720,2534,18574
1393,3,0,4,21,57935880,3637,40371720,2534,18577
1394,3,0,6,19,57942480,3638,40371720,2533,18580
1395,12,0,14,11,57954780,3637,40371720,2531,18592
1396,3,0,8,17,57987540,3637,40371720,2531,18595
1397,2,0,5,20,58009800,3638,40371720,2531,18597
1398,8,0,8,17,58027320,3638,40371720,2529,18605
1399,10,0,11,14,58043700,3637,40371720,2528,18615
1400,7,0,11,14,58067880,3637,40371720,2527,18622
1401,7,0,9,16,58101240,3637,40371720,2526,18629
1402,6,0,9,16,58132860,3638,40371720,2525,18635
1403,11,0,10,15,58158540,3637,40371720,2523,18646
1404,11,0,15,10,58184040,3637,40371720,2521,18657
1405,6,0,13,12,58210620,3637,40371720,2520,18663
1406,10,0,14,11,58251060,3637,40371720,2519,18673
1407,11,0,16,9,58298520,3638,40371720,2517,18684
1408,14,0,15,10,58353120,3638,40371720,2515,18698
1409,10,0,13,12,58408980,3639,40371720,2513,18708
1410,16,0,11,14,58452480,3638,40371720,2511,18724
1411,10,0,17,8,58462020,3637,40371720,2509,18734
1412,9,0,14,11,58506780,3638,40371720,2508,18743
1413,9,0,11,14,58556220,3638,40371720,2506,18752
1414,6,0,8,17,58592520,3638,40371720,2505,18758
1415,2,0,6,19,58619100,3639,40371720,2505,18760
1416,2,0,5,20,58631100,3639,40371720,2505,18762
1417,9,0,11,14,58635960,3639,40371720,2503,18771
1418,2,0,6,19,58661100,3639,40371720,2503,18773
1419,4,0,6,19,58681560,3639,40371720,2502,18777
1420,2,0,6,19,58685640,3639,40371720,2502,18779
1421,2,0,5,20,58690020,3638,40371720,2502,18781
1422,13,0,10,15,58712820,3638,40371720,2500,18794
1423,4,0,9,16,58729920,3638,40371720,2499,18798
1424,12,0,13,12,58753620,3637,40371720,2497,18810
1425,16,0,14,11,58807200,3637,40371720,2495,18826
1426,14,0,16,9,58844220,3637,40372680,2493,18840
1427,11,3,12,13,58895520,3637,40375140,2491,18851
1428,13,13,12,13,58912740,3638,40379280,2490,18864
1429,11,12,17,8,58973340,3640,40397880,2489,18875
1430,13,5,25,0,59021700,3640,40482180,2492,18888
1431,15,0,16,9,59097780,3639,40494720,2491,18903
1432,7,0,10,15,59141340,3638,40494720,2489,18910
1433,5,0,9,16,59161800,3638,40494720,2489,18915
1434,9,0,11,14,59194980,3639,40494720,2487,18924
1435,5,0,9,16,59216460,3638,40494720,2487,18929
1436,2,0,6,19,59241180,3639,40494720,2486,18931
1437,7,0,7,18,59257560,3639,40494720,2485,18938
1438,5,0,10,15,59268060,3639,40494720,2484,18943
1439,5,0,7,18,59299980,3639,40494720,2484,18948
1440,8,0,12,13,59308260,3639,40494720,2482,18956
1441,3,0,8,17,59334120,3639,40494720,2482,18959
1442,5,0,7,18,59358000,3639,40494720,2481,18964
1443,7,0,9,16,59383020,3639,40494720,2480,18971
1444,6,0,8,17,59408460,3639,40494720,2479,18977
1445,6,0,10,15,59421240,3639,40494720,2478,18983
1446,3,0,8,17,59448300,3640,40494720,2478,18986
1447,7,0,7,18,59477400,3640,40494720,2477,18993
1448,5,0,10,15,59482440,3640,40494720,2476,18998
1449,15,0,16,9,59507460,3639,40494720,2474,19013
1450,9,0,14,11,59542500,3639,40494720,2472,19022
1451,10,0,14,11,59581500,3639,40494720,2471,19032
1452,12,0,13,12,59622660,3639,40494720,2469,19044
1453,8,0,11,14,59660340,3639,40494720,2468,19052
1454,10,0,14,11,59676000,3638,40494720,2466,19062
1455,7,0,11,14,59732520,3639,40494720,2465,19069
1456,12,0,12,13,59778540,3640,40494720,2464,19081
1457,7,0,14,11,59794440,3640,40494720,2463,19088
1458,6,0,11,14,59843280,3640,40494720,2462,19094
1459,4,0,8,17,59872980,3641,40494720,2461,19098
1460,10,0,12,13,59905740,3641,40494720,2460,19108
1461,7,0,11,14,59931360,3641,40494720,2458,19115
1462,4,0,6,19,59957460,3641,40494720,2458,19119
1463,6,0,7,18,59981880,3641,40494720,2457,19125
1464,7,0,8,17,59992080,3640,40494720,2456,19132
1465,8,0,10,15,60007080,3640,40494720,2455,19140
1466,2,0,7,18,60022080,3640,40494720,2454,19142
1467,5,0,9,16,60045240,3641,40494720,2454,19147
1468,6,0,11,14,60060960,3641,40494720,2453,19153
1469,7,0,10,15,60091440,3641,40494720,2452,19160
1470,10,0,12,13,60121200,3641,40494720,2450,19170
1471,5,0,8,17,60146280,3640,40494720,2450,19175
1472,9,0,10,15,60163560,3640,40494720,2448,19184
1473,14,0,12,13,60190140,3639,40494720,2446,19198
1474,10,0,11,14,60219300,3638,40494720,2445,19208
1475,12,0,13,12,60242160,3637,40494720,2443,19220
1476,16,0,21,4,60268620,3637,40494720,2441,19236
1477,8,0,11,14,60334500,3637,40494720,2439,19244
1478,15,0,16,9,60379020,3638,40494720,2437,19259
1479,9,0,17,8,60398640,3637,40494720,2436,19268
1480,11,0,12,13,60469080,3638,40494720,2434,19279
1481,9,0,14,11,60496320,3638,40494720,2433,19288
1482,6,0,9,16,60543240,3638,40494720,2432,19294
1483,12,0,10,15,60576120,3638,40494720,2430,19306
1484,4,0,8,17,60602700,3638,40494720,2430,19310
1485,6,0,10,15,60621780,3638,40494720,2429,19316
1486,3,0,9,16,60641460,3639,40494720,2428,19319
1487,2,0,7,18,60659520,3639,40494720,2428,19321
1488,8,0,10,15,60689940,3640,40494720,2427,19329
1489,6,0,12,13,60695700,3639,40494720,2426,19335
1490,9,0,14,11,60723720,3639,40494720,2425,19344
1491,5,0,8,17,60763560,3639,40494720,2424,19349
1492,3,0,9,16,60779340,3640,40494720,2424,19352
1493,8,0,11,14,60806820,3640,40494720,2422,19360
1494,7,0,7,18,60835380,3640,40494720,2421,19367
1495,2,0,6,19,60855960,3640,40494720,2421,19369
1496,6,0,11,14,60862980,3640,40494720,2420,19375
1497,10,0,11,14,60891480,3640,40494720,2419,19385
1498,10,0,8,17,60929520,3639,40494720,2417,19395
1499,5,0,10,15,60945660,3640,40494720,2417,19400
1500,3,0,10,15,60957300,3640,40494720,2416,19403
1501,11,0,11,14,60996960,3640,40494720,2415,19414
1502,8,0,11,14,61014180,3639,40494720,2413,19422
1503,6,0,7,18,61044060,3639,40494720,2413,19428
1504,12,0,10,15,61058580,3638,40494720,2411,19440
1505,5,0,8,17,61075500,3637,40494720,2410,19445
1506,9,0,13,12,61087980,3637,40494720,2409,19454
1507,11,0,12,13,61141800,3638,40494720,2407,19465
1508,6,0,9,16,61176480,3638,40494720,2406,19471
1509,15,0,17,8,61195380,3637,40494720,2404,19486
1510,6,0,9,16,61245600,3637,40494720,2403,19492
1511,7,0,9,16,61264020,3637,40494720,2402,19499
1512,6,0,8,17,61292340,3637,40494720,2402,19505
1513,5,0,8,17,61314120,3637,40494720,2401,19510
1514,7,0,10,15,61325760,3637,40494720,2400,19517
1515,5,0,12,13,61346940,3637,40494720,2399,19522
1516,4,0,8,17,61386300,3638,40494720,2399,19526
1517,6,0,11,14,61395720,3638,40494720,2398,19532
1518,5,0,11,14,61410000,3638,40494720,2397,19537
1519,10,0,10,15,61461240,3638,40494720,2396,19547
1520,7,0,11,14,61483920,3638,40494720,2395,19554
1521,11,0,14,11,61502700,3638,40494720,2393,19565
1522,5,0,9,16,61549740,3638,40494720,2392,19570
1523,12,0,13,12,61571940,3638,40494720,2391,19582
1524,19,1,22,3,61587900,3637,40495680,2388,19601
1525,13,0,22,3,61638780,3637,40499940,2386,19614
1526,11,0,15,10,61719300,3638,40499940,2385,19625
1527,11,0,15,10,61770120,3639,40499940,2383,19636
1528,9,0,11,14,61815300,3638,40499940,2382,19645
1529,6,0,7,18,61858620,3639,40499940,2381,19651
1530,6,0,8,17,61876140,3639,40499940,2380,19657
1531,6,0,8,17,61890000,3638,40499940,2380,19663
1532,7,0,11,14,61899900,3638,40499940,2379,19670
1533,7,0,14,11,61919340,3638,40499940,2378,19677
1534,7,0,12,13,61952880,3638,40499940,2377,19684
1535,6,0,8,17,61996980,3639,40499940,2376,19690
1536,5,0,9,16,62008560,3639,40499940,2375,19695
1537,6,0,10,15,62027340,3639,40499940,2374,19701
1538,2,0,6,19,62044380,3638,40499940,2374,19703
1539,3,0,6,19,62052420,3638,40499940,2374,19706
1540,4,0,9,16,62058540,3638,40499940,2373,19710
1541,4,0,9,16,62073600,3638,40499940,2372,19714
1542,7,0,10,15,62099940,3639,40499940,2372,19721
1543,8,0,8,17,62130960,3638,40499940,2370,19729
1544,8,0,12,13,62146620,3638,40499940,2369,19737
1545,14,0,14,11,62172720,3637,40499940,2367,19751
1546,6,0,11,14,62214420,3638,40499940,2367,19757
1547,6,0,10,15,62248860,3639,40499940,2366,19763
1548,12,0,16,9,62271960,3639,40499940,2364,19775
1549,11,0,17,8,62305800,3638,40499940,2363,19786
1550,15,0,20,5,62357280,3639,40499940,2360,19801
1551,9,0,16,9,62411580,3639,40499940,2359,19810
1552,7,0,13,12,62460480,3640,40499940,2358,19817
1553,13,0,16,9,62506140,3641,40499940,2356,19830
1554,13,0,19,6,62539380,3640,40499940,2355,19843
1555,10,0,16,9,62605380,3641,40499940,2353,19853
1556,7,0,13,12,62647440,3642,40499940,2352,19860
1557,12,0,14,11,62694720,3642,40499940,2351,19872
1558,6,0,10,15,62728380,3642,40499940,2350,19878
1559,9,0,12,13,62761380,3642,40499940,2349,19887
1560,6,0,8,17,62793360,3642,40499940,2348,19893
1561,2,0,4,21,62822700,3643,40499940,2348,19895
1562,8,0,10,15,62831460,3643,40499940,2347,19903
1563,4,0,10,15,62840460,3642,40499940,2346,19907
1564,8,0,5,20,62878440,3642,40499940,2345,19915
1565,5,0,7,18,62882700,3641,40499940,2344,19920
1566,9,0,11,14,62897820,3641,40499940,2343,19929
1567,11,0,16,9,62917380,3641,40499940,2341,19940
1568,7,0,10,15,62973360,3642,40499940,2341,19947
1569,9,0,15,10,62990580,3642,40499940,2339,19956
1570,15,0,16,9,63027960,3641,40499940,2337,19971
1571,13,0,17,8,63065880,3641,40499940,2336,19984
1572,11,0,13,12,63128880,3641,40499940,2334,19995
1573,12,0,12,13,63165900,3641,40499940,2332,20007
1574,6,0,5,20,63220680,3641,40499940,2332,20013
1575,11,0,12,13,63231900,3641,40499940,2330,20024
1576,1,0,7,18,63251820,3641,40499940,2330,20025
1577,12,0,16,9,63269160,3641,40499940,2328,20037
1578,3,0,9,16,63304500,3641,40499940,2328,20040
1579,2,0,5,20,63337320,3642,40499940,2328,20042
1580,4,0,7,18,63348120,3642,40499940,2327,20046
1581,6,0,9,16,63356820,3642,40499940,2326,20052
1582,7,0,11,14,63371880,3641,40499940,2325,20059
1583,7,0,8,17,63405060,3641,40499940,2325,20066
1584,4,0,9,16,63418440,3641,40499940,2324,20070
1585,3,0,6,19,63440340,3641,40499940,2324,20073
1586,3,0,7,18,63442020,3641,40499940,2323,20076
1587,3,0,7,18,63455520,3641,40499940,2323,20079
1588,1,0,6,19,63469560,3642,40499940,2323,20080
1589,14,0,17,8,63477420,3641,40499940,2321,20094
1590,7,0,11,14,63509940,3640,40499940,2320,20101
1591,8,0,9,16,63549180,3641,40499940,2319,20109
1592,13,0,15,10,63573840,3641,40499940,2317,20122
1593,14,0,18,7,63605580,3640,40499940,2315,20136
1594,5,0,11,14,63656580,3641,40499940,2315,20141
1595,9,0,10,15,63688620,3640,40499940,2313,20150
1596,13,0,15,10,63709740,3640,40499940,2312,20163
1597,7,0,12,13,63747720,3640,40499940,2311,20170
1598,16,0,16,9,63782040,3639,40499940,2309,20186
1599,11,0,18,7,63823080,3640,40499940,2307,20197
1600,10,0,13,12,63885240,3640,40499940,2306,20207
1601,7,0,11,14,63922980,3641,40499940,2305,20214
1602,10,0,14,11,63947940,3641,40499940,2304,20224
1603,6,0,8,17,63984300,3640,40499940,2303,20230
1604,6,0,9,16,64000260,3640,40499940,2302,20236
1605,8,0,12,13,64019880,3640,40499940,2301,20244
1606,4,0,7,18,64056600,3640,40499940,2301,20248
1607,7,0,6,19,64078320,3640,40499940,2300,20255
1608,5,0,7,18,64084560,3639,40499940,2299,20260
1609,3,0,8,17,64093980,3640,40499940,2299,20263
1610,6,0,8,17,64108980,3639,40499940,2298,20269
1611,6,0,9,16,64134120,3640,40499940,2297,20275
1612,4,0,10,15,64151220,3640,40499940,2296,20279
1613,8,0,12,13,64171920,3640,40499940,2295,20287
1614,9,0,10,15,64211340,3640,40499940,2294,20296
1615,8,0,10,15,64233540,3639,40499940,2293,20304
1616,6,0,11,14,64259460,3640,40499940,2292,20310
1617,10,0,15,10,64278180,3640,40499940,2291,20320
1618,9,0,16,9,64326480,3641,40499940,2290,20329
1619,14,0,16,9,64382940,3641,40499940,2288,20343
1620,13,0,14,11,64427220,3640,40499940,2286,20356
1621,9,0,11,14,64469280,3640,40499940,2285,20365
1622,15,0,16,9,64489560,3639,40499940,2283,20380
1623,4,0,12,13,64519560,3640,40499940,2283,20384
1624,13,0,15,10,64572720,3640,40499940,2281,20397
1625,12,0,15,10,64617300,3641,40499940,2280,20409
1626,11,0,15,10,64649460,3640,40499940,2278,20420
1627,11,0,10,15,64701840,3640,40499940,2277,20431
1628,6,0,7,18,64729920,3639,40499940,2276,20437
1629,8,0,9,16,64747380,3639,40499940,2275,20445
1630,6,0,10,15,64758600,3639,40499940,2274,20451
1631,3,0,6,19,64787280,3639,40499940,2274,20454
1632,2,0,8,17,64787280,3639,40499940,2274,20456
1633,11,0,14,11,64802100,3639,40499940,2272,20467
1634,3,0,11,14,64833840,3639,40499940,2272,20470
1635,1,0,7,18,64867740,3640,40499940,2272,20471
1636,10,0,10,15,64893300,3640,40499940,2270,20481
1637,8,0,10,15,64913040,3640,40499940,2269,20489
1638,2,0,8,17,64928580,3640,40499940,2269,20491
1639,4,0,6,19,64954860,3640,40499940,2269,20495
1640,6,0,7,18,64963560,3640,40499940,2268,20501
1641,11,0,9,16,64981320,3639,40499940,2266,20512
1642,10,0,11,14,65006340,3638,40499940,2265,20522
1643,4,0,8,17,65031900,3638,40499940,2265,20526
1644,17,0,16,9,65050140,3638,40499940,2263,20543
1645,6,0,13,12,65093880,3638,40499940,2262,20549
1646,13,0,13,12,65145480,3639,40499940,2260,20562
1647,7,0,12,13,65174640,3639,40499940,2259,20569
1648,13,0,12,13,65209560,3638,40499940,2258,20582
1649,6,0,11,14,65231400,3638,40499940,2257,20588
1650,12,0,12,13,65262600,3637,40499940,2255,20600
1651,13,0,20,5,65284500,3637,40499940,2254,20613
1652,6,0,11,14,65336220,3637,40499940,2253,20619
1653,7,0,11,14,65376900,3638,40499940,2252,20626
1654,6,0,13,12,65402580,3639,40499940,2251,20632
1655,7,0,10,15,65450280,3639,40499940,2250,20639
1656,2,0,8,17,65473560,3640,40499940,2250,20641
1657,3,0,5,20,65497200,3640,40499940,2250,20644
1658,4,0,5,20,65506620,3640,40499940,2249,20648
1659,6,0,8,17,65513460,3639,40499940,2249,20654
1660,4,0,8,17,65523840,3639,40499940,2248,20658
1661,8,0,11,14,65542320,3639,40499940,2247,20666
1662,3,0,8,17,65565720,3639,40499940,2247,20669
1663,10,0,11,14,65591940,3639,40499940,2246,20679
1664,10,0,15,10,65615040,3639,40499940,2244,20689
1665,7,0,10,15,65661960,3640,40499940,2243,20696
1666,12,0,11,14,65697780,3639,40499940,2242,20708
1667,19,0,18,7,65730420,3639,40499940,2240,20727
1668,14,0,17,8,65762520,3637,40499940,2238,20741
1669,12,0,18,7,65807520,3638,40499940,2236,20753
1670,8,0,13,12,65860980,3638,40499940,2235,20761
1671,6,0,12,13,65888160,3638,40499940,2235,20767
1672,14,0,15,10,65938380,3639,40499940,2233,20781
1673,13,0,18,7,65963520,3638,40499940,2231,20794
1674,5,0,11,14,66004440,3638,40499940,2231,20799
1675,6,0,10,15,66029460,3638,40499940,2230,20805
1676,7,0,12,13,66057720,3638,40499940,2229,20812
1677,4,0,9,16,66082080,3638,40499940,2229,20816
1678,7,0,9,16,66114000,3639,40499940,2228,20823
1679,4,0,8,17,66139140,3639,40499940,2227,20827
1680,8,0,10,15,66154380,3639,40499940,2226,20835
1681,4,0,8,17,66182040,3639,40499940,2226,20839
1682,12,0,15,10,66197280,3639,40499940,2224,20851
1683,23,4,18,7,66238980,3638,40500600,2222,20874
1684,22,2,25,0,66283560,3637,40506540,2219,20896
1685,36,11,25,0,66380700,3637,40513620,2215,20932
1686,33,33,25,0,66432600,3638,40521840,2212,20965
1687,33,38,25,0,66517740,3639,40558860,2211,20998
1688,33,37,25,0,66625980,3640,40613160,2211,21031
1689,25,37,25,0,66693420,3640,40663080,2212,21056
1690,28,38,25,0,66767520,3639,40730460,2213,21084
1691,28,40,25,0,66844680,3639,40751400,2211,21112
1692,34,39,24,1,66917160,3639,40787220,2210,21146
1693,42,37,25,0,67012740,3640,40825860,2210,21188
1694,30,39,17,8,67075800,3640,40834500,2209,21218
1695,36,40,24,1,67120680,3640,40905780,2211,21254
1696,25,36,25,0,67203480,3640,41135280,2220,21279
1697,31,37,25,0,67283220,3641,41153820,2219,21310
1698,29,39,25,0,67333620,3641,41184360,2219,21339
1699,30,40,25,0,67442460,3641,41238600,2219,21369
1700,21,40,25,0,67494180,3642,41280120,2220,21390
1701,34,40,25,0,67582020,3643,41286840,2218,21424
1702,21,31,25,0,67670580,3642,41579520,2231,21445
1703,31,37,25,0,67746420,3642,41587380,2228,21476
1704,44,40,25,0,67814940,3643,41624760,2228,21520
1705,33,38,25,0,67902240,3643,41668500,2228,21553
1706,35,38,25,0,67977900,3644,41688180,2227,21588
1707,30,40,25,0,68049600,3644,41773080,2229,21618
1708,25,37,25,0,68130180,3644,41814780,2229,21643
1709,27,36,25,0,68233260,3645,41929200,2233,21670
1710,32,37,25,0,68296440,3643,42011700,2234,21702
1711,28,38,18,7,68365980,3644,42019080,2233,21730
1712,36,38,20,5,68417280,3645,42059760,2234,21766
1713,33,37,25,0,68497140,3644,42215400,2238,21799
1714,23,28,25,0,68564700,3641,42818760,2268,21822
1715,35,40,20,5,68622960,3641,43120740,2281,21857
1716,28,39,23,2,68711700,3643,43137840,2279,21885
1717,33,40,25,0,68778120,3643,43181640,2279,21918
1718,36,36,25,0,68862240,3641,43344720,2284,21954
1719,31,40,25,0,68939340,3641,43360560,2282,21985
1720,32,40,25,0,69005280,3642,43377120,2282,22017
1721,26,31,25,0,69095760,3641,43527780,2287,22043
1722,34,37,25,0,69179880,3640,43924320,2304,22077
1723,33,40,25,0,69237240,3640,43934520,2302,22110
1724,27,36,25,0,69334680,3640,44114880,2308,22137
1725,25,32,25,0,69415440,3638,44171340,2308,22162
1726,32,40,14,11,69468240,3638,44172060,2307,22194
1727,24,38,22,3,69522420,3640,44211720,2307,22218
1728,26,39,23,2,69601260,3640,44222220,2305,22244
1729,36,40,25,0,69669960,3641,44284680,2306,22280
1730,35,36,25,0,69763560,3641,44377560,2309,22315
1731,41,37,25,0,69832860,3641,44433000,2309,22356
1732,33,38,25,0,69904260,3639,44528160,2311,22389
1733,36,39,25,0,69995760,3640,44537700,2308,22425
1734,32,39,25,0,70058160,3640,44554320,2307,22457
1735,29,33,25,0,70155120,3639,44762280,2315,22486
1736,25,24,25,0,70224540,3637,45865080,2369,22511
1737,24,25,25,0,70315740,3637,46476060,2398,22535
1738,32,40,23,2,70358160,3637,46484700,2395,22567
1739,29,38,25,0,70437900,3638,46513320,2395,22596
1740,33,40,17,8,70511640,3639,46522860,2394,22629
1741,23,36,25,0,70559880,3640,46570680,2395,22652
1742,35,40,21,4,70618440,3640,46770840,2403,22687
1743,33,37,25,0,70711680,3641,46841640,2404,22720
1744,26,38,25,0,70762140,3641,46900020,2405,22746
1745,30,39,16,9,70826820,3640,46921140,2405,22776
1746,32,38,25,0,70890960,3641,46981440,2405,22808
1747,30,40,25,0,70971960,3641,47010600,2404,22838
1748,31,36,25,0,71059800,3642,47146620,2409,22869
1749,28,40,18,7,71101980,3640,47332620,2416,22897
1750,35,36,25,0,71178120,3642,47354880,2415,22932
1751,22,39,25,0,71235060,3642,47377260,2414,22954
1752,36,39,25,0,71323920,3642,47511300,2418,22990
1753,29,40,16,9,71384100,3642,47551620,2419,23019
1754,31,38,25,0,71450220,3643,47571300,2417,23050
1755,25,39,25,0,71501760,3643,47664120,2421,23075
1756,36,40,19,6,71579820,3643,47724780,2421,23111
1757,34,38,25,0,71661540,3644,47794500,2423,23145
1758,25,32,25,0,71751840,3643,48166560,2439,23170
1759,36,40,25,0,71815320,3643,48196740,2437,23206
1760,34,38,25,0,71904300,3644,48240360,2437,23240
1761,21,36,25,0,71973420,3643,48281040,2436,23261
1762,33,37,25,0,72044940,3644,48304080,2435,23294
1763,34,38,25,0,72132840,3642,48430560,2438,23328
1764,31,39,25,0,72216600,3642,48462420,2436,23359
1765,31,37,25,0,72277080,3641,48504360,2436,23390
1766,25,38,25,0,72364260,3641,48533520,2434,23415
1767,36,40,25,0,72424380,3641,48555060,2434,23451
1768,33,40,25,0,72494040,3641,48602760,2433,23484
1769,31,39,22,3,72586920,3640,48988740,2449,23515
1770,37,40,25,0,72649020,3641,49007100,2448,23552
1771,30,40,25,0,72704220,3642,49024380,2448,23582
1772,27,40,23,2,72793200,3642,49454940,2466,23609
1773,17,36,21,4,72873120,3643,49486140,2467,23626
1774,33,38,25,0,72956700,3643,49559820,2467,23659
1775,34,38,25,0,73003860,3642,49572960,2465,23693
1776,33,40,18,7,73095120,3644,49581540,2464,23726
1777,38,36,25,0,73155360,3645,49661880,2467,23764
1778,29,40,25,0,73217520,3644,49766400,2469,23793
1779,32,40,25,0,73290900,3645,49777920,2467,23825
1780,34,40,23,2,73350060,3645,49811340,2467,23859
1781,31,37,25,0,73465560,3646,49914900,2469,23890
1782,41,40,18,7,73532700,3646,49917300,2468,23931
1783,34,38,23,2,73594680,3646,49951260,2467,23965
1784,28,36,23,2,73659420,3646,50076780,2471,23993
1785,28,40,25,0,73720080,3646,50133660,2472,24021
1786,27,33,23,2,73800240,3647,50182860,2473,24048
1787,36,40,22,3,73863000,3647,50243940,2473,24084
1788,32,39,22,3,73923660,3646,50338740,2476,24116
1789,36,38,24,1,74006880,3647,50364600,2474,24152
1790,33,38,25,0,74094120,3647,50403120,2474,24185
1791,29,40,14,11,74145660,3648,50403540,2473,24214
1792,34,30,25,0,74217960,3648,50808420,2491,24248
1793,34,40,13,12,74264340,3647,51542580,2524,24282
1794,29,40,25,0,74317620,3648,51582060,2524,24311
1795,23,30,25,0,74398680,3646,52054320,2544,24334
1796,27,39,22,3,74455260,3646,52064400,2542,24361
1797,32,39,25,0,74526840,3647,52094280,2542,24393
1798,32,40,25,0,74617380,3647,52133760,2540,24425
1799,30,40,13,12,74683620,3647,52184220,2542,24455
1800,30,39,15,10,74726760,3648,52202820,2541,24485
1801,30,31,18,7,74778960,3644,53949780,2623,24515
1802,42,40,25,0,74849520,3645,53965380,2620,24557
1803,34,40,25,0,74898420,3645,53991600,2620,24591
1804,26,35,25,0,74994540,3645,54504060,2641,24617
1805,32,40,25,0,75077460,3645,54536940,2640,24649
1806,25,39,25,0,75153660,3646,54549780,2638,24674
1807,33,36,20,5,75250020,3648,54568260,2638,24707
1808,23,38,14,11,75294900,3648,54573780,2637,24730
1809,30,40,17,8,75332820,3648,54640860,2639,24760
1810,36,40,21,4,75395640,3649,54662520,2637,24796
1811,31,31,25,0,75483060,3649,55017600,2652,24827
1812,25,23,24,1,75544320,3646,56602140,2726,24852
1813,34,40,24,1,75610380,3647,56610840,2722,24886
1814,27,40,25,0,75687120,3648,56629140,2721,24913
1815,32,40,25,0,75778380,3649,56683260,2721,24945
1816,35,40,25,0,75858900,3648,57060600,2736,24980
1817,35,40,14,11,75899100,3648,57063540,2736,25015
1818,28,36,25,0,75967080,3649,57132000,2736,25043
1819,29,40,25,0,76043460,3648,57275640,2739,25072
1820,35,39,21,4,76124700,3648,57313380,2738,25107
1821,29,40,25,0,76170540,3648,57339540,2738,25136
1822,31,40,19,6,76282860,3648,57484500,2742,25167
1823,35,40,16,9,76319100,3648,57491700,2741,25202
1824,25,34,25,0,76382460,3648,57565020,2742,25227
1825,32,38,23,2,76454100,3648,57691680,2744,25259
1826,28,40,25,0,76528680,3648,57708900,2743,25287
1827,31,37,25,0,76609560,3649,57953460,2752,25318
1828,32,40,21,4,76670940,3649,57963960,2751,25350
1829,39,40,24,1,76734540,3649,58053060,2753,25389
1830,32,39,22,3,76789620,3649,58060920,2751,25421
1831,28,39,24,1,76860120,3649,58157460,2753,25449
1832,28,40,15,10,76922100,3650,58162740,2753,25477
1833,35,40,16,9,76975560,3650,58234080,2754,25512
1834,33,38,19,6,77019780,3651,58285500,2755,25545
1835,28,32,25,0,77084640,3650,58820820,2778,25573
1836,19,27,20,5,77148600,3648,59586180,2812,25592
1837,28,40,13,12,77205060,3649,59590620,2810,25620
1838,22,40,11,14,77244960,3650,59605380,2810,25642
1839,35,39,13,12,77274120,3651,59635860,2811,25677
1840,22,40,25,0,77313780,3652,59727840,2813,25699
1841,30,40,14,11,77387280,3653,59735640,2812,25729
1842,30,38,22,3,77436480,3654,59784900,2813,25759
1843,15,34,25,0,77493060,3653,60017220,2822,25774
1844,27,26,25,0,77590860,3652,60584820,2845,25801
1845,41,39,25,0,77650860,3652,60593040,2841,25842
1846,33,40,25,0,77724060,3652,60611220,2840,25875
1847,19,28,25,0,77820120,3652,60964980,2854,25894
1848,12,0,14,11,77914860,3648,62359260,2918,25906
1849,3,0,8,17,77950260,3648,62359260,2917,25909
1850,6,0,8,17,77980920,3648,62359260,2916,25915
1851,3,0,6,19,77996760,3648,62359260,2916,25918
1852,6,0,8,17,78009180,3648,62359260,2915,25924
1853,6,0,9,16,78019800,3648,62359260,2914,25930
1854,6,0,9,16,78041100,3648,62359260,2913,25936
1855,7,0,10,15,78061920,3648,62359260,2913,25943
1856,6,0,7,18,78083520,3647,62359260,2912,25949
1857,14,0,14,11,78096060,3647,62359260,2910,25963
1858,15,0,16,9,78131580,3646,62359260,2908,25978
1859,15,0,16,9,78180720,3646,62360040,2906,25993
1860,6,0,11,14,78231720,3646,62360040,2905,25999
1861,9,0,11,14,78269280,3647,62360040,2904,26008
1862,13,0,13,12,78304620,3646,62360040,2902,26021
1863,15,0,18,7,78338940,3646,62360040,2900,26036
1864,10,0,15,10,78387900,3646,62360040,2899,26046
1865,7,0,10,15,78425400,3646,62360040,2898,26053
1866,4,0,8,17,78457080,3646,62360040,2897,26057
1867,10,0,12,13,78479700,3646,62360040,2896,26067
1868,7,0,14,11,78504960,3647,62360040,2895,26074
1869,6,0,12,13,78528120,3647,62360040,2894,26080
1870,14,0,16,9,78567060,3647,62360040,2892,26094
1871,4,0,10,15,78606660,3647,62360040,2892,26098
1872,10,0,9,16,78637980,3646,62360040,2890,26108
1873,6,0,8,17,78657780,3646,62360040,2889,26114
1874,8,0,9,16,78689340,3646,62360040,2888,26122
1875,7,0,7,18,78714840,3646,62360040,2887,26129
1876,7,0,5,20,78735540,3646,62360040,2887,26136
1877,8,0,8,17,78742920,3645,62360040,2885,26144
1878,8,0,9,16,78760560,3645,62360040,2884,26152
1879,5,0,8,17,78784500,3645,62360040,2884,26157
1880,9,0,13,12,78799620,3645,62360040,2883,26166
1881,8,0,13,12,78833280,3645,62360040,2881,26174
1882,7,0,9,16,78869040,3645,62360040,2881,26181
1883,8,0,8,17,78910920,3645,62360040,2879,26189
1884,10,0,13,12,78923280,3645,62360040,2878,26199
1885,10,0,14,11,78951660,3645,62360040,2877,26209
1886,11,0,15,10,78991860,3645,62360040,2875,26220
1887,13,0,14,11,79039620,3645,62360040,2874,26233
1888,12,0,15,10,79073340,3644,62360040,2872,26245
1889,11,0,14,11,79110420,3644,62360040,2871,26256
1890,4,0,13,12,79122600,3644,62360040,2870,26260
1891,9,0,13,12,79168920,3644,62360040,2869,26269
1892,11,0,14,11,79209900,3645,62360040,2867,26280
1893,6,0,8,17,79235400,3644,62360040,2867,26286
1894,3,0,7,18,79254660,3644,62360040,2866,26289
1895,3,0,7,18,79261740,3644,62360040,2866,26292
1896,3,0,7,18,79276620,3644,62360040,2865,26295
1897,10,0,9,16,79306740,3644,62360040,2864,26305
1898,3,0,7,18,79321380,3644,62360040,2864,26308
1899,3,0,6,19,79340760,3644,62360040,2863,26311
1900,8,0,10,15,79348680,3644,62360040,2862,26319
1901,7,0,8,17,79370340,3643,62360040,2861,26326
1902,2,0,6,19,79389420,3644,62360040,2861,26328
1903,5,0,8,17,79399140,3644,62360040,2860,26333
1904,9,0,10,15,79422960,3643,62360040,2859,26342
1905,8,0,13,12,79441440,3643,62360040,2858,26350
1906,10,0,14,11,79472160,3643,62360040,2857,26360
1907,9,0,12,13,79518840,3644,62360040,2856,26369
1908,9,0,11,14,79547340,3643,62360040,2855,26378
1909,15,0,12,13,79591020,3643,62360040,2853,26393
1910,14,0,11,14,79617840,3642,62360040,2851,26407
1911,12,0,16,9,79642260,3642,62360040,2849,26419
1912,10,0,13,12,79683060,3641,62360040,2848,26429
1913,8,0,12,13,79718520,3641,62360040,2847,26437
1914,7,0,11,14,79742400,3641,62360040,2846,26444
1915,5,0,9,16,79774080,3641,62360040,2845,26449
1916,8,0,11,14,79801800,3642,62360040,2844,26457
1917,7,0,8,17,79823520,3641,62360040,2843,26464
1918,9,0,9,16,79850760,3641,62360040,2842,26473
1919,4,0,9,16,79862640,3641,62360040,2842,26477
1920,5,0,8,17,79881720,3641,62360040,2841,26482
1921,5,0,8,17,79906680,3641,62360040,2840,26487
1922,6,0,9,16,79930260,3641,62360040,2840,26493
1923,2,0,7,18,79945920,3641,62360040,2839,26495
1924,7,0,7,18,79966560,3641,62360040,2838,26502
1925,11,0,7,18,79993440,3641,62360040,2837,26513
1926,10,0,12,13,80002620,3640,62360040,2836,26523
1927,5,0,9,16,80022900,3640,62360040,2835,26528
1928,7,0,11,14,80047860,3640,62360040,2834,26535
1929,7,0,11,14,80076240,3640,62360040,2833,26542
1930,11,0,14,11,80110200,3640,62360040,2832,26553
1931,12,0,21,4,80126280,3640,62360040,2830,26565
1932,8,0,13,12,80207700,3641,62360040,2829,26573
1933,16,0,14,11,80250120,3641,62360040,2827,26589
1934,16,0,18,7,80279520,3640,62360040,2825,26605
1935,14,0,17,8,80324880,3640,62360040,2823,26619
1936,9,0,11,14,80385960,3640,62360040,2822,26628
1937,11,0,12,13,80415360,3640,62360040,2821,26639
1938,5,0,12,13,80436480,3640,62360040,2820,26644
1939,11,0,9,16,80485800,3640,62360040,2819,26655
1940,6,0,11,14,80493540,3639,62360040,2818,26661
1941,8,0,11,14,80525220,3640,62360040,2817,26669
1942,9,0,9,16,80552400,3639,62360040,2816,26678
1943,7,0,12,13,80561520,3639,62360040,2815,26685
1944,5,0,13,12,80573400,3639,62360040,2814,26690
1945,4,0,7,18,80628900,3639,62360040,2814,26694
1946,7,0,8,17,80655660,3640,62360040,2813,26701
1947,7,0,10,15,80662500,3639,62360040,2812,26708
1948,4,0,7,18,80700300,3640,62360040,2812,26712
1949,7,0,8,17,80714040,3639,62360040,2811,26719
1950,7,0,11,14,80727660,3639,62360040,2810,26726
1951,10,0,10,15,80757420,3639,62360040,2809,26736
1952,12,0,13,12,80790780,3639,62360040,2807,26748
1953,12,0,15,10,80809680,3638,62360040,2805,26760
1954,11,0,12,13,80859660,3638,62360040,2804,26771
1955,12,0,15,10,80900940,3638,62360040,2803,26783
1956,10,0,12,13,80943180,3638,62360040,2801,26793
1957,8,0,9,16,80991060,3639,62360040,2800,26801
1958,8,0,12,13,81002340,3638,62360040,2799,26809
1959,14,0,16,9,81034920,3638,62360040,2798,26823
1960,15,0,17,8,81069780,3637,62360040,2796,26838
1961,12,0,14,11,81133380,3638,62360040,2794,26850
1962,9,0,12,13,81172860,3638,62360040,2793,26859
1963,5,0,11,14,81196560,3638,62360040,2792,26864
1964,9,0,11,14,81234180,3638,62360040,2791,26873
1965,6,0,9,16,81257220,3638,62360040,2791,26879
1966,5,0,6,19,81290040,3638,62360040,2790,26884
1967,7,0,9,16,81302760,3638,62360040,2789,26891
1968,3,0,7,18,81321540,3638,62360040,2789,26894
1969,3,0,6,19,81343620,3638,62360040,2788,26897
1970,5,0,8,17,81352080,3638,62360040,2788,26902
1971,7,0,11,14,81365100,3638,62360040,2787,26909
1972,6,0,7,18,81397860,3638,62360040,2786,26915
1973,10,0,11,14,81411180,3638,62360040,2785,26925
1974,6,0,11,14,81439800,3638,62360040,2784,26931
1975,3,0,7,18,81470100,3638,62360040,2784,26934
1976,11,0,14,11,81478200,3638,62360040,2782,26945
1977,10,0,14,11,81509700,3638,62360040,2781,26955
1978,7,0,13,12,81539280,3638,62360040,2780,26962
1979,8,0,10,15,81588780,3638,62360040,2779,26970
1980,10,0,10,15,81622680,3638,62360040,2778,26980
1981,11,0,9,16,81651360,3637,62360040,2777,26991
1982,11,0,13,12,81668400,3637,62360040,2775,27002
1983,12,0,14,11,81695700,3636,62360040,2774,27014
1984,10,0,13,12,81736020,3636,62360040,2773,27024
1985,6,0,11,14,81769800,3636,62360040,2772,27030
1986,6,0,9,16,81805020,3637,62360040,2771,27036
1987,11,0,13,12,81825060,3636,62360040,2770,27047
1988,6,0,14,11,81845820,3637,62360040,2769,27053
1989,7,0,12,13,81882840,3637,62360040,2768,27060
1990,4,0,9,16,81918360,3637,62360040,2768,27064
1991,3,0,4,21,81953280,3638,62360040,2767,27067
1992,6,0,8,17,81956100,3637,62360040,2767,27073
1993,6,0,8,17,81973020,3637,62360040,2766,27079
1994,8,0,10,15,81997800,3637,62360040,2765,27087
1995,3,0,6,19,82026540,3637,62360040,2764,27090
1996,8,0,9,16,82039440,3637,62360040,2763,27098
1997,6,0,5,20,82067580,3637,62360040,2763,27104
1998,3,0,7,18,82074780,3637,62360040,2762,27107
1999,6,0,9,16,82084980,3637,62360040,2762,27113
2000,8,0,10,15,82102080,3636,62360040,2761,27121
2001,9,0,12,13,82129860,3636,62360040,2760,27130
2002,7,0,7,18,82166640,3636,62360040,2759,27137
2003,8,0,12,13,82175400,3636,62360040,2758,27145
2004,16,0,15,10,82222740,3636,62360040,2756,27161
2005,10,0,13,12,82257060,3636,62360040,2755,27171
2006,9,0,14,11,82289400,3636,62360040,2753,27180
2007,12,0,18,7,82326420,3636,62360040,2752,27192
2008,12,0,17,8,82383660,3637,62360040,2751,27204
2009,14,0,13,12,82436460,3636,62360040,2749,27218
2010,8,0,14,11,82455660,3636,62360040,2748,27226
2011,9,0,12,13,82515720,3637,62360040,2747,27235
2012,8,0,13,12,82542660,3637,62360040,2746,27243
2013,5,0,6,19,82589220,3637,62360040,2745,27248
2014,6,0,11,14,82591740,3637,62360040,2744,27254
2015,6,0,5,20,82622820,3636,62360040,2744,27260
2016,4,0,7,18,82626720,3636,62360040,2743,27264
2017,7,0,12,13,82628640,3636,62360040,2742,27271
2018,8,0,15,10,82642440,3636,62360040,2741,27279
2019,6,0,13,12,82669440,3636,62360040,2741,27285
2020,2,0,10,15,82695660,3636,62360040,2740,27287
2021,5,0,11,14,82722060,3636,62360040,2740,27292
2022,2,0,8,17,82735140,3636,62360040,2740,27294
2023,3,0,9,16,82745520,3636,62360040,2739,27297
2024,7,0,12,13,82753080,3636,62360040,2738,27304
2025,16,0,19,6,82766220,3635,62360040,2737,27320
2026,8,0,16,9,82812180,3635,62360040,2736,27328
2027,14,0,19,6,82864620,3636,62360040,2734,27342
2028,6,0,14,11,82890420,3635,62360040,2733,27348
2029,9,0,17,8,82921860,3636,62360040,2732,27357
2030,18,2,25,0,82960860,3636,62360040,2730,27375
2031,10,0,19,6,83022540,3636,62362440,2729,27385
2032,11,0,18,7,83074860,3636,62362440,2728,27396
2033,8,0,14,11,83129880,3637,62362440,2727,27404
2034,10,0,13,12,83157360,3636,62362440,2725,27414
2035,12,0,16,9,83201340,3637,62362440,2724,27426
2036,13,0,14,11,83233260,3636,62362440,2722,27439
2037,6,0,13,12,83254560,3636,62362440,2722,27445
2038,6,0,15,10,83277180,3636,62362440,2721,27451
2039,3,0,9,16,83319120,3636,62362440,2721,27454
2040,4,0,10,15,83337540,3637,62362440,2720,27458
2041,3,0,10,15,83349120,3637,62362440,2720,27461
2042,5,0,10,15,83371020,3637,62362440,2719,27466
2043,6,0,13,12,83376360,3637,62362440,2718,27472
2044,2,0,9,16,83408460,3637,62362440,2718,27474
2045,8,0,12,13,83419560,3637,62362440,2717,27482
2046,8,0,14,11,83436180,3637,62362440,2716,27490
2047,4,0,13,12,83448000,3636,62362440,2716,27494
2048,11,0,18,7,83467200,3636,62362440,2715,27505
2049,4,0,10,15,83515560,3636,62362440,2714,27509
2050,10,0,16,9,83533260,3637,62362440,2713,27519
2051,9,0,13,12,83578560,3637,62362440,2712,27528
2052,9,0,14,11,83604480,3637,62362440,2711,27537
2053,7,0,14,11,83622360,3636,62362440,2710,27544
2054,9,0,10,15,83667960,3636,62362440,2709,27553
2055,10,0,13,12,83678880,3635,62362440,2708,27563
2056,18,0,17,8,83710860,3635,62362440,2706,27581
2057,9,0,16,9,83752320,3635,62362440,2705,27590
2058,6,0,14,11,83775180,3635,62362440,2704,27596
2059,6,0,14,11,83811720,3635,62362440,2703,27602
2060,10,0,15,10,83849100,3635,62362440,2702,27612
2061,4,0,11,14,83880240,3636,62362440,2702,27616
2062,7,0,12,13,83894040,3635,62362440,2701,27623
2063,6,0,11,14,83925960,3635,62362440,2700,27629
2064,5,0,10,15,83943180,3635,62362440,2699,27634
2065,4,0,10,15,83956980,3635,62362440,2699,27638
2066,3,0,8,17,83979420,3635,62362440,2699,27641
2067,2,0,7,18,83987640,3635,62362440,2698,27643
2068,8,0,13,12,83991600,3635,62362440,2697,27651
2069,7,0,13,12,84008580,3635,62362440,2697,27658
2070,7,0,15,10,84024360,3635,62362440,2696,27665
2071,10,0,14,11,84066120,3635,62362440,2695,27675
2072,9,0,16,9,84085980,3635,62362440,2694,27684
2073,8,0,17,8,84113280,3635,62362440,2693,27692
2074,11,0,20,5,84156780,3635,62362440,2691,27703
2075,13,0,12,13,84218160,3635,62362560,2690,27716
2076,12,0,14,11,84244740,3634,62362560,2688,27728
2077,15,0,18,7,84284700,3634,62362560,2687,27743
2078,9,0,20,5,84315900,3634,62362560,2686,27752
2079,10,0,17,8,84366720,3635,62362560,2685,27762
2080,12,0,20,5,84410940,3635,62362560,2683,27774
2081,5,0,14,11,84453300,3635,62362560,2683,27779
2082,15,0,18,7,84495000,3635,62362560,2681,27794
2083,6,0,16,9,84526380,3635,62362560,2680,27800
2084,8,0,16,9,84565680,3636,62362560,2679,27808
2085,2,0,11,14,84590280,3636,62362560,2679,27810
2086,4,0,10,15,84624960,3636,62362560,2679,27814
2087,6,0,16,9,84624960,3636,62362560,2678,27820
2088,4,0,12,13,84661380,3637,62362560,2677,27824
2089,6,0,11,14,84692100,3637,62362560,2677,27830
2090,7,0,13,12,84708420,3637,62362560,2676,27837
2091,3,0,11,14,84723120,3637,62362560,2676,27840
2092,5,0,14,11,84741480,3637,62362560,2675,27845
2093,3,0,9,16,84776820,3638,62362560,2675,27848
2094,6,0,10,15,84794820,3638,62362560,2674,27854
2095,5,0,8,17,84810600,3637,62362560,2673,27859
2096,10,0,15,10,84820200,3637,62362560,2672,27869
2097,9,0,16,9,84841080,3637,62362560,2671,27878
2098,9,0,14,11,84879180,3637,62362560,2670,27887
2099,17,0,19,6,84914040,3636,62362560,2668,27904
2100,13,0,21,4,84937560,3636,62362560,2667,27917
2101,11,0,17,8,84992880,3636,62362560,2665,27928
2102,8,0,19,6,85022820,3636,62362560,2665,27936
2103,9,0,14,11,85075560,3636,62362560,2664,27945
2104,6,0,9,16,85118520,3636,62362560,2663,27951
2105,6,0,10,15,85128960,3636,62362560,2662,27957
2106,6,0,11,14,85146540,3636,62362560,2661,27963
2107,11,0,15,10,85165980,3635,62362560,2660,27974
2108,3,0,10,15,85195560,3636,62362560,2660,27977
2109,6,0,13,12,85214580,3636,62362560,2659,27983
2110,7,0,13,12,85229760,3635,62362560,2658,27990
2111,3,0,8,17,85254540,3635,62362560,2658,27993
2112,5,0,11,14,85263480,3635,62362560,2658,27998
2113,5,0,10,15,85275360,3635,62362560,2657,28003
2114,5,0,10,15,85297620,3635,62362560,2656,28008
2115,3,0,10,15,85303920,3635,62362560,2656,28011
2116,8,0,16,9,85316220,3635,62362560,2655,28019
2117,7,0,14,11,85350240,3635,62362560,2654,28026
2118,3,0,12,13,85369500,3635,62362560,2654,28029
2119,13,0,19,6,85406880,3636,62362560,2653,28042
2120,4,0,12,13,85442820,3636,62362560,2652,28046
2121,12,0,19,6,85464720,3636,62362560,2651,28058
2122,8,0,17,8,85497300,3636,62362560,2650,28066
2123,10,0,17,8,85539060,3636,62362560,2649,28076
2124,12,0,18,7,85588620,3636,62362560,2647,28088
2125,8,0,13,12,85622040,3636,62362560,2646,28096
2126,11,0,19,6,85652580,3636,62362560,2645,28107
2127,4,0,12,13,85691160,3636,62362560,2645,28111
2128,10,0,15,10,85718520,3636,62362560,2644,28121
2129,6,0,14,11,85737540,3636,62362560,2643,28127
2130,11,0,19,6,85756500,3636,62362560,2642,28138
2131,4,0,11,14,85810680,3636,62362560,2641,28142
2132,2,0,9,16,85834200,3637,62362560,2641,28144
2133,8,0,11,14,85850100,3636,62362560,2640,28152
2134,4,0,11,14,85864200,3636,62362560,2640,28156
2135,5,0,10,15,85891680,3637,62362560,2639,28161
2136,3,0,8,17,85906800,3637,62362560,2639,28164
2137,2,0,8,17,85914540,3637,62362560,2639,28166
2138,4,0,10,15,85922340,3637,62362560,2638,28170
2139,6,0,12,13,85936740,3637,62362560,2638,28176
2140,9,0,16,9,85952040,3636,62362560,2637,28185
2141,4,0,11,14,85983900,3636,62362560,2636,28189
2142,5,0,14,11,85995180,3637,62362560,2636,28194
2143,11,0,20,5,86023980,3637,62362560,2634,28205
2144,11,0,19,6,86064360,3637,62362560,2633,28216
2145,10,0,18,7,86106960,3637,62362560,2632,28226
2146,9,0,14,11,86160780,3637,62362560,2631,28235
2147,18,0,23,2,86182320,3637,62362560,2629,28253
2148,9,0,18,7,86227980,3637,62362560,2628,28262
2149,12,0,17,8,86282220,3637,62362560,2627,28274
2150,7,0,12,13,86328540,3637,62362560,2626,28281
2151,10,0,16,9,86348940,3637,62362560,2625,28291
2152,8,0,15,10,86375940,3637,62362560,2624,28299
2153,4,0,14,11,86404260,3637,62362560,2623,28303
2154,7,0,16,9,86430900,3637,62362560,2623,28310
2155,11,0,17,8,86470680,3638,62362560,2621,28321
2156,7,0,10,15,86519040,3638,62362560,2621,28328
2157,4,0,10,15,86533860,3638,62362560,2620,28332
2158,9,0,14,11,86547000,3637,62362560,2619,28341
2159,5,0,11,14,86580480,3637,62362560,2619,28346
2160,3,0,10,15,86595660,3638,62362560,2618,28349
2161,9,0,13,12,86609280,3637,62362560,2617,28358
2162,7,0,14,11,86635260,3637,62362560,2617,28365
2163,3,0,12,13,86658120,3638,62362560,2616,28368
2164,8,0,14,11,86685540,3638,62362560,2615,28376
2165,14,0,23,2,86695200,3637,62362560,2614,28390
2166,5,0,13,12,86750400,3637,62362560,2613,28395
2167,3,0,9,16,86789760,3638,62362560,2613,28398
2168,6,0,14,11,86797440,3638,62362560,2612,28404
2169,9,0,15,10,86825220,3638,62362560,2611,28413
2170,9,0,19,6,86839980,3638,62362560,2610,28422
2171,10,0,13,12,86901360,3638,62362560,2609,28432
2172,7,0,13,12,86931000,3638,62362560,2608,28439
2173,10,0,19,6,86946240,3638,62362560,2607,28449
2174,14,1,22,3,86988060,3639,62363820,2606,28463
2175,15,0,24,1,87045120,3639,62365500,2604,28478
2176,7,0,16,9,87106140,3639,62365500,2604,28485
2177,9,0,17,8,87153240,3640,62365500,2603,28494
2178,8,0,14,11,87189180,3640,62365500,2602,28502
2179,7,0,14,11,87211440,3640,62365500,2601,28509
2180,9,0,12,13,87243540,3639,62365500,2600,28518
2181,3,0,13,12,87262860,3640,62365500,2600,28521
2182,10,0,13,12,87294120,3639,62365500,2599,28531
2183,11,0,13,12,87336000,3640,62365500,2597,28542
2184,9,0,18,7,87356400,3640,62365500,2596,28551
2185,5,0,14,11,87386880,3640,62365500,2596,28556
2186,5,0,11,14,87425460,3640,62365500,2595,28561
2187,3,0,10,15,87440400,3640,62365500,2595,28564
2188,4,0,9,16,87459000,3640,62365500,2595,28568
2189,9,0,10,15,87478560,3640,62365500,2594,28577
2190,3,0,9,16,87491100,3640,62365500,2593,28580
2191,5,0,14,11,87491100,3640,62365500,2593,28585
2192,10,0,15,10,87526860,3640,62365500,2592,28595
2193,12,0,20,5,87545940,3640,62365500,2590,28607
2194,9,0,15,10,87583620,3639,62365500,2589,28616
2195,11,0,17,8,87621300,3639,62365500,2588,28627
2196,10,0,16,9,87662100,3639,62365500,2587,28637
2197,10,0,14,11,87708120,3639,62365500,2586,28647
2198,10,0,12,13,87743160,3639,62365500,2585,28657
2199,13,0,13,12,87776820,3639,62365500,2584,28670
2200,7,0,14,11,87790320,3638,62365500,2583,28677
2201,6,0,16,9,87808740,3638,62365500,2582,28683
2202,8,0,14,11,87850200,3639,62365500,2581,28691
2203,7,0,14,11,87874560,3638,62365500,2581,28698
2204,6,0,12,13,87903660,3638,62365500,2580,28704
2205,10,0,14,11,87937860,3639,62365500,2579,28714
2206,6,0,12,13,87961260,3638,62365500,2578,28720
2207,2,0,8,17,87993360,3639,62365500,2578,28722
2208,3,0,11,14,87993360,3639,62365500,2578,28725
2209,6,0,14,11,88007700,3639,62365500,2577,28731
2210,4,0,10,15,88042440,3639,62365500,2577,28735
2211,6,0,12,13,88065840,3640,62365500,2576,28741
2212,9,0,16,9,88079340,3639,62365500,2575,28750
2213,10,0,18,7,88103280,3639,62365500,2574,28760
2214,14,0,19,6,88150860,3639,62365500,2573,28774
2215,8,0,11,14,88207500,3639,62365500,2572,28782
2216,11,0,15,10,88222920,3639,62365500,2571,28793
2217,16,0,21,4,88253580,3639,62365500,2569,28809
2218,12,0,19,6,88300560,3638,62365500,2568,28821
2219,14,0,20,5,88340280,3638,62365500,2566,28835
2220,17,0,25,0,88384740,3638,62368620,2564,28852
2221,7,0,15,10,88459320,3639,62368800,2564,28859
2222,18,0,23,2,88497780,3639,62368800,2562,28877
2223,9,0,20,5,88546320,3639,62368800,2561,28886
2224,6,0,11,14,88612080,3639,62368800,2560,28892
2225,4,0,10,15,88635180,3640,62368800,2560,28896
2226,8,0,14,11,88641720,3639,62368800,2559,28904
2227,7,0,12,13,88666560,3639,62368800,2558,28911
2228,6,0,12,13,88690740,3639,62368800,2558,28917
2229,7,0,12,13,88715220,3639,62368800,2557,28924
2230,6,0,13,12,88733520,3639,62368800,2556,28930
2231,7,0,11,14,88762380,3639,62368800,2555,28937
2232,7,0,10,15,88783440,3638,62368800,2555,28944
2233,6,0,12,13,88790640,3638,62368800,2554,28950
2234,7,0,11,14,88814640,3638,62368800,2553,28957
2235,5,0,11,14,88834800,3638,62368800,2553,28962
2236,8,0,11,14,88859940,3638,62368800,2552,28970
2237,8,0,13,12,88878780,3638,62368800,2551,28978
2238,2,0,11,14,88895700,3638,62368800,2551,28980
2239,4,0,11,14,88920600,3638,62368800,2551,28984
2240,8,0,12,13,88941060,3638,62368800,2550,28992
2241,9,0,11,14,88967640,3638,62368800,2549,29001
2242,3,0,12,13,88972140,3638,62368800,2548,29004
2243,4,0,12,13,88987020,3638,62368800,2548,29008
2244,12,0,17,8,89014620,3638,62368800,2547,29020
2245,11,0,11,14,89042400,3636,62368800,2546,29031
2246,10,0,15,10,89067600,3636,62368800,2545,29041
2247,8,0,18,7,89090340,3637,62368800,2544,29049
2248,6,0,16,9,89132280,3637,62368800,2543,29055
2249,10,0,17,8,89167800,3637,62368800,2542,29065
2250,14,0,20,5,89209800,3637,62368800,2541,29079
2251,5,0,14,11,89254380,3637,62368800,2540,29084
2252,7,0,14,11,89278920,3637,62368800,2539,29091
2253,5,0,10,15,89322420,3638,62368800,2539,29096
2254,6,0,14,11,89327580,3638,62368800,2538,29102
2255,8,0,16,9,89357700,3638,62368800,2537,29110
2256,3,0,12,13,89388720,3638,62368800,2537,29113
2257,8,0,12,13,89411760,3638,62368800,2536,29121
2258,8,0,14,11,89435640,3638,62368800,2536,29129
2259,11,0,15,10,89469180,3638,62368800,2534,29140
2260,7,0,14,11,89501460,3638,62368800,2534,29147
2261,7,0,15,10,89528220,3638,62368800,2533,29154
2262,11,0,19,6,89552220,3638,62368800,2532,29165
2263,8,0,20,5,89576880,3638,62368800,2531,29173
2264,8,0,14,11,89639340,3639,62368800,2530,29181
2265,8,0,12,13,89689680,3639,62368800,2529,29189
2266,8,0,16,9,89697480,3639,62368800,2529,29197
2267,14,0,22,3,89711340,3638,62368800,2527,29211
2268,11,0,19,6,89782260,3639,62368800,2526,29222
2269,5,0,14,11,89829300,3640,62368800,2525,29227
2270,10,0,18,7,89857080,3640,62368800,2524,29237
2271,12,0,15,10,89913180,3640,62368800,2523,29249
2272,11,0,14,11,89944080,3639,62368800,2522,29260
2273,8,0,15,10,89962620,3639,62368800,2521,29268
2274,7,0,11,14,90004320,3639,62368800,2521,29275
2275,8,0,14,11,90022740,3639,62368800,2520,29283
2276,12,0,17,8,90055740,3639,62368800,2519,29295
2277,6,0,15,10,90086160,3639,62368800,2518,29301
2278,7,0,16,9,90110880,3639,62368800,2517,29308
2279,9,0,16,9,90137820,3639,62368800,2516,29317
2280,2,0,9,16,90178680,3640,62368800,2516,29319
2281,7,0,15,10,90184620,3640,62368800,2515,29326
2282,5,0,13,12,90218880,3640,62368800,2515,29331
2283,8,0,13,12,90249120,3640,62368800,2514,29339
2284,6,0,15,10,90270180,3640,62368800,2513,29345
2285,8,0,13,12,90310500,3640,62368800,2513,29353
2286,9,0,19,6,90313920,3640,62368800,2512,29362
2287,9,0,18,7,90361740,3641,62368800,2511,29371
2288,7,0,14,11,90401940,3641,62368800,2510,29378
2289,12,0,15,10,90444960,3641,62368800,2509,29390
2290,17,0,24,1,90467700,3640,62369280,2507,29407
2291,9,0,21,4,90519600,3641,62369280,2506,29416
2292,12,0,14,11,90603900,3641,62369280,2505,29428
2293,13,0,15,10,90636540,3641,62369280,2504,29441
2294,12,0,17,8,90651120,3640,62369280,2503,29453
2295,7,0,14,11,90697140,3640,62369280,2502,29460
2296,12,0,19,6,90723360,3641,62369280,2501,29472
2297,11,5,20,5,90736500,3640,62369700,2500,29483
2298,9,2,22,3,90797340,3641,62389320,2499,29492
2299,8,0,14,11,90875880,3642,62394480,2499,29500
2300,10,0,17,8,90900900,3642,62394480,2498,29510
2301,6,0,16,9,90936960,3642,62394480,2497,29516
2302,11,0,11,14,90985980,3642,62394480,2496,29527
2303,3,0,9,16,91004460,3642,62394480,2496,29530
2304,4,0,9,16,91022220,3642,62394480,2495,29534
2305,3,0,8,17,91034100,3642,62394480,2495,29537
2306,6,0,10,15,91041120,3642,62394480,2495,29543
2307,3,0,8,17,91055460,3641,62394480,2494,29546
2308,7,0,12,13,91071780,3642,62394480,2494,29553
2309,10,0,18,7,91085040,3642,62394480,2493,29563
2310,7,0,17,8,91115580,3642,62394480,2492,29570
2311,10,0,14,11,91150980,3641,62394480,2491,29580
2312,9,0,14,11,91191840,3641,62394480,2490,29589
2313,13,0,16,9,91215240,3641,62394480,2489,29602
2314,6,0,16,9,91243680,3641,62394480,2488,29608
2315,15,0,21,4,91285020,3641,62394480,2487,29623
2316,8,0,14,11,91337340,3641,62394480,2486,29631
2317,13,0,21,4,91353300,3641,62394480,2485,29644
2318,9,0,18,7,91399140,3641,62394480,2484,29653
2319,11,0,21,4,91443960,3642,62394480,2483,29664
2320,10,0,19,6,91479780,3641,62394480,2482,29674
2321,12,0,20,5,91530780,3642,62394480,2480,29686
2322,10,0,18,7,91578900,3642,62394480,2479,29696
2323,11,0,18,7,91624140,3642,62394480,2478,29707
2324,7,0,16,9,91652040,3642,62394480,2478,29714
2325,5,0,13,12,91695720,3643,62394480,2477,29719
2326,10,0,16,9,91721940,3643,62394480,2476,29729
2327,3,0,12,13,91750440,3643,62394480,2476,29732
2328,4,0,11,14,91774080,3643,62394480,2475,29736
2329,4,0,11,14,91796940,3643,62394480,2475,29740
2330,4,0,8,17,91823100,3643,62394480,2475,29744
2331,2,0,10,15,91823100,3643,62394480,2474,29746
2332,8,0,13,12,91838280,3643,62394480,2474,29754
2333,5,0,12,13,91864500,3643,62394480,2473,29759
2334,4,0,10,15,91886940,3643,62394480,2473,29763
2335,3,0,10,15,91906980,3644,62394480,2473,29766
2336,11,0,14,11,91926240,3643,62394480,2471,29777
2337,10,0,12,13,91963020,3643,62394480,2470,29787
2338,8,0,12,13,91989840,3643,62394480,2470,29795
2339,10,0,14,11,92011500,3643,62394480,2469,29805
2340,16,0,16,9,92045460,3642,62394480,2467,29821
2341,3,0,9,16,92074440,3642,62394480,2467,29824
2342,11,0,15,10,92088060,3642,62394480,2466,29835
2343,10,0,15,10,92114220,3641,62394480,2465,29845
2344,11,0,13,12,92158500,3641,62394480,2464,29856
2345,6,0,11,14,92185020,3641,62394480,2463,29862
2346,7,0,12,13,92212320,3641,62394480,2462,29869
2347,12,0,11,14,92240340,3640,62394480,2461,29881
2348,7,0,11,14,92255280,3640,62394480,2461,29888
2349,8,0,13,12,92280000,3640,62394480,2460,29896
2350,5,0,11,14,92301720,3640,62394480,2459,29901
2351,5,0,12,13,92320800,3640,62394480,2459,29906
2352,3,0,8,17,92355300,3641,62394480,2459,29909
2353,5,0,10,15,92362200,3640,62394480,2458,29914
2354,17,0,19,6,92377440,3640,62394480,2456,29931
2355,25,0,25,0,92417700,3639,62394480,2454,29956
2356,26,1,25,0,92480520,3638,62394900,2452,29982
2357,21,10,25,0,92520720,3637,62405580,2450,30003
2358,34,34,19,6,92592180,3638,62411520,2448,30037
2359,29,40,17,8,92636520,3639,62416980,2446,30066
2360,26,38,25,0,92703540,3640,62467200,2446,30092
2361,34,39,25,0,92776680,3640,62513280,2447,30126
2362,36,40,25,0,92846940,3641,62573340,2447,30162
2363,32,40,25,0,92904600,3640,62610600,2447,30194
2364,29,38,25,0,92977260,3640,62680080,2448,30223
2365,36,40,23,2,93029400,3640,62697180,2447,30259
2366,29,39,20,5,93108480,3640,62756100,2448,30288
2367,28,40,25,0,93143100,3640,62788560,2448,30316
2368,32,40,25,0,93217860,3640,62933580,2451,30348
2369,31,36,25,0,93300240,3641,62951640,2450,30379
2370,34,40,25,0,93352080,3641,62959920,2449,30413
2371,29,40,25,0,93423720,3642,62981340,2449,30442
2372,32,40,25,0,93497220,3641,63118800,2452,30474
2373,30,37,25,0,93571980,3641,63199140,2453,30504
2374,28,38,24,1,93639420,3641,63240360,2453,30532
2375,33,40,20,5,93681900,3641,63246540,2452,30565
2376,34,40,25,0,93750180,3642,63311520,2453,30599
2377,29,37,25,0,93813180,3642,63347820,2453,30628
2378,28,35,25,0,93890400,3641,63486900,2456,30656
2379,33,40,25,0,93953640,3641,63516720,2455,30689
2380,29,38,25,0,94028280,3641,63538140,2454,30718
2381,27,39,25,0,94079880,3641,63572640,2454,30745
2382,35,37,25,0,94150380,3642,63596640,2454,30780
2383,31,40,25,0,94212060,3642,63644280,2454,30811
2384,35,40,25,0,94292880,3642,63674460,2453,30846
2385,25,36,25,0,94363740,3642,63733980,2454,30871
2386,29,40,25,0,94424940,3641,63853140,2456,30900
2387,35,40,21,4,94488180,3641,63878280,2456,30935
2388,30,34,25,0,94554420,3641,63959220,2457,30965
2389,19,24,25,0,94616280,3640,65290500,2507,30984
2390,30,34,25,0,94692840,3640,65298120,2504,31014
2391,30,40,22,3,94740900,3640,65307960,2503,31044
2392,38,40,25,0,94814460,3641,65339280,2503,31082
2393,35,40,25,0,94867860,3641,65352000,2502,31117
2394,27,37,25,0,94945020,3641,65406600,2502,31144
2395,34,40,25,0,95010720,3641,65461260,2502,31178
2396,28,32,25,0,95078400,3640,65870040,2516,31206
2397,33,40,25,0,95141280,3641,65907180,2516,31239
2398,29,38,25,0,95232720,3641,65960820,2516,31268
2399,30,40,21,4,95262180,3640,65964420,2515,31298

