Hour,Arrivals,Waiting,Treating,Available Rooms,Total Treatment Time,Average Treatment Time,Total Wait Time,Average Wait Time,Total Arrivals
1,6,0,5,20,1380,1380,0,0,6
2,5,0,5,20,13920,2320,0,0,11
3,10,0,6,19,42660,2844,0,0,21
4,5,0,5,20,67620,3220,0,0,26
5,6,0,4,21,90420,3229,0,0,32
6,4,0,3,22,98880,2996,0,0,36
7,8,0,5,20,118560,3040,0,0,44
8,6,0,5,20,131340,2918,0,0,50
9,4,0,2,23,151140,2906,0,0,54
10,7,0,5,20,158040,2822,0,0,61
11,12,0,11,14,170160,2744,0,0,73
12,6,0,7,18,207060,2875,0,0,79
13,11,0,9,16,235620,2908,0,0,90
14,9,0,6,19,284400,3058,0,0,99
15,14,0,13,12,296700,2967,0,0,113
16,11,0,10,15,343020,3008,0,0,124
17,11,0,10,15,384420,3075,0,0,135
18,4,0,7,18,414120,3137,0,0,139
19,3,0,4,21,446280,3233,0,0,142
20,7,0,7,18,464220,3269,0,0,149
21,6,0,7,18,476520,3219,0,0,155
22,3,0,3,22,505440,3260,0,0,158
23,3,0,2,23,524040,3295,0,0,161
24,8,0,8,17,527880,3278,0,0,169
25,4,0,7,18,547680,3299,0,0,173
26,4,0,7,18,561300,3301,0,0,177
27,9,0,7,18,609180,3403,0,0,186
28,6,0,7,18,621660,3360,0,0,192
29,9,0,6,19,660180,3385,0,0,201
30,7,0,5,20,680940,3354,0,0,208
31,6,0,7,18,692760,3346,0,0,214
32,13,0,13,12,721860,3373,0,0,227
33,8,0,14,11,757140,3425,0,0,235
34,11,0,10,15,813900,3448,0,0,246
35,13,0,13,12,845640,3437,0,0,259
36,6,0,11,14,891120,3508,0,0,265
37,10,0,9,16,939060,3530,0,0,275
38,10,0,9,16,968280,3508,0,0,285
39,10,0,9,16,1000200,3497,0,0,295
40,9,0,9,16,1028820,3487,0,0,304
41,9,0,10,15,1061340,3502,0,0,313
42,13,0,10,15,1106940,3502,0,0,326
43,13,0,10,15,1159860,3525,0,0,339
44,11,0,10,15,1192680,3507,0,0,350
45,7,0,10,15,1214520,3500,0,0,357
46,4,0,5,20,1251480,3515,0,0,361
47,6,0,3,22,1277760,3510,0,0,367
48,5,0,5,20,1282200,3493,0,0,372
49,8,0,6,19,1313340,3511,0,0,380
50,11,0,10,15,1341060,3519,0,0,391
51,5,0,2,23,1381620,3506,0,0,396
52,7,0,4,21,1394280,3494,0,0,403
53,11,0,12,13,1402920,3489,0,0,414
54,11,0,8,17,1449900,3476,0,0,425
55,10,0,10,15,1480200,3482,0,0,435
56,9,0,11,14,1509420,3485,0,0,444
57,11,0,14,11,1547340,3508,0,0,455
58,9,0,14,11,1580760,3512,0,0,464
59,9,0,11,14,1631280,3530,0,0,473
60,18,0,18,7,1685400,3563,1080,2,491
61,13,0,19,6,1728900,3564,1680,3,504
62,14,0,13,12,1809840,3583,1680,3,518
63,11,0,9,16,1869000,3594,1680,3,529
64,11,0,8,17,1911600,3593,1680,3,540
65,4,0,9,16,1929720,3606,1680,3,544
66,5,0,5,20,1973460,3627,1680,3,549
67,8,0,10,15,1989300,3636,1680,3,557
68,7,0,8,17,2027940,3647,1680,2,564
69,7,0,7,18,2065560,3662,1680,2,571
70,6,0,7,18,2086260,3660,1680,2,577
71,4,0,4,21,2122500,3678,1680,2,581
72,4,0,3,22,2138220,3673,1680,2,585
73,3,0,2,23,2152260,3672,1680,2,588
74,5,0,7,18,2152260,3672,1680,2,593
75,8,0,6,19,2178840,3661,1680,2,601
76,6,0,8,17,2185200,3648,1680,2,607
77,1,0,2,23,2220540,3664,1680,2,608
78,13,0,9,16,2239620,3659,1680,2,621
79,12,0,10,15,2260800,3628,1680,2,633
80,6,0,3,22,2309820,3631,1680,2,639
81,4,0,4,21,2320320,3631,1680,2,643
82,6,0,6,19,2335320,3631,1680,2,649
83,16,0,13,12,2356800,3614,1680,2,665
84,18,0,19,6,2381700,3586,1680,2,683
85,5,0,12,13,2435520,3602,1680,2,688
86,12,0,11,14,2502120,3631,1680,2,700
87,9,0,9,16,2537460,3624,1680,2,709
88,11,0,11,14,2553720,3601,1680,2,720
89,11,0,10,15,2591520,3594,1680,2,731
90,7,0,7,18,2627040,3593,1680,2,738
91,10,0,8,17,2658180,3592,1680,2,748
92,9,0,10,15,2685960,3595,1680,2,757
93,6,0,10,15,2707920,3596,1680,2,763
94,4,0,4,21,2756220,3612,1680,2,767
95,6,0,5,20,2773140,3610,1680,2,773
96,12,0,11,14,2792820,3608,1680,2,785
97,3,0,4,21,2825400,3603,1680,2,788
98,6,0,9,16,2833980,3610,1680,2,794
99,6,0,6,19,2869320,3613,1680,2,800
100,9,0,7,18,2883960,3595,1680,2,809
101,11,0,7,18,2922120,3594,1680,2,820
102,10,0,11,14,2937660,3586,1680,2,830
103,12,0,10,15,2980500,3582,1680,1,842
104,7,0,7,18,3019800,3586,1680,1,849
105,7,0,7,18,3044520,3586,1680,1,856
106,9,0,8,17,3065940,3577,1680,1,865
107,12,0,18,7,3075300,3580,1680,1,877
108,10,0,16,9,3119160,3581,1680,1,887
109,8,0,8,17,3207240,3615,1680,1,895
110,9,0,7,18,3239820,3611,1680,1,904
111,8,0,9,16,3259020,3609,1680,1,912
112,12,0,12,13,3284160,3601,1680,1,924
113,7,0,3,22,3332340,3590,1680,1,931
114,13,0,9,16,3351120,3584,1680,1,944
115,7,0,5,20,3382560,3575,1680,1,951
116,6,0,6,19,3404340,3579,1680,1,957
117,10,0,12,13,3417720,3578,1680,1,967
118,8,0,10,15,3453120,3578,1680,1,975
119,7,0,7,18,3496380,3586,1680,1,982
120,2,0,5,20,3511260,3586,1680,1,984
121,4,0,5,20,3545280,3606,1680,1,988
122,5,0,6,19,3560760,3607,1680,1,993
123,4,0,2,23,3587460,3605,1680,1,997
124,1,0,2,23,3595560,3610,1680,1,998
125,4,0,3,22,3605040,3608,1680,1,1002
126,5,0,2,23,3615120,3597,1680,1,1007
127,10,0,6,19,3625860,3586,1680,1,1017
128,9,0,5,20,3647340,3572,1680,1,1026
129,11,0,9,16,3664440,3564,1680,1,1037
130,15,0,14,11,3682320,3547,1680,1,1052
131,6,0,6,19,3745980,3560,1680,1,1058
132,8,0,9,16,3761520,3558,1680,1,1066
133,8,0,7,18,3809460,3570,1680,1,1074
134,13,0,10,15,3846060,3571,1680,1,1087
135,5,0,8,17,3864000,3564,1680,1,1092
136,9,0,8,17,3904200,3572,1680,1,1101
137,4,0,4,21,3925500,3565,1680,1,1105
138,9,0,9,16,3939480,3565,1680,1,1114
139,12,0,7,18,3974520,3551,1680,1,1126
140,9,0,9,16,3992460,3545,1680,1,1135
141,7,0,8,17,4019580,3544,1680,1,1142
142,8,0,11,14,4042080,3548,1680,1,1150
143,3,0,6,19,4076220,3553,1680,1,1153
144,9,0,8,17,4108560,3560,1680,1,1162
145,5,0,7,18,4132440,3562,1680,1,1167
146,7,0,10,15,4147920,3563,1680,1,1174
147,4,0,4,21,4198440,3576,1680,1,1178
148,10,0,11,14,4203060,3570,1680,1,1188
149,2,0,6,19,4236960,3578,1680,1,1190
150,11,0,9,16,4270320,3582,1680,1,1201
151,12,0,11,14,4290840,3569,1680,1,1213
152,9,0,10,15,4327320,3570,1680,1,1222
153,9,0,10,15,4360140,3570,1680,1,1231
154,14,0,16,9,4386420,3569,1680,1,1245
155,12,0,15,10,4444020,3578,1680,1,1257
156,9,0,11,14,4495380,3581,1680,1,1266
157,15,0,9,16,4545240,3573,1680,1,1281
158,7,0,8,17,4571460,3571,1680,1,1288
159,15,0,9,16,4614240,3565,1680,1,1303
160,10,0,14,11,4629600,3563,1680,1,1313
161,10,0,10,15,4688280,3570,1680,1,1323
162,8,0,4,21,4733880,3567,1680,1,1331
163,7,0,8,17,4749120,3570,1680,1,1338
164,9,0,9,16,4762080,3559,1680,1,1347
165,9,0,9,16,4791660,3557,1680,1,1356
166,7,0,6,19,4807320,3542,1680,1,1363
167,5,0,4,21,4842900,3550,1680,1,1368
168,6,0,7,18,4861980,3556,1680,1,1374
169,4,0,8,17,4868760,3553,1680,1,1378
170,4,0,1,24,4914780,3558,1680,1,1382
171,7,0,6,19,4917600,3555,1680,1,1389
172,7,0,8,17,4932840,3553,1680,1,1396
173,5,0,5,20,4953660,3548,1680,1,1401
174,6,0,5,20,4977600,3550,1680,1,1407
175,9,0,6,19,4999560,3545,1680,1,1416
176,7,0,7,18,5013720,3540,1680,1,1423
177,9,0,11,14,5034900,3543,1680,1,1432
178,6,0,6,19,5080980,3548,1680,1,1438
179,6,0,8,17,5101980,3552,1680,1,1444
180,12,0,12,13,5128080,3551,1680,1,1456
181,9,0,11,14,5162220,3550,1680,1,1465
182,9,0,11,14,5202840,3556,1680,1,1474
183,19,0,12,13,5258940,3550,1680,1,1493
184,11,0,9,16,5306220,3549,1680,1,1504
185,13,0,17,8,5327160,3551,1680,1,1517
186,11,0,18,7,5369100,3555,1680,1,1528
187,6,0,8,17,5442240,3566,1680,1,1534
188,9,0,9,16,5470080,3565,1680,1,1543
189,9,0,5,20,5520960,3568,1680,1,1552
190,7,0,8,17,5530980,3566,1680,1,1559
191,5,0,7,18,5546520,3562,1680,1,1564
192,4,0,6,19,5569620,3565,1680,1,1568
193,3,0,3,22,5595240,3568,1680,1,1571
194,11,0,10,15,5605620,3565,1680,1,1582
195,9,0,11,14,5627640,3561,1680,1,1591
196,8,0,10,15,5660520,3562,1680,1,1599
197,7,0,8,17,5694540,3563,1680,1,1606
198,12,0,12,13,5716440,3559,1680,1,1618
199,7,0,11,14,5750160,3562,1680,1,1625
200,5,0,10,15,5791320,3574,1680,1,1630
201,11,0,11,14,5822460,3572,1680,1,1641
202,8,0,12,13,5861580,3580,1680,1,1649
203,11,0,10,15,5910960,3582,1680,1,1660
204,11,0,12,13,5938500,3579,1680,1,1671
205,9,0,10,15,5988180,3585,1680,1,1680
206,18,0,13,12,6031020,3579,1680,0,1698
207,13,0,12,13,6067140,3571,1680,0,1711
208,8,0,9,16,6102240,3568,1680,0,1719
209,12,0,13,12,6144900,3576,1680,0,1731
210,9,0,9,16,6191880,3577,1680,0,1740
211,11,0,13,12,6219000,3578,1680,0,1751
212,13,0,9,16,6284280,3580,1680,0,1764
213,13,0,11,14,6307140,3571,1680,0,1777
214,9,0,7,18,6340920,3564,1680,0,1786
215,4,0,4,21,6380640,3572,1680,0,1790
216,4,0,5,20,6394680,3574,1680,0,1794
217,5,0,3,22,6418080,3573,1680,0,1799
218,10,0,10,15,6420480,3568,1680,0,1809
219,5,0,5,20,6455280,3568,1680,0,1814
220,4,0,3,22,6482520,3571,1680,0,1818
221,0,0,1,24,6492480,3573,1680,0,1818
222,10,0,7,18,6502140,3570,1680,0,1828
223,11,0,9,16,6523320,3564,1680,0,1839
224,11,0,12,13,6550440,3563,1680,0,1850
225,8,0,11,14,6592140,3569,1680,0,1858
226,13,0,15,10,6636060,3575,1680,0,1871
227,14,0,17,8,6682860,3577,1680,0,1885
228,10,0,8,17,6765300,3585,1680,0,1895
229,11,0,10,15,6793020,3582,1680,0,1906
230,11,0,10,15,6820920,3576,1680,0,1917
231,9,0,11,14,6852600,3578,1680,0,1926
232,13,0,8,17,6904140,3575,1680,0,1939
233,8,0,6,19,6934500,3572,1680,0,1947
234,17,0,12,13,6957780,3564,1680,0,1964
235,7,0,10,15,6991560,3565,1680,0,1971
236,9,0,13,12,7019940,3568,1680,0,1980
237,5,0,8,17,7059660,3570,1680,0,1985
238,5,0,4,21,7106940,3578,1680,0,1990
239,5,0,3,22,7122720,3575,1680,0,1995
240,8,0,5,20,7144980,3576,1680,0,2003
241,4,0,3,22,7160280,3572,1680,0,2007
242,3,0,4,21,7175280,3576,1680,0,2010
243,0,0,1,24,7183680,3575,1680,0,2010
244,11,0,7,18,7194900,3572,1680,0,2021
245,13,0,14,11,7203360,3566,1680,0,2034
246,8,0,10,15,7256400,3571,1680,0,2042
247,7,0,10,15,7299600,3579,1680,0,2049
248,8,0,6,19,7340580,3579,1680,0,2057
249,5,0,4,21,7368960,3580,1680,0,2062
250,13,0,11,14,7384500,3577,1680,0,2075
251,5,0,8,17,7411080,3576,1680,0,2080
252,8,0,7,18,7438800,3574,1680,0,2088
253,9,0,7,18,7476180,3577,1680,0,2097
254,11,0,13,12,7495800,3577,1680,0,2108
255,12,0,12,13,7536900,3575,1680,0,2120
256,13,0,13,12,7575120,3573,1680,0,2133
257,12,0,14,11,7611480,3571,1680,0,2145
258,9,0,11,14,7669800,3579,1680,0,2154
259,13,0,14,11,7713660,3582,1680,0,2167
260,11,0,13,12,7750200,3579,1680,0,2178
261,7,0,11,14,7777980,3577,1680,0,2185
262,6,0,7,18,7843620,3591,1680,0,2191
263,5,0,5,20,7870560,3592,1680,0,2196
264,6,0,4,21,7886580,3588,1680,0,2202
265,4,0,6,19,7894860,3588,1680,0,2206
266,3,0,4,21,7912620,3588,1680,0,2209
267,3,0,5,20,7923420,3590,1680,0,2212
268,4,0,4,21,7935120,3587,1680,0,2216
269,4,0,5,20,7952640,3590,1680,0,2220
270,8,0,7,18,7976100,3591,1680,0,2228
271,10,0,11,14,7990620,3588,1680,0,2238
272,9,0,10,15,8025360,3587,1680,0,2247
273,10,0,12,13,8061600,3590,1680,0,2257
274,9,0,14,11,8082360,3588,1680,0,2266
275,11,0,11,14,8146140,3594,1680,0,2277
276,8,0,11,14,8186640,3600,1680,0,2285
277,14,0,12,13,8223360,3595,1680,0,2299
278,11,0,10,15,8259960,3591,1680,0,2310
279,8,0,11,14,8285220,3591,1680,0,2318
280,7,0,8,17,8334960,3597,1680,0,2325
281,8,0,10,15,8356200,3597,1680,0,2333
282,10,0,9,16,8395680,3597,1680,0,2343
283,8,0,8,17,8434260,3599,1680,0,2351
284,6,0,5,20,8466720,3599,1680,0,2357
285,3,0,3,22,8486700,3600,1680,0,2360
286,5,0,6,19,8492400,3600,1680,0,2365
287,3,0,2,23,8514420,3598,1680,0,2368
288,3,0,2,23,8522340,3597,1680,0,2371
289,7,0,5,20,8530020,3594,1680,0,2378
290,2,0,3,22,8543760,3594,1680,0,2380
291,8,0,5,20,8562000,3592,1680,0,2388
292,4,0,5,20,8568600,3589,1680,0,2392
293,8,0,9,16,8581740,3589,1680,0,2400
294,7,0,9,16,8613900,3592,1680,0,2407
295,7,0,10,15,8643300,3595,1680,0,2414
296,11,0,14,11,8683980,3601,1680,0,2425
297,10,0,10,15,8733000,3601,1680,0,2435
298,12,0,15,10,8764500,3603,1680,0,2447
299,9,0,9,16,8829600,3608,1680,0,2456
300,3,0,6,19,8860440,3612,1680,0,2459
301,7,0,7,18,8885760,3613,1680,0,2466
302,7,0,8,17,8912820,3615,1680,0,2473
303,17,0,15,10,8938980,3611,1680,0,2490
304,9,0,13,12,8969700,3608,1680,0,2499
305,9,0,11,14,9024240,3614,1680,0,2508
306,9,0,8,17,9070560,3615,1680,0,2517
307,10,0,13,12,9088620,3615,1680,0,2527
308,9,0,9,16,9137520,3615,1680,0,2536
309,9,0,9,16,9176400,3618,1680,0,2545
310,9,0,11,14,9198300,3617,1680,0,2554
311,5,0,4,21,9249420,3620,1680,0,2559
312,5,0,6,19,9261480,3620,1680,0,2564
313,9,0,9,16,9278640,3618,1680,0,2573
314,2,0,6,19,9303540,3621,1680,0,2575
315,4,0,5,20,9334140,3626,1680,0,2579
316,5,0,6,19,9352500,3627,1680,0,2584
317,8,0,9,16,9368940,3627,1680,0,2592
318,5,0,5,20,9393120,3623,1680,0,2597
319,10,0,10,15,9417840,3626,1680,0,2607
320,5,0,7,18,9447900,3626,1680,0,2612
321,6,0,6,19,9466440,3624,1680,0,2618
322,7,0,7,18,9485700,3623,1680,0,2625
323,8,0,6,19,9521580,3624,1680,0,2633
324,13,0,13,12,9540480,3623,1680,0,2646
325,9,0,11,14,9574680,3621,1680,0,2655
326,14,0,9,16,9622920,3617,1680,0,2669
327,15,0,15,10,9646680,3614,1680,0,2684
328,13,0,12,13,9705060,3614,1680,0,2697
329,7,0,6,19,9759180,3617,1680,0,2704
330,8,0,8,17,9775380,3615,1680,0,2712
331,14,0,13,12,9799980,3612,1680,0,2726
332,9,0,9,16,9844800,3611,1680,0,2735
333,7,0,8,17,9877320,3612,1680,0,2742
334,7,0,7,18,9910140,3614,1680,0,2749
335,6,0,5,20,9932940,3611,1680,0,2755
336,4,0,4,21,9958440,3614,1680,0,2759
337,8,0,7,18,9975780,3614,1680,0,2767
338,9,0,7,18,9998580,3610,1680,0,2776
339,20,0,16,9,10022640,3605,1680,0,2796
340,21,0,19,6,10077120,3601,1680,0,2817
341,28,5,21,4,10131660,3594,2280,0,2845
342,31,32,11,14,10204980,3602,11400,3,2876
343,31,39,18,7,10231860,3606,42300,14,2907
344,35,39,25,0,10316940,3618,104280,35,2942
345,28,39,25,0,10408920,3620,141360,48,2970
346,25,39,25,0,10494180,3622,230220,77,2995
347,31,38,25,0,10586940,3628,253920,85,3026
348,22,35,25,0,10653660,3631,322200,107,3048
349,35,40,20,5,10746180,3634,339360,112,3083
350,35,38,25,0,10821660,3643,348480,114,3118
351,29,37,25,0,10902000,3642,468000,153,3147
352,44,40,21,4,10987500,3646,471660,153,3191
353,32,34,25,0,11101980,3643,775920,249,3223
354,30,32,25,0,11182620,3635,914040,291,3253
355,23,11,25,0,11278020,3614,1560120,494,3276
356,14,0,25,0,11325720,3601,1806480,569,3290
357,37,11,25,0,11455920,3612,1812660,565,3327
358,32,21,25,0,11548800,3616,1832580,565,3359
359,30,31,25,0,11629560,3619,1847460,565,3389
360,27,39,25,0,11697120,3624,1855320,563,3416
361,35,40,25,0,11791680,3630,1891440,571,3451
362,33,40,25,0,11899320,3635,1918020,574,3484
363,27,29,25,0,11995980,3636,2082180,620,3511
364,33,29,24,1,12080400,3624,2304900,680,3544
365,33,40,21,4,12144600,3628,2309880,678,3577
366,30,36,25,0,12245100,3629,2433360,709,3607
367,29,32,25,0,12332100,3635,2461380,713,3636
368,35,40,25,0,12406440,3638,2500620,720,3671
369,25,35,25,0,12502440,3640,2561700,733,3696
370,19,9,25,0,12605700,3623,3166740,901,3715
371,31,23,23,2,12671640,3622,3214200,906,3746
372,26,37,21,4,12737760,3626,3222600,903,3772
373,36,40,24,1,12818940,3636,3238680,902,3808
374,33,38,25,0,12927540,3644,3352680,928,3841
375,32,40,25,0,13012320,3642,3385620,931,3873
376,34,39,25,0,13091280,3640,3417360,933,3907
377,25,34,23,2,13192440,3644,3464640,942,3932
378,25,33,25,0,13272540,3642,3579540,967,3957
379,34,40,25,0,13341840,3640,3613980,969,3991
380,26,32,25,0,13452780,3640,3732780,994,4017
381,21,0,25,0,13555980,3616,4677060,1239,4038
382,26,2,24,1,13637220,3614,4681200,1232,4064
383,18,8,22,3,13697580,3617,4693800,1229,4082
384,28,25,17,8,13784100,3624,4701180,1224,4110
385,33,37,13,12,13853460,3633,4715700,1220,4143
386,34,38,22,3,13887240,3637,4766760,1229,4177
387,23,39,25,0,13958760,3643,4813020,1236,4200
388,25,40,25,0,14055660,3649,4860840,1241,4225
389,29,39,25,0,14144100,3651,4899480,1244,4254
390,31,40,25,0,14235840,3650,4979460,1256,4285
391,33,36,25,0,14332920,3649,5038080,1263,4318
392,19,21,25,0,14422620,3641,5434200,1356,4337
393,35,4,25,0,14526780,3619,5856780,1448,4372
394,37,22,25,0,14595420,3619,5863920,1438,4409
395,23,26,25,0,14683020,3624,5883780,1435,4432
396,32,39,25,0,14772240,3629,5897760,1427,4464
397,34,37,25,0,14877660,3634,5919720,1424,4498
398,24,35,25,0,14961900,3633,6008340,1438,4522
399,33,39,23,2,15045780,3626,6059340,1440,4555
400,32,38,25,0,15133140,3629,6115260,1445,4587
401,26,39,20,5,15205620,3622,6197760,1457,4613
402,32,40,25,0,15302880,3629,6222060,1454,4645
403,34,40,25,0,15390780,3624,6294120,1460,4679
404,30,32,25,0,15490380,3626,6351180,1467,4709
405,29,23,25,0,15582060,3615,6788400,1558,4738
406,34,36,21,4,15645900,3609,6886620,1567,4772
407,32,39,16,9,15725700,3615,6906120,1568,4804
408,33,36,21,4,15766920,3620,6948720,1574,4837
409,37,38,22,3,15874860,3625,7035120,1584,4874
410,28,39,25,0,15929040,3625,7074540,1588,4902
411,19,21,25,0,16015260,3614,7585320,1694,4921
412,27,13,25,0,16132980,3612,7886400,1751,4948
413,33,10,25,0,16210140,3600,8082360,1783,4981
414,26,28,20,5,16275360,3604,8088420,1774,5007
415,32,37,25,0,16369500,3615,8124780,1770,5039
416,26,39,25,0,16443180,3621,8150760,1769,5065
417,19,26,25,0,16581420,3625,8307000,1796,5084
418,24,11,25,0,16662240,3612,8513520,1831,5108
419,32,18,25,0,16725480,3606,8535540,1825,5140
420,22,23,25,0,16802820,3610,8547240,1818,5162
421,27,22,25,0,16916880,3613,8595300,1817,5189
422,32,31,25,0,16977660,3608,8665560,1822,5221
423,33,40,23,2,17062920,3611,8678460,1814,5254
424,29,39,24,1,17155380,3620,8735820,1819,5283
425,33,37,22,3,17251680,3622,8845620,1834,5316
426,36,40,25,0,17309760,3626,8864700,1832,5352
427,26,34,25,0,17403780,3622,8992380,1849,5378
428,15,29,22,3,17506860,3626,9073260,1860,5393
429,21,17,25,0,17589300,3621,9464940,1932,5414
430,23,9,25,0,17667660,3614,9758220,1984,5437
431,36,27,25,0,17744700,3616,9769740,1975,5473
432,31,40,19,6,17832060,3622,9781020,1963,5504
433,23,38,25,0,17916420,3629,9830640,1966,5527
434,33,38,25,0,18005520,3631,9885540,1969,5560
435,36,37,25,0,18086340,3632,9928020,1970,5596
436,31,39,25,0,18174120,3635,9952080,1966,5627
437,25,34,25,0,18261000,3631,10065900,1978,5652
438,37,40,25,0,18346260,3633,10096800,1974,5689
439,32,29,25,0,18444060,3631,10263540,1999,5721
440,23,18,25,0,18532620,3624,10664100,2068,5744
441,25,21,25,0,18611280,3624,10725720,2070,5769
442,29,25,25,0,18709080,3625,10738500,2061,5798
443,34,40,16,9,18787560,3629,10741620,2053,5832
444,31,37,22,3,18842640,3634,10778820,2055,5863
445,33,40,25,0,18913860,3637,10807920,2053,5896
446,26,35,25,0,19014360,3637,10993740,2080,5922
447,29,39,25,0,19091760,3635,11091600,2086,5951
448,30,38,25,0,19197720,3642,11103780,2082,5981
449,37,40,25,0,19291560,3642,11152980,2080,6018
450,32,40,25,0,19380720,3641,11175120,2075,6050
451,27,37,20,5,19462500,3643,11191440,2073,6077
452,25,26,25,0,19556580,3640,11597880,2138,6102
453,31,39,25,0,19626120,3641,11684880,2142,6133
454,37,40,25,0,19708620,3645,11706720,2140,6170
455,40,36,25,0,19803180,3644,11824560,2151,6210
456,22,26,25,0,19896660,3640,12172320,2207,6232
457,31,39,23,2,19965960,3639,12291180,2217,6263
458,33,39,25,0,20064540,3642,12394320,2224,6296
459,29,37,25,0,20151360,3643,12409080,2218,6325
460,39,40,25,0,20262180,3642,12511800,2223,6364
461,30,32,25,0,20355120,3638,12732660,2253,6394
462,26,28,25,0,20438400,3634,12916800,2275,6420
463,41,40,25,0,20519160,3634,12954420,2268,6461
464,33,39,16,9,20608500,3634,13009380,2271,6494
465,26,40,15,10,20657820,3633,13020240,2268,6520
466,34,36,19,6,20753520,3635,13145760,2280,6554
467,27,35,25,0,20816400,3634,13229280,2286,6581
468,29,40,24,1,20891880,3633,13337940,2294,6610
469,35,40,25,0,20963100,3637,13355880,2292,6645
470,26,38,25,0,21064680,3643,13378260,2288,6671
471,34,27,25,0,21186480,3640,13683960,2330,6705
472,31,22,25,0,21274020,3632,14280480,2419,6736
473,30,16,25,0,21359880,3625,14575020,2457,6766
474,33,40,17,8,21423420,3625,14581500,2444,6799
475,38,37,25,0,21502980,3631,14632260,2446,6837
476,39,40,25,0,21560940,3632,14657340,2442,6876
477,32,40,25,0,21658500,3635,14719200,2444,6908
478,28,38,25,0,21766320,3638,14762820,2441,6936
479,27,32,25,0,21836940,3631,14981100,2468,6963
480,30,39,16,9,21930420,3635,14989200,2462,6993
481,31,40,14,11,21996060,3635,14998020,2457,7024
482,25,32,25,0,22066200,3637,15145500,2473,7049
483,31,37,25,0,22143540,3637,15158820,2465,7080
484,31,40,25,0,22232220,3636,15218400,2463,7111
485,40,40,25,0,22316880,3637,15259380,2461,7151
486,34,32,25,0,22430940,3636,15469680,2484,7185
487,23,21,25,0,22519860,3630,16342500,2616,7208
488,37,34,25,0,22587660,3627,16386900,2606,7245
489,32,40,25,0,22672560,3631,16410960,2603,7277
490,31,40,18,7,22768200,3632,16429440,2597,7308
491,30,37,21,4,22829880,3634,16469940,2598,7338
492,33,21,25,0,22913640,3622,17035980,2673,7371
493,36,40,18,7,22965180,3618,17062080,2669,7407
494,26,37,25,0,23044980,3624,17090940,2662,7433
495,31,39,25,0,23141640,3628,17138040,2660,7464
496,31,36,25,0,23229960,3628,17212740,2663,7495
497,27,33,25,0,23331360,3627,17336280,2671,7522
498,30,35,25,0,23405640,3623,17516760,2687,7552
499,36,40,23,2,23481360,3624,17525580,2679,7588
500,39,38,23,2,23576160,3629,17589180,2682,7627
501,30,39,25,0,23642220,3628,17652720,2684,7657
502,28,34,25,0,23734680,3628,17722200,2685,7685
503,22,24,23,2,23804220,3619,18038040,2723,7707
504,12,0,13,12,23912400,3611,18956100,2856,7719
505,8,0,10,15,23968020,3613,18956100,2853,7727
506,7,0,9,16,23998020,3613,18956100,2850,7734
507,7,0,8,17,24032580,3614,18956100,2847,7741
508,5,0,4,21,24069420,3615,18956100,2845,7746
509,6,0,6,19,24084900,3615,18956100,2842,7752
510,4,0,7,18,24098760,3615,18956100,2841,7756
511,6,0,8,17,24115980,3615,18956100,2838,7762
512,5,0,7,18,24144720,3616,18956100,2836,7767
513,7,0,8,17,24170340,3617,18956100,2833,7774
514,8,0,8,17,24200460,3617,18956100,2830,7782
515,10,0,10,15,24237120,3618,18956100,2825,7792
516,9,0,6,19,24282300,3618,18956100,2822,7801
517,10,0,9,16,24296280,3616,18956100,2817,7811
518,15,0,12,13,24342540,3617,18956100,2811,7826
519,11,0,14,11,24380940,3617,18956100,2807,7837
520,9,0,9,16,24424980,3616,18956100,2803,7846
521,12,0,9,16,24469140,3617,18956100,2798,7858
522,10,0,6,19,24502980,3615,18956100,2794,7868
523,8,0,9,16,24512400,3613,18956100,2790,7876
524,4,0,4,21,24552360,3614,18956100,2789,7880
525,6,0,4,21,24572280,3614,18956100,2786,7886
526,3,0,5,20,24580080,3614,18956100,2785,7889
527,4,0,6,19,24594000,3615,18956100,2783,7893
528,4,0,6,19,24606300,3614,18956100,2782,7897
529,2,0,3,22,24632820,3616,18956100,2781,7899
530,8,0,7,18,24647640,3616,18956100,2778,7907
531,6,0,4,21,24673860,3615,18956100,2775,7913
532,4,0,3,22,24679440,3613,18956100,2774,7917
533,7,0,5,20,24706200,3614,18956100,2771,7924
534,9,0,9,16,24717300,3613,18956100,2767,7933
535,10,0,13,12,24741720,3614,18956100,2763,7943
536,8,0,7,18,24802680,3615,18956100,2760,7951
537,6,0,5,20,24823320,3614,18956100,2758,7957
538,11,0,11,14,24833280,3613,18956100,2753,7968
539,11,0,14,11,24859260,3612,18956100,2749,7979
540,7,0,10,15,24900300,3612,18956100,2746,7986
541,6,0,9,16,24944040,3615,18956100,2744,7992
542,11,0,10,15,24982440,3615,18956100,2739,8003
543,9,0,7,18,25024440,3615,18956100,2736,8012
544,6,0,7,18,25049820,3616,18956100,2733,8018
545,9,0,9,16,25078320,3616,18956100,2730,8027
546,7,0,11,14,25090140,3615,18956100,2727,8034
547,7,0,9,16,25139400,3618,18956100,2724,8041
548,7,0,6,19,25174980,3618,18956100,2722,8048
549,7,0,7,18,25199520,3618,18956100,2719,8055
550,5,0,4,21,25228800,3618,18956100,2717,8060
551,10,0,5,20,25251360,3617,18956100,2713,8070
552,1,0,1,24,25274940,3617,18956100,2713,8071
553,3,0,3,22,25275840,3617,18956100,2711,8074
554,6,0,4,21,25290780,3617,18956100,2709,8080
555,5,0,6,19,25299240,3616,18956100,2707,8085
556,6,0,2,23,25330380,3616,18956100,2705,8091
557,5,0,6,19,25334280,3616,18956100,2703,8096
558,5,0,8,17,25343280,3615,18956100,2701,8101
559,11,0,9,16,25373280,3614,18956100,2697,8112
560,5,0,6,19,25403880,3615,18956100,2695,8117
561,12,0,13,12,25420440,3614,18956100,2690,8129
562,7,0,8,17,25475340,3616,18956100,2688,8136
563,11,0,13,12,25499700,3616,18956100,2683,8147
564,7,0,10,15,25538520,3617,18956100,2681,8154
565,16,0,13,12,25574940,3615,18956100,2675,8170
566,6,0,10,15,25620960,3617,18956100,2672,8176
567,15,0,11,14,25666320,3617,18956100,2667,8191
568,17,0,14,11,25719900,3617,18956100,2660,8208
569,19,0,20,5,25755540,3615,18956100,2653,8227
570,3,0,6,19,25837260,3618,18956100,2652,8230
571,5,0,1,24,25874580,3618,18956100,2650,8235
572,6,0,4,21,25880160,3618,18956100,2648,8241
573,5,0,3,22,25891680,3616,18956100,2646,8246
574,4,0,4,21,25904880,3616,18956100,2645,8250
575,3,0,5,20,25916160,3617,18956100,2644,8253
576,3,0,3,22,25940280,3618,18956100,2643,8256
577,5,0,2,23,25954440,3617,18956100,2641,8261
578,6,0,7,18,25957620,3617,18956100,2639,8267
579,5,0,8,17,25970760,3617,18956100,2637,8272
580,7,0,9,16,26001960,3618,18956100,2634,8279
581,6,0,4,21,26044560,3618,18956100,2632,8285
582,9,0,10,15,26049360,3617,18956100,2629,8294
583,9,0,11,14,26077980,3617,18956100,2625,8303
584,11,0,13,12,26107920,3617,18956100,2621,8314
585,13,0,13,12,26145840,3616,18956100,2617,8327
586,7,0,9,16,26183160,3615,18956100,2614,8334
587,10,0,9,16,26211960,3614,18956100,2611,8344
588,11,0,7,18,26253780,3614,18956100,2607,8355
589,11,0,8,17,26288100,3613,18956100,2603,8366
590,9,0,10,15,26307120,3613,18956100,2599,8375
591,11,0,9,16,26348400,3612,18956100,2596,8386
592,6,0,12,13,26360520,3613,18956100,2593,8392
593,5,0,5,20,26404680,3613,18956100,2592,8397
594,8,0,6,19,26424300,3612,18956100,2589,8405
595,8,0,9,16,26437560,3611,18956100,2586,8413
596,6,0,5,20,26480220,3612,18956100,2584,8419
597,10,0,8,17,26504220,3612,18956100,2580,8429
598,5,0,6,19,26527620,3612,18956100,2579,8434
599,6,0,7,18,26549040,3612,18956100,2576,8440
600,2,0,2,23,26586960,3614,18956100,2576,8442
601,8,0,7,18,26591400,3613,18956100,2573,8450
602,8,0,5,20,26618880,3612,18956100,2570,8458
603,5,0,5,20,26631840,3611,18956100,2568,8463
604,6,0,6,19,26647440,3611,18956100,2566,8469
605,7,0,8,17,26673720,3612,18956100,2564,8476
606,7,0,7,18,26701860,3612,18956100,2561,8483
607,7,0,7,18,26727900,3612,18956100,2559,8490
608,8,0,4,21,26756100,3610,18956100,2556,8498
609,11,0,9,16,26771760,3610,18956100,2553,8509
610,7,0,10,15,26798400,3610,18956100,2550,8516
611,15,0,14,11,26826000,3609,18956100,2545,8531
612,10,0,10,15,26901600,3612,18956100,2542,8541
613,8,0,8,17,26934720,3612,18956100,2539,8549
614,9,0,10,15,26958420,3611,18956100,2536,8558
615,8,0,10,15,26992560,3612,18956100,2533,8566
616,15,0,14,11,27018900,3610,18956100,2528,8581
617,14,0,17,8,27060300,3610,18956100,2523,8595
618,6,0,12,13,27113400,3612,18956100,2521,8601
619,3,0,6,19,27168060,3615,18956100,2520,8604
620,10,0,8,17,27195480,3615,18956100,2517,8614
621,6,0,9,16,27217080,3615,18956100,2515,8620
622,5,0,3,22,27249300,3614,18956100,2513,8625
623,7,0,2,23,27274440,3614,18956100,2511,8632
624,5,0,4,21,27280500,3613,18956100,2509,8637
625,8,0,10,15,27284400,3613,18956100,2507,8645
626,4,0,3,22,27327120,3613,18956100,2505,8649
627,4,0,5,20,27341040,3614,18956100,2504,8653
628,4,0,3,22,27361860,3614,18956100,2503,8657
629,8,0,9,16,27363480,3613,18956100,2500,8665
630,8,0,8,17,27395820,3613,18956100,2497,8673
631,11,0,12,13,27417000,3613,18956100,2494,8684
632,11,0,14,11,27450300,3613,18956100,2490,8695
633,10,0,10,15,27504960,3613,18956100,2487,8705
634,3,0,4,21,27546240,3614,18956100,2486,8708
635,11,0,11,14,27571260,3616,18956100,2482,8719
636,11,0,15,10,27587940,3615,18956100,2479,8730
637,14,0,16,9,27642240,3616,18956100,2474,8744
638,8,0,10,15,27698460,3616,18956100,2472,8752
639,12,0,9,16,27743880,3616,18956100,2468,8764
640,9,0,8,17,27784800,3617,18956100,2465,8773
641,12,0,10,15,27815400,3616,18956100,2461,8785
642,6,0,6,19,27846120,3615,18956100,2459,8791
643,5,0,5,20,27868800,3616,18956100,2458,8796
644,7,0,7,18,27885840,3615,18956100,2455,8803
645,3,0,3,22,27914580,3616,18956100,2454,8806
646,14,0,15,10,27925140,3616,18956100,2450,8820
647,4,0,12,13,27949860,3616,18956100,2449,8824
648,3,0,5,20,28005300,3619,18956100,2448,8827
649,5,0,1,24,28039860,3619,18956100,2446,8832
650,1,0,0,25,28045800,3619,18956100,2446,8833
651,3,0,1,24,28049160,3618,18956100,2445,8836
652,8,0,5,20,28053660,3617,18956100,2442,8844
653,11,0,7,18,28079040,3616,18956100,2439,8855
654,6,0,8,17,28092180,3615,18956100,2437,8861
655,7,0,8,17,28121040,3616,18956100,2435,8868
656,7,0,10,15,28146000,3617,18956100,2433,8875
657,16,0,10,15,28189320,3615,18956100,2428,8891
658,5,0,7,18,28221900,3615,18956100,2426,8896
659,5,0,5,20,28255500,3616,18956100,2424,8901
660,6,0,4,21,28272900,3615,18956100,2423,8907
661,13,0,12,13,28284300,3615,18956100,2419,8920
662,13,0,14,11,28331460,3616,18956100,2415,8933
663,14,0,18,7,28368420,3616,18956100,2410,8947
664,7,0,8,17,28434840,3616,18956100,2408,8954
665,7,0,7,18,28476300,3618,18956100,2406,8961
666,9,0,9,16,28496700,3617,18956100,2403,8970
667,11,0,10,15,28538640,3618,18956100,2400,8981
668,7,0,7,18,28569480,3617,18956100,2398,8988
669,3,0,5,20,28592640,3618,18956100,2397,8991
670,6,0,3,22,28612380,3617,18956100,2395,8997
671,4,0,2,23,28636920,3618,18956100,2394,9001
672,4,0,4,21,28642740,3617,18956100,2393,9005
673,8,0,9,16,28645260,3616,18956100,2390,9013
674,2,0,7,18,28653180,3615,18956100,2390,9015
675,6,0,7,18,28679640,3616,18956100,2388,9021
676,4,0,7,18,28687440,3615,18956100,2387,9025
677,10,0,9,16,28711500,3615,18956100,2384,9035
678,3,0,8,17,28726020,3615,18956100,2383,9038
679,7,0,8,17,28746120,3614,18956100,2381,9045
680,6,0,7,18,28771740,3614,18956100,2379,9051
681,13,0,12,13,28789680,3613,18956100,2375,9064
682,8,0,12,13,28807320,3611,18956100,2373,9072
683,6,0,10,15,28835640,3611,18956100,2371,9078
684,8,0,10,15,28859940,3611,18956100,2368,9086
685,6,0,13,12,28869120,3610,18956100,2367,9092
686,12,0,12,13,28918260,3611,18956100,2363,9104
687,13,0,11,14,28958880,3609,18956100,2359,9117
688,13,0,19,6,28984380,3610,18956100,2355,9130
689,15,0,20,5,29025120,3609,18956100,2351,9145
690,8,0,9,16,29111640,3611,18956100,2349,9153
691,9,0,12,13,29144400,3613,18956100,2346,9162
692,12,0,13,12,29160660,3610,18956100,2343,9174
693,4,0,8,17,29208180,3612,18956100,2341,9178
694,7,0,8,17,29235060,3612,18956100,2339,9185
695,4,0,7,18,29253120,3612,18956100,2338,9189
696,7,0,10,15,29259000,3611,18956100,2336,9196
697,1,0,5,20,29285880,3611,18956100,2336,9197
698,2,0,4,21,29295840,3611,18956100,2335,9199
699,7,0,9,16,29298720,3611,18956100,2333,9206
700,8,0,11,14,29316660,3610,18956100,2331,9214
701,6,0,13,12,29333340,3611,18956100,2329,9220
702,5,0,10,15,29363820,3611,18956100,2328,9225
703,9,0,13,12,29392680,3612,18956100,2325,9234
704,13,0,12,13,29449140,3612,18956100,2322,9247
705,9,0,10,15,29489340,3613,18956100,2319,9256
706,11,0,12,13,29514000,3612,18956100,2316,9267
707,14,0,17,8,29549160,3612,18956100,2312,9281
708,6,0,16,9,29583480,3613,18956100,2310,9287
709,7,0,11,14,29637840,3614,18956100,2308,9294
710,6,0,12,13,29672040,3616,18956100,2307,9300
711,12,0,15,10,29704860,3616,18956100,2303,9312
712,12,0,16,9,29749320,3617,18956100,2300,9324
713,9,0,13,12,29795400,3617,18956100,2297,9333
714,9,0,13,12,29826120,3617,18956100,2295,9342
715,8,0,12,13,29855040,3617,18956100,2293,9350
716,14,0,15,10,29886300,3616,18956100,2289,9364
717,12,0,15,10,29918280,3614,18956100,2286,9376
718,4,0,11,14,29958960,3616,18956100,2284,9380
719,7,0,13,12,29979780,3616,18956100,2283,9387
720,6,0,12,13,30023520,3618,18956100,2281,9393
721,7,0,11,14,30059160,3619,18956100,2279,9400
722,6,0,13,12,30074700,3619,18956100,2277,9406
723,11,0,14,11,30122160,3620,18956100,2274,9417
724,6,0,12,13,30146580,3620,18956100,2273,9423
725,5,0,9,16,30184140,3621,18956100,2271,9428
726,6,0,10,15,30200940,3621,18956100,2270,9434
727,6,0,10,15,30231780,3622,18956100,2268,9440
728,8,0,10,15,30258180,3621,18956100,2266,9448
729,7,0,10,15,30283920,3622,18956100,2264,9455
730,8,0,9,16,30309060,3621,18956100,2262,9463
731,8,0,10,15,30331020,3620,18956100,2260,9471
732,10,0,9,16,30363240,3619,18956100,2257,9481
733,9,0,11,14,30380580,3618,18956100,2255,9490
734,18,0,12,13,30426360,3617,18956100,2250,9508
735,14,0,17,8,30445980,3615,18956100,2246,9522
736,17,0,17,8,30506280,3615,18956100,2241,9539
737,12,0,13,12,30556500,3614,18956100,2238,9551
738,7,0,11,14,30595440,3615,18956100,2236,9558
739,16,0,17,8,30630900,3615,18956100,2232,9574
740,3,0,10,15,30680700,3616,18956100,2231,9577
741,7,0,13,12,30699480,3617,18956100,2230,9584
742,7,0,9,16,30749220,3618,18956100,2228,9591
743,5,0,9,16,30774960,3619,18956100,2226,9596
744,5,0,10,15,30789360,3619,18956100,2225,9601
745,8,0,9,16,30829860,3620,18956100,2223,9609
746,7,0,6,19,30852720,3618,18956100,2221,9616
747,6,0,11,14,30854580,3618,18956100,2220,9622
748,5,0,9,16,30882000,3618,18956100,2218,9627
749,7,0,7,18,30911700,3618,18956100,2217,9634
750,9,0,12,13,30922380,3617,18956100,2214,9643
751,13,0,15,10,30959760,3618,18956100,2211,9656
752,6,0,13,12,30989400,3618,18956100,2209,9662
753,7,0,11,14,31036200,3619,18956100,2208,9669
754,13,0,15,10,31066200,3619,18956100,2204,9682
755,12,0,15,10,31105200,3618,18956100,2201,9694
756,6,0,14,11,31144080,3620,18956100,2200,9700
757,6,0,13,12,31179120,3621,18956100,2198,9706
758,9,0,10,15,31227960,3622,18956100,2196,9715
759,13,0,13,12,31255200,3621,18956100,2192,9728
760,14,0,17,8,31293840,3621,18956100,2189,9742
761,10,0,17,8,31326000,3621,18956100,2186,9752
762,8,0,12,13,31376220,3621,18956100,2184,9760
763,6,0,10,15,31410900,3622,18956100,2183,9766
764,5,0,10,15,31438380,3623,18956100,2182,9771
765,5,0,11,14,31461060,3624,18956100,2180,9776
766,7,0,9,16,31508700,3625,18956100,2179,9783
767,7,0,13,12,31516380,3625,18956100,2177,9790
768,4,0,8,17,31553220,3625,18956100,2176,9794
769,8,0,10,15,31578240,3626,18956100,2174,9802
770,5,0,7,18,31601100,3625,18956100,2173,9807
771,3,0,8,17,31615860,3626,18956100,2172,9810
772,3,0,7,18,31633740,3626,18956100,2171,9813
773,3,0,7,18,31645200,3626,18956100,2170,9816
774,5,0,9,16,31649760,3626,18956100,2169,9821
775,8,0,10,15,31677720,3626,18956100,2167,9829
776,9,0,11,14,31706700,3626,18956100,2165,9838
777,11,0,14,11,31729440,3625,18956100,2162,9849
778,11,0,15,10,31768860,3626,18956100,2159,9860
779,12,0,19,6,31802700,3626,18956100,2157,9872
780,14,0,20,5,31848900,3626,18956100,2153,9886
781,10,0,15,10,31913820,3627,18956100,2151,9896
782,7,0,10,15,31968360,3629,18956100,2149,9903
783,9,0,12,13,31998720,3629,18956100,2147,9912
784,7,0,14,11,32014260,3629,18956100,2145,9919
785,11,0,15,10,32049600,3629,18956100,2142,9930
786,7,0,12,13,32093640,3630,18956100,2141,9937
787,15,0,14,11,32147520,3630,18956100,2137,9952
788,14,0,21,4,32171160,3630,18956100,2134,9966
789,6,0,14,11,32228220,3631,18956100,2132,9972
790,6,0,9,16,32278020,3632,18956100,2131,9978
791,8,0,11,14,32298960,3632,18956100,2129,9986
792,7,0,9,16,32333700,3633,18956100,2127,9993
793,4,0,9,16,32357040,3633,18956100,2126,9997
794,4,0,6,19,32388720,3634,18956100,2125,10001
795,6,0,7,18,32397000,3633,18956100,2124,10007
796,3,0,9,16,32403660,3633,18956100,2123,10010
797,9,0,8,17,32430780,3632,18956100,2121,10019
798,4,0,8,17,32441520,3632,18956100,2120,10023
799,8,0,11,14,32456520,3632,18956100,2118,10031
800,11,0,11,14,32491500,3631,18956100,2116,10042
801,10,0,14,11,32516160,3631,18956100,2113,10052
802,8,0,12,13,32546040,3630,18956100,2111,10060
803,6,0,8,17,32590980,3631,18956100,2110,10066
804,15,0,12,13,32616540,3630,18956100,2106,10081
805,12,0,16,9,32636640,3629,18956100,2104,10093
806,8,0,15,10,32667060,3628,18956100,2102,10101
807,14,0,15,10,32721720,3629,18956100,2099,10115
808,7,0,11,14,32763480,3629,18956100,2097,10122
809,6,0,10,15,32791740,3629,18956100,2095,10128
810,7,0,11,14,32814780,3629,18956100,2094,10135
811,11,0,13,12,32838420,3628,18956100,2091,10146
812,10,0,14,11,32861520,3627,18956100,2089,10156
813,5,0,9,16,32894460,3627,18956100,2088,10161
814,6,0,10,15,32915760,3627,18956100,2086,10167
815,8,0,12,13,32932740,3627,18956100,2085,10175
816,9,0,10,15,32962380,3626,18956100,2083,10184
817,0,0,4,21,33000060,3627,18956100,2083,10184
818,3,0,5,20,33007560,3628,18956100,2082,10187
819,9,0,10,15,33015960,3627,18956100,2080,10196
820,6,0,9,16,33028860,3625,18956100,2078,10202
821,4,0,6,19,33061860,3626,18956100,2078,10206
822,3,0,6,19,33067860,3626,18956100,2077,10209
823,10,0,9,16,33086940,3625,18956100,2075,10219
824,7,0,10,15,33100260,3624,18956100,2073,10226
825,5,0,7,18,33128400,3624,18956100,2072,10231
826,12,0,12,13,33146820,3623,18956100,2069,10243
827,13,0,13,12,33174120,3622,18956100,2066,10256
828,8,0,13,12,33201600,3621,18956100,2064,10264
829,4,0,9,16,33233340,3622,18956100,2064,10268
830,14,0,13,12,33269880,3622,18956100,2060,10282
831,13,0,15,10,33292440,3620,18956100,2057,10295
832,6,0,11,14,33329340,3620,18956100,2056,10301
833,9,0,9,16,33380580,3621,18956100,2054,10310
834,7,0,10,15,33392520,3620,18956100,2053,10317
835,3,0,9,16,33407880,3620,18956100,2052,10320
836,4,0,7,18,33433080,3621,18956100,2051,10324
837,15,0,16,9,33447660,3620,18956100,2048,10339
838,5,0,12,13,33473160,3619,18956100,2047,10344
839,7,0,14,11,33497160,3620,18956100,2045,10351
840,5,0,9,16,33557580,3622,18956100,2044,10356
841,2,0,7,18,33575220,3623,18956100,2044,10358
842,4,0,6,19,33593640,3623,18956100,2043,10362
843,7,0,9,16,33607200,3623,18956100,2041,10369
844,5,0,8,17,33624000,3622,18956100,2040,10374
845,6,0,9,16,33638880,3622,18956100,2039,10380
846,8,0,10,15,33675120,3623,18956100,2037,10388
847,10,0,14,11,33698820,3623,18956100,2035,10398
848,7,0,12,13,33727800,3623,18956100,2033,10405
849,9,0,15,10,33754380,3623,18956100,2031,10414
850,11,0,19,6,33783720,3624,18956100,2029,10425
851,12,0,16,9,33847800,3625,18956100,2026,10437
852,13,0,14,11,33893460,3624,18956100,2023,10450
853,14,0,14,11,33941940,3623,18956100,2020,10464
854,10,0,17,8,33968460,3624,18956100,2018,10474
855,12,0,15,10,34029120,3625,18956100,2016,10486
856,10,0,14,11,34070100,3625,18956100,2014,10496
857,9,0,13,12,34111560,3625,18956100,2012,10505
858,13,0,14,11,34152120,3625,18956100,2009,10518
859,7,0,15,10,34181040,3626,18956100,2007,10525
860,5,0,8,17,34227300,3626,18956100,2006,10530
861,8,0,9,16,34254240,3626,18956100,2005,10538
862,4,0,8,17,34275120,3626,18956100,2004,10542
863,9,0,10,15,34302840,3627,18956100,2002,10551
864,3,0,10,15,34313580,3627,18956100,2001,10554
865,6,0,11,14,34334400,3627,18956100,2000,10560
866,5,0,8,17,34371660,3628,18956100,1999,10565
867,11,0,13,12,34390560,3628,18956100,1997,10576
868,6,0,13,12,34419120,3628,18956100,1995,10582
869,6,0,11,14,34453020,3629,18956100,1994,10588
870,13,0,17,8,34473660,3628,18956100,1991,10601
871,11,0,16,9,34505820,3627,18956100,1989,10612
872,8,0,6,19,34573260,3627,18956100,1987,10620
873,8,0,9,16,34582260,3626,18956100,1986,10628
874,16,0,19,6,34598820,3626,18956100,1982,10644
875,16,0,17,8,34639200,3623,18956100,1979,10660
876,9,0,12,13,34687500,3623,18956100,1977,10669
877,8,0,6,19,34737900,3623,18956100,1976,10677
878,13,0,12,13,34757400,3622,18956100,1973,10690
879,10,0,11,14,34780620,3621,18956100,1971,10700
880,11,0,12,13,34817340,3621,18956100,1969,10711
881,15,0,18,7,34845180,3620,18956100,1965,10726
882,7,0,13,12,34888380,3620,18956100,1964,10733
883,5,0,9,16,34927260,3621,18956100,1963,10738
884,7,0,10,15,34944600,3620,18956100,1962,10745
885,8,0,13,12,34960980,3620,18956100,1960,10753
886,7,0,9,16,34996920,3620,18956100,1959,10760
887,9,0,11,14,35018580,3619,18956100,1957,10769
888,7,0,9,16,35052600,3620,18956100,1955,10776
889,6,0,12,13,35065920,3620,18956100,1954,10782
890,10,0,13,12,35094180,3619,18956100,1952,10792
891,5,0,10,15,35127180,3620,18956100,1951,10797
892,5,0,9,16,35150280,3620,18956100,1950,10802
893,8,0,12,13,35169840,3620,18956100,1949,10810
894,11,0,14,11,35207640,3621,18956100,1946,10821
895,17,0,16,9,35251440,3619,18956100,1943,10838
896,11,0,15,10,35286360,3619,18956100,1941,10849
897,14,0,13,12,35351220,3619,18956100,1938,10863
898,12,0,15,10,35374980,3618,18956100,1936,10875
899,11,0,15,10,35417160,3618,18956100,1933,10886
900,8,0,14,11,35458980,3619,18956100,1932,10894
901,10,0,13,12,35507280,3620,18956100,1930,10904
902,13,0,18,7,35535780,3620,18956100,1927,10917
903,8,0,12,13,35574420,3619,18956100,1926,10925
904,11,0,13,12,35620800,3620,18956100,1924,10936
905,14,0,17,8,35660280,3620,18956100,1921,10950
906,9,0,16,9,35704800,3621,18956100,1919,10959
907,8,0,15,10,35746020,3622,18956100,1918,10967
908,8,0,12,13,35792160,3623,18956100,1916,10975
909,10,0,12,13,35830320,3623,18956100,1914,10985
910,6,0,12,13,35844780,3622,18956100,1913,10991
911,4,0,7,18,35882040,3622,18956100,1912,10995
912,9,0,9,16,35908800,3623,18956100,1910,11004
913,4,0,8,17,35922480,3622,18956100,1910,11008
914,6,0,9,16,35941500,3622,18956100,1908,11014
915,3,0,8,17,35958360,3623,18956100,1908,11017
916,1,0,5,20,35979660,3623,18956100,1908,11018
917,1,0,5,20,35988360,3624,18956100,1908,11019
918,8,0,7,18,35998860,3623,18956100,1906,11027
919,8,0,9,16,36018660,3622,18956100,1904,11035
920,6,0,10,15,36035100,3622,18956100,1903,11041
921,9,0,8,17,36070200,3622,18956100,1902,11050
922,7,0,11,14,36082440,3622,18956100,1900,11057
923,9,0,14,11,36106740,3622,18956100,1899,11066
924,15,0,16,9,36149100,3621,18956100,1896,11081
925,10,0,11,14,36194040,3620,18956100,1894,11091
926,13,0,17,8,36213480,3620,18956100,1891,11104
927,10,0,14,11,36262620,3620,18956100,1889,11114
928,10,0,13,12,36303960,3620,18956100,1888,11124
929,8,0,11,14,36338400,3620,18956100,1886,11132
930,8,0,8,17,36385740,3621,18956100,1885,11140
931,9,0,8,17,36403140,3619,18956100,1883,11149
932,7,0,9,16,36424620,3619,18956100,1882,11156
933,8,0,8,17,36452160,3619,18956100,1880,11164
934,4,0,9,16,36461520,3619,18956100,1879,11168
935,2,0,6,19,36484680,3619,18956100,1879,11170
936,4,0,5,20,36508500,3620,18956100,1878,11174
937,1,0,4,21,36512400,3619,18956100,1878,11175
938,8,0,11,14,36513240,3619,18956100,1877,11183
939,9,0,17,8,36517800,3618,18956100,1875,11192
940,10,0,20,5,36549720,3619,18956100,1873,11202
941,9,0,17,8,36618360,3621,18956100,1871,11211
942,8,0,10,15,36688980,3623,18956100,1870,11219
943,6,0,8,17,36717780,3623,18956100,1869,11225
944,5,0,9,16,36732960,3623,18956100,1868,11230
945,9,0,11,14,36762660,3624,18956100,1866,11239
946,8,0,9,16,36789420,3623,18956100,1865,11247
947,8,0,9,16,36808740,3622,18956100,1863,11255
948,8,0,8,17,36841620,3622,18956100,1862,11263
949,5,0,10,15,36848580,3621,18956100,1861,11268
950,7,0,5,20,36882300,3620,18956100,1860,11275
951,7,0,9,16,36886200,3620,18956100,1858,11282
952,14,0,15,10,36900960,3618,18956100,1856,11296
953,8,0,12,13,36938340,3618,18956100,1854,11304
954,10,0,14,11,36962760,3618,18956100,1852,11314
955,6,0,15,10,36991260,3619,18956100,1851,11320
956,4,0,11,14,37031880,3620,18956100,1851,11324
957,7,0,10,15,37082820,3622,18956100,1849,11331
958,6,0,10,15,37102980,3622,18956100,1848,11337
959,6,0,9,16,37134000,3622,18956100,1847,11343
960,6,0,8,17,37147980,3621,18956100,1846,11349
961,5,0,8,17,37168500,3621,18956100,1845,11354
962,5,0,7,18,37187760,3621,18956100,1844,11359
963,11,0,14,11,37203300,3621,18956100,1842,11370
964,5,0,11,14,37236240,3622,18956100,1842,11375
965,7,0,12,13,37258260,3622,18956100,1840,11382
966,10,0,11,14,37302960,3622,18956100,1838,11392
967,10,0,10,15,37332180,3621,18956100,1837,11402
968,8,0,14,11,37353720,3622,18956100,1835,11410
969,9,0,12,13,37394040,3622,18956100,1834,11419
970,11,0,11,14,37429920,3621,18956100,1832,11430
971,7,0,10,15,37466700,3622,18956100,1830,11437
972,5,0,8,17,37496580,3622,18956100,1830,11442
973,7,0,10,15,37515960,3622,18956100,1828,11449
974,9,0,10,15,37543200,3622,18956100,1827,11458
975,7,0,9,16,37564740,3621,18956100,1826,11465
976,7,0,11,14,37582440,3621,18956100,1824,11472
977,3,0,8,17,37613820,3622,18956100,1824,11475
978,8,0,11,14,37634160,3622,18956100,1822,11483
979,8,0,14,11,37643220,3621,18956100,1821,11491
980,4,0,6,19,37688280,3622,18956100,1820,11495
981,10,0,13,12,37701240,3622,18956100,1819,11505
982,3,0,6,19,37732620,3621,18956100,1818,11508
983,5,0,9,16,37742280,3622,18956100,1817,11513
984,3,0,9,16,37753620,3622,18956100,1817,11516
985,4,0,6,19,37778340,3622,18956100,1816,11520
986,8,0,9,16,37796880,3622,18956100,1815,11528
987,10,0,8,17,37826040,3621,18956100,1813,11538
988,7,0,9,16,37850880,3621,18956100,1812,11545
989,6,0,8,17,37867260,3620,18956100,1811,11551
990,8,0,10,15,37893300,3620,18956100,1809,11559
991,5,0,11,14,37902900,3620,18956100,1808,11564
992,8,0,11,14,37937040,3620,18956100,1807,11572
993,9,0,16,9,37947300,3620,18956100,1805,11581
994,10,0,17,8,37977840,3620,18956100,1804,11591
995,9,0,16,9,38042040,3623,18956100,1802,11600
996,12,0,15,10,38082720,3622,18956100,1800,11612
997,13,0,15,10,38137080,3623,18956100,1798,11625
998,16,0,14,11,38198520,3623,18956100,1795,11641
999,11,0,15,10,38224020,3622,18956100,1793,11652
1000,14,0,14,11,38271900,3621,18956100,1791,11666
1001,8,0,14,11,38301840,3621,18956100,1790,11674
1002,16,0,14,11,38351280,3620,18956100,1787,11690
1003,7,0,11,14,38384400,3620,18956100,1786,11697
1004,6,0,7,18,38430360,3621,18956100,1785,11703
1005,6,0,7,18,38444880,3620,18956100,1784,11709
1006,8,0,12,13,38452680,3620,18956100,1782,11717
1007,4,0,8,17,38487600,3620,18956100,1782,11721
1008,3,0,7,18,38505420,3621,18956100,1781,11724
1009,8,0,7,18,38527800,3620,18956100,1780,11732
1010,13,0,8,17,38546160,3618,18956100,1778,11745
1011,17,0,21,4,38557740,3618,18956100,1775,11762
1012,31,14,24,1,38605740,3617,18958260,1770,11793
1013,18,29,14,11,38670960,3619,18964200,1768,11811
1014,32,39,25,0,38734320,3622,19013820,1767,11843
1015,33,40,25,0,38776500,3621,19052160,1769,11876
1016,35,40,25,0,38863620,3622,19095300,1769,11911
1017,30,35,24,1,38955300,3623,19155000,1771,11941
1018,26,34,25,0,39022980,3620,19256280,1777,11967
1019,25,40,25,0,39094320,3622,19261080,1774,11992
1020,27,32,25,0,39185760,3618,19483140,1790,12019
1021,37,40,25,0,39265680,3619,19492140,1786,12056
1022,32,39,25,0,39322500,3619,19502460,1784,12088
1023,36,32,25,0,39437280,3618,19684800,1797,12124
1024,35,40,25,0,39491820,3617,19691580,1793,12159
1025,29,34,25,0,39578880,3619,19770960,1798,12188
1026,27,34,25,0,39663480,3618,19955220,1811,12215
1027,34,40,20,5,39727140,3617,19971840,1809,12249
1028,30,40,25,0,39802920,3618,20042160,1811,12279
1029,37,40,16,9,39859200,3618,20049840,1811,12316
1030,32,40,16,9,39905280,3618,20107740,1814,12348
1031,34,40,23,2,39973200,3619,20113740,1811,12382
1032,39,38,25,0,40046340,3620,20225820,1818,12421
1033,36,33,25,0,40140900,3618,20459400,1834,12457
1034,34,40,18,7,40196100,3617,20502000,1835,12491
1035,29,38,25,0,40246560,3617,20529000,1835,12520
1036,24,35,25,0,40330320,3616,20678460,1844,12544
1037,25,40,19,6,40419300,3618,20687280,1842,12569
1038,26,39,25,0,40476900,3619,20719620,1842,12595
1039,42,38,25,0,40565760,3618,20774700,1842,12637
1040,28,40,25,0,40635360,3618,20793060,1841,12665
1041,19,34,25,0,40716840,3618,20868060,1845,12684
1042,34,40,19,6,40779480,3619,20874540,1843,12718
1043,30,37,25,0,40854720,3621,20944200,1846,12748
1044,34,40,15,10,40933380,3622,20949240,1844,12782
1045,27,35,25,0,40981320,3622,21066060,1852,12809
1046,30,38,24,1,41042160,3622,21079080,1850,12839
1047,36,39,25,0,41122860,3624,21092220,1848,12875
1048,29,34,25,0,41217180,3622,21199440,1853,12904
1049,34,40,25,0,41280720,3622,21248580,1854,12938
1050,38,38,25,0,41344740,3622,21271500,1853,12976
1051,32,31,25,0,41439180,3618,21958980,1908,13008
1052,31,40,18,7,41510520,3618,21964080,1905,13039
1053,34,40,21,4,41552280,3620,21984960,1905,13073
1054,22,39,25,0,41608140,3622,22016220,1906,13095
1055,35,40,25,0,41709180,3624,22030620,1903,13130
1056,33,40,25,0,41782140,3624,22055760,1902,13163
1057,24,33,25,0,41879400,3623,22243380,1915,13187
1058,26,40,19,6,41947320,3623,22249620,1912,13213
1059,35,39,22,3,42013320,3624,22287060,1912,13248
1060,38,40,19,6,42082920,3623,22361520,1915,13286
1061,21,36,18,7,42139680,3624,22411980,1918,13307
1062,35,40,25,0,42183660,3625,22473420,1921,13342
1063,30,28,25,0,42288120,3623,23224020,1980,13372
1064,19,22,25,0,42368280,3622,24331980,2072,13391
1065,25,10,25,0,42450540,3617,25528800,2169,13416
1066,26,28,22,3,42501360,3618,25531560,2166,13442
1067,25,40,13,12,42581040,3621,25539060,2162,13467
1068,26,40,20,5,42609300,3622,25579980,2164,13493
1069,29,40,25,0,42682260,3626,25647720,2167,13522
1070,30,38,25,0,42764040,3626,25732140,2170,13552
1071,40,40,25,0,42845160,3628,25777560,2171,13592
1072,32,39,25,0,42931620,3629,25833240,2172,13624
1073,34,40,16,9,42977040,3630,25837440,2172,13658
1074,28,39,24,1,43054200,3631,25896060,2172,13686
1075,32,40,25,0,43116300,3632,25901520,2170,13718
1076,35,40,25,0,43204560,3632,25954800,2170,13753
1077,26,40,25,0,43272600,3632,26001300,2170,13779
1078,29,39,25,0,43362840,3632,26137020,2177,13808
1079,23,39,25,0,43442880,3633,26144940,2175,13831
1080,21,38,25,0,43515720,3633,26177760,2174,13852
1081,29,39,25,0,43586820,3634,26206740,2173,13881
1082,26,24,25,0,43682220,3630,27327420,2261,13907
1083,32,40,21,4,43748580,3630,27429840,2265,13939
1084,29,40,23,2,43818180,3632,27450180,2264,13968
1085,31,36,25,0,43893180,3632,27552180,2269,13999
1086,22,29,25,0,43981020,3631,27775860,2283,14021
1087,25,39,25,0,44040780,3631,27784020,2280,14046
1088,35,40,25,0,44128680,3634,27802020,2277,14081
1089,36,40,25,0,44199900,3635,27825540,2276,14117
1090,34,40,25,0,44281380,3634,27936000,2281,14151
1091,26,37,25,0,44374920,3635,27977880,2280,14177
1092,35,40,25,0,44454000,3634,28056720,2282,14212
1093,27,40,25,0,44524200,3635,28074240,2280,14239
1094,30,40,25,0,44610600,3635,28109100,2278,14269
1095,29,40,25,0,44674920,3635,28133580,2277,14298
1096,27,39,23,2,44751480,3635,28174380,2277,14325
1097,32,40,21,4,44817420,3637,28180140,2276,14357
1098,24,36,25,0,44899500,3637,28315500,2282,14381
1099,31,39,22,3,44964180,3638,28324500,2280,14412
1100,33,39,25,0,45037440,3639,28398960,2282,14445
1101,29,40,24,1,45102480,3638,28406580,2280,14474
1102,38,38,25,0,45205560,3639,28465860,2280,14512
1103,25,37,25,0,45288660,3638,28710000,2295,14537
1104,39,40,25,0,45336300,3638,28767240,2296,14576
1105,26,24,25,0,45455340,3637,29712240,2368,14602
1106,32,34,25,0,45516600,3635,29858220,2373,14634
1107,31,40,25,0,45606300,3637,29881080,2371,14665
1108,30,34,25,0,45694680,3636,30201540,2392,14695
1109,45,40,25,0,45746160,3634,30259740,2391,14740
1110,49,40,25,0,45836820,3634,30338820,2393,14789
1111,30,37,25,0,45902340,3633,30387180,2394,14819
1112,32,40,25,0,45987360,3635,30427860,2393,14851
1113,29,40,21,4,46053000,3635,30452640,2392,14880
1114,23,34,25,0,46155840,3637,30559740,2397,14903
1115,33,38,25,0,46239480,3636,30597420,2394,14936
1116,24,38,25,0,46295700,3635,30631440,2393,14960
1117,29,36,25,0,46376160,3634,30699480,2394,14989
1118,29,40,25,0,46460400,3634,30775380,2395,15018
1119,33,36,23,2,46516680,3633,30805320,2395,15051
1120,34,38,25,0,46610340,3634,30816960,2391,15085
1121,27,19,25,0,46698540,3628,32447040,2512,15112
1122,29,37,20,5,46753080,3628,32450340,2509,15141
1123,37,40,17,8,46809840,3630,32460480,2506,15178
1124,37,39,25,0,46873860,3631,32520840,2507,15215
1125,26,34,25,0,46957860,3632,32579760,2509,15241
1126,31,38,25,0,47051460,3633,32667540,2510,15272
1127,35,40,25,0,47126580,3631,32679120,2506,15307
1128,40,38,24,1,47193360,3632,32749860,2508,15347
1129,28,33,25,0,47266740,3631,32876640,2514,15375
1130,28,38,25,0,47335740,3631,32899080,2512,15403
1131,31,40,25,0,47408760,3632,32955480,2512,15434
1132,20,39,25,0,47494800,3633,32986500,2511,15454
1133,32,39,25,0,47566260,3632,33022140,2510,15486
1134,34,35,25,0,47648760,3633,33098040,2512,15520
1135,30,35,25,0,47735340,3634,33108840,2509,15550
1136,29,40,25,0,47769360,3633,33116340,2506,15579
1137,25,30,25,0,47891880,3634,33522960,2533,15604
1138,28,40,23,2,47932440,3632,33806160,2550,15632
1139,26,39,13,12,48014580,3635,33814500,2550,15658
1140,30,35,23,2,48072600,3637,33859140,2550,15688
1141,29,40,24,1,48100860,3637,33864900,2548,15717
1142,39,40,25,0,48208320,3639,33895740,2546,15756
1143,30,35,25,0,48284400,3636,34285740,2570,15786
1144,34,38,25,0,48353280,3637,34311720,2569,15820
1145,34,37,25,0,48449100,3634,34417140,2570,15854
1146,27,40,25,0,48513000,3635,34429620,2568,15881
1147,32,40,25,0,48578940,3636,34461300,2567,15913
1148,29,40,25,0,48661380,3636,34511880,2566,15942
1149,32,39,25,0,48756660,3635,34551960,2564,15974
1150,29,35,25,0,48847260,3634,34635780,2566,16003
1151,30,40,25,0,48915480,3634,34647840,2562,16033
1152,30,32,25,0,49004640,3634,34797780,2569,16063
1153,33,39,25,0,49068060,3633,35155680,2590,16096
1154,30,38,25,0,49142940,3634,35173740,2589,16126
1155,31,40,25,0,49211940,3635,35212500,2588,16157
1156,31,40,25,0,49309560,3635,35290740,2590,16188
1157,30,40,19,6,49390920,3634,35355660,2590,16218
1158,36,40,19,6,49434540,3635,35369100,2590,16254
1159,28,34,25,0,49515360,3635,35612640,2603,16282
1160,43,40,25,0,49574340,3633,35708640,2605,16325
1161,29,40,22,3,49635300,3634,35772300,2607,16354
1162,36,40,25,0,49736820,3635,35838240,2607,16390
1163,29,40,23,2,49794720,3635,35843700,2605,16419
1164,31,34,24,1,49908240,3637,35950680,2608,16450
1165,24,33,25,0,49958940,3634,36305160,2630,16474
1166,34,40,24,1,50026080,3635,36314160,2627,16508
1167,34,38,25,0,50109780,3637,36335280,2625,16542
1168,23,23,25,0,50208720,3634,37652580,2716,16565
1169,20,0,24,1,50294220,3629,39780240,2865,16585
1170,24,1,25,0,50355480,3628,39780300,2861,16609
1171,28,4,25,0,50430720,3627,39784260,2855,16637
1172,31,15,25,0,50508480,3627,39792060,2850,16668
1173,26,29,24,1,50571300,3628,39802740,2845,16694
1174,31,40,16,9,50643720,3630,39811140,2842,16725
1175,18,37,25,0,50699040,3632,39849120,2842,16743
1176,16,36,25,0,50770020,3633,39891180,2842,16759
1177,9,27,25,0,50845560,3634,40041840,2851,16768
1178,11,0,15,10,50956800,3629,40468380,2879,16779
1179,4,0,8,17,50996340,3629,40468380,2878,16783
1180,6,0,7,18,51017880,3629,40468380,2877,16789
1181,7,0,8,17,51039840,3629,40468380,2876,16796
1182,9,0,13,12,51050940,3629,40468380,2874,16805
1183,5,0,9,16,51080580,3628,40468380,2873,16810
1184,6,0,8,17,51101100,3628,40468380,2871,16816
1185,5,0,9,16,51124860,3629,40468380,2870,16821
1186,6,0,9,16,51148560,3629,40468380,2869,16827
1187,14,0,14,11,51177120,3629,40468380,2866,16841
1188,13,0,16,9,51210960,3628,40468380,2864,16854
1189,6,0,9,16,51245220,3627,40468380,2862,16860
1190,12,0,16,9,51263460,3627,40468380,2860,16872
1191,12,0,19,6,51295860,3627,40468380,2858,16884
1192,15,0,18,7,51356220,3627,40468380,2855,16899
1193,8,0,11,14,51405180,3627,40468380,2853,16907
1194,10,0,13,12,51440520,3627,40468380,2851,16917
1195,7,0,12,13,51471540,3628,40468380,2850,16924
1196,5,0,11,14,51494220,3628,40468380,2849,16929
1197,4,0,10,15,51526920,3629,40468380,2848,16933
1198,6,0,7,18,51559440,3629,40468380,2847,16939
1199,6,0,8,17,51578160,3629,40468380,2845,16945
1200,8,0,8,17,51603780,3628,40468380,2844,16953
1201,4,0,6,19,51618300,3628,40468380,2843,16957
1202,4,0,7,18,51631920,3628,40468380,2842,16961
1203,7,0,8,17,51643080,3627,40468380,2841,16968
1204,8,0,10,15,51658320,3627,40468380,2839,16976
1205,5,0,8,17,51690540,3627,40468380,2838,16981
1206,10,0,10,15,51714300,3627,40468380,2836,16991
1207,2,0,6,19,51726540,3626,40468380,2836,16993
1208,9,0,10,15,51740820,3626,40468380,2834,17002
1209,4,0,8,17,51760380,3626,40468380,2833,17006
1210,10,0,10,15,51784200,3626,40468380,2831,17016
1211,7,0,12,13,51797400,3625,40468380,2830,17023
1212,10,0,17,8,51812940,3625,40468380,2828,17033
1213,8,0,14,11,51875460,3627,40468380,2826,17041
1214,10,0,11,14,51914340,3626,40468380,2824,17051
1215,10,0,13,12,51944700,3626,40468380,2822,17061
1216,10,0,15,10,51981360,3627,40468380,2820,17071
1217,10,0,18,7,51998160,3626,40468380,2818,17081
1218,7,0,16,9,52051140,3628,40468380,2817,17088
1219,9,0,12,13,52103280,3628,40468380,2815,17097
1220,6,0,10,15,52137120,3628,40468380,2814,17103
1221,4,0,8,17,52160160,3628,40468380,2813,17107
1222,7,0,11,14,52177380,3628,40468380,2812,17114
1223,5,0,7,18,52208160,3628,40468380,2811,17119
1224,7,0,11,14,52221900,3629,40468380,2810,17126
1225,5,0,12,13,52245060,3629,40468380,2809,17131
1226,10,0,9,16,52294680,3629,40468380,2807,17141
1227,5,0,11,14,52298580,3629,40468380,2806,17146
1228,5,0,8,17,52334160,3629,40468380,2805,17151
1229,4,0,8,17,52349520,3629,40468380,2804,17155
1230,5,0,9,16,52359300,3629,40468380,2803,17160
1231,6,0,10,15,52386420,3630,40468380,2802,17166
1232,9,0,12,13,52403160,3629,40468380,2800,17175
1233,12,0,15,10,52425960,3628,40468380,2798,17187
1234,7,0,10,15,52475340,3629,40468380,2796,17194
1235,13,0,15,10,52506000,3629,40468380,2794,17207
1236,14,0,20,5,52536720,3629,40468380,2791,17221
1237,12,0,14,11,52595100,3628,40468380,2789,17233
1238,5,0,7,18,52646220,3629,40468380,2788,17238
1239,11,0,16,9,52658220,3629,40468380,2786,17249
1240,6,0,12,13,52693440,3629,40468380,2785,17255
1241,13,0,13,12,52749300,3630,40468380,2782,17268
1242,7,0,11,14,52780380,3630,40468380,2781,17275
1243,4,0,6,19,52809900,3630,40468380,2780,17279
1244,5,0,9,16,52816560,3630,40468380,2779,17284
1245,6,0,9,16,52833000,3629,40468380,2778,17290
1246,4,0,6,19,52860600,3629,40468380,2777,17294
1247,10,0,12,13,52873740,3629,40468380,2775,17304
1248,3,0,8,17,52900380,3629,40468380,2775,17307
1249,4,0,6,19,52922880,3629,40468380,2774,17311
1250,7,0,9,16,52937220,3629,40468380,2773,17318
1251,8,0,7,18,52961340,3628,40468380,2771,17326
1252,6,0,6,19,52980360,3628,40468380,2770,17332
1253,10,0,12,13,52986060,3627,40468380,2768,17342
1254,4,0,8,17,53009880,3627,40468380,2767,17346
1255,10,0,10,15,53042580,3627,40468380,2765,17356
1256,10,0,12,13,53065200,3627,40468380,2764,17366
1257,7,0,9,16,53104140,3627,40468380,2762,17373
1258,13,0,11,14,53134560,3626,40468380,2760,17386
1259,14,0,14,11,53165340,3626,40468380,2757,17400
1260,7,0,13,12,53194740,3626,40468380,2756,17407
1261,10,0,12,13,53244480,3627,40468380,2754,17417
1262,9,0,15,10,53262360,3626,40468380,2752,17426
1263,11,0,18,7,53294820,3626,40468380,2750,17437
1264,6,0,13,12,53348220,3627,40468380,2749,17443
1265,11,0,16,9,53371620,3627,40468380,2747,17454
1266,12,0,16,9,53412120,3627,40468380,2745,17466
1267,11,0,17,8,53460900,3628,40468380,2743,17477
1268,12,0,17,8,53515680,3628,40468380,2741,17489
1269,6,0,10,15,53555580,3628,40468380,2739,17495
1270,6,0,11,14,53577960,3628,40468380,2738,17501
1271,7,0,10,15,53607420,3628,40468380,2737,17508
1272,7,0,10,15,53636760,3629,40468380,2736,17515
1273,4,0,11,14,53647380,3628,40468380,2735,17519
1274,4,0,8,17,53675280,3629,40468380,2734,17523
1275,10,0,13,12,53698680,3629,40468380,2732,17533
1276,6,0,10,15,53723280,3628,40468380,2731,17539
1277,9,0,10,15,53754480,3628,40468380,2730,17548
1278,12,0,19,6,53767380,3629,40468380,2727,17560
1279,6,0,17,8,53800980,3629,40468380,2726,17566
1280,5,0,10,15,53867820,3630,40468380,2725,17571
1281,12,0,13,12,53899500,3630,40468380,2723,17583
1282,9,0,10,15,53933640,3630,40468380,2722,17592
1283,9,0,12,13,53947740,3629,40468380,2720,17601
1284,15,0,15,10,53992500,3629,40468380,2717,17616
1285,21,1,25,0,54012480,3628,40468380,2713,17637
1286,7,0,9,16,54104160,3628,40469340,2712,17644
1287,9,0,12,13,54122160,3628,40469340,2710,17653
1288,7,0,12,13,54156480,3629,40469340,2709,17660
1289,13,0,16,9,54192540,3629,40469340,2707,17673
1290,10,0,15,10,54235140,3629,40469340,2705,17683
1291,9,0,12,13,54275160,3629,40469340,2703,17692
1292,8,0,9,16,54329700,3630,40469340,2702,17700
1293,8,0,9,16,54353460,3629,40469340,2701,17708
1294,3,0,6,19,54380760,3630,40469340,2700,17711
1295,4,0,6,19,54387060,3629,40469340,2699,17715
1296,6,0,9,16,54398100,3629,40469340,2698,17721
1297,7,0,11,14,54412680,3629,40469340,2697,17728
1298,2,0,7,18,54432600,3629,40469340,2697,17730
1299,5,0,10,15,54436020,3629,40469340,2696,17735
1300,2,0,5,20,54466140,3629,40469340,2695,17737
1301,8,0,10,15,54473640,3629,40469340,2694,17745
1302,10,0,15,10,54483060,3628,40469340,2692,17755
1303,7,0,9,16,54526320,3628,40469340,2691,17762
1304,8,0,9,16,54558540,3628,40469340,2689,17770
1305,6,0,7,18,54577920,3627,40469340,2688,17776
1306,10,0,10,15,54600120,3627,40469340,2687,17786
1307,15,0,15,10,54622440,3626,40469340,2684,17801
1308,9,0,16,9,54654480,3626,40469340,2682,17810
1309,7,0,13,12,54697020,3627,40469340,2681,17817
1310,13,0,15,10,54741900,3627,40469340,2679,17830
1311,11,0,15,10,54775080,3627,40469340,2677,17841
1312,5,0,9,16,54833100,3628,40469340,2676,17846
1313,8,0,6,19,54874140,3628,40469340,2674,17854
1314,13,0,12,13,54889620,3627,40469340,2672,17867
1315,11,0,13,12,54915660,3627,40469340,2670,17878
1316,5,0,11,14,54940680,3627,40469340,2669,17883
1317,4,0,7,18,54980340,3627,40469340,2669,17887
1318,8,0,9,16,54996060,3627,40469340,2667,17895
1319,8,0,8,17,55011540,3626,40469340,2666,17903
1320,3,0,9,16,55022040,3626,40469340,2665,17906
1321,5,0,7,18,55051440,3626,40469340,2664,17911
1322,5,0,5,20,55068000,3626,40469340,2664,17916
1323,4,0,5,20,55076280,3625,40469340,2663,17920
1324,5,0,7,18,55088700,3625,40469340,2662,17925
1325,7,0,12,13,55092660,3625,40469340,2661,17932
1326,3,0,6,19,55133340,3626,40469340,2660,17935
1327,10,0,7,18,55149120,3625,40469340,2658,17945
1328,8,0,10,15,55160520,3624,40469340,2657,17953
1329,7,0,10,15,55184400,3624,40469340,2656,17960
1330,5,0,11,14,55196400,3624,40469340,2655,17965
1331,16,0,15,10,55231500,3623,40469340,2652,17981
1332,16,0,15,10,55276920,3623,40469340,2649,17997
1333,15,0,15,10,55318800,3622,40469340,2647,18012
1334,7,0,12,13,55360560,3622,40469340,2646,18019
1335,8,0,11,14,55399380,3623,40469340,2644,18027
1336,10,0,12,13,55418340,3622,40469340,2642,18037
1337,13,0,15,10,55455780,3622,40469340,2640,18050
1338,7,0,14,11,55486680,3622,40469340,2639,18057
1339,17,0,18,7,55525020,3621,40469340,2636,18074
1340,7,0,11,14,55576320,3621,40469340,2635,18081
1341,7,0,9,16,55616280,3622,40469340,2634,18088
1342,3,0,5,20,55646520,3622,40469340,2633,18091
1343,10,0,10,15,55656000,3622,40469340,2631,18101
1344,5,0,8,17,55671600,3621,40469340,2631,18106
1345,10,0,16,9,55673580,3621,40469340,2629,18116
1346,2,0,11,14,55701900,3621,40469340,2629,18118
1347,4,0,8,17,55726980,3621,40469340,2628,18122
1348,2,0,8,17,55733880,3621,40469340,2628,18124
1349,8,0,14,11,55737000,3620,40469340,2626,18132
1350,6,0,12,13,55757820,3620,40469340,2625,18138
1351,7,0,13,12,55782060,3620,40469340,2624,18145
1352,5,0,13,12,55797000,3620,40469340,2623,18150
1353,13,0,18,7,55827120,3620,40469340,2621,18163
1354,7,0,13,12,55866180,3620,40469340,2620,18170
1355,5,0,13,12,55885140,3620,40469340,2619,18175
1356,7,0,14,11,55906380,3620,40469340,2618,18182
1357,11,0,12,13,55935540,3619,40469340,2616,18193
1358,8,0,12,13,55953120,3618,40469340,2614,18201
1359,9,0,13,12,55968360,3617,40469340,2613,18210
1360,11,0,17,8,55987320,3616,40469340,2611,18221
1361,11,0,16,9,56035080,3617,40469340,2609,18232
1362,11,0,18,7,56063040,3616,40469340,2607,18243
1363,8,0,15,10,56102580,3616,40469340,2606,18251
1364,7,0,13,12,56146500,3617,40469340,2605,18258
1365,5,0,12,13,56170920,3617,40469340,2604,18263
1366,7,0,13,12,56188800,3617,40469340,2603,18270
1367,6,0,15,10,56200680,3617,40469340,2602,18276
1368,5,0,14,11,56220780,3617,40469340,2601,18281
1369,3,0,12,13,56243100,3617,40469340,2601,18284
1370,6,0,15,10,56261400,3618,40469340,2600,18290
1371,3,0,11,14,56290260,3618,40469340,2599,18293
1372,11,0,14,11,56313000,3617,40469340,2597,18304
1373,9,0,17,8,56332800,3617,40469340,2596,18313
1374,8,0,15,10,56362500,3617,40469340,2594,18321
1375,8,0,15,10,56401620,3618,40469340,2593,18329
1376,11,0,14,11,56448240,3618,40469340,2591,18340
1377,6,0,11,14,56468760,3617,40469340,2590,18346
1378,9,0,18,7,56476740,3617,40469340,2589,18355
1379,8,0,19,6,56505360,3617,40469340,2587,18363
1380,9,0,14,11,56565780,3618,40469340,2586,18372
1381,11,0,18,7,56590320,3618,40469340,2584,18383
1382,10,0,16,9,56637900,3618,40469340,2582,18393
1383,14,0,17,8,56686740,3618,40469340,2580,18407
1384,10,0,19,6,56725440,3619,40469340,2578,18417
1385,4,0,14,11,56774280,3620,40469340,2578,18421
1386,6,0,13,12,56792700,3619,40469340,2577,18427
1387,7,0,15,10,56815680,3620,40469340,2576,18434
1388,6,0,14,11,56858280,3621,40469340,2575,18440
1389,8,0,12,13,56886660,3620,40469340,2573,18448
1390,8,0,17,8,56896140,3620,40469340,2572,18456
1391,9,0,14,11,56931060,3620,40469340,2571,18465
1392,3,0,12,13,56960460,3620,40469340,2570,18468
1393,4,0,13,12,56972580,3620,40469340,2569,18472
1394,3,0,13,12,56991600,3621,40469340,2569,18475
1395,5,0,13,12,57002460,3621,40469340,2568,18480
1396,8,0,12,13,57037320,3621,40469340,2567,18488
1397,8,0,13,12,57053220,3620,40469340,2566,18496
1398,8,0,12,13,57083400,3620,40469340,2564,18504
1399,6,0,11,14,57106440,3620,40469340,2563,18510
1400,8,0,13,12,57122940,3619,40469340,2562,18518
1401,9,0,16,9,57146040,3620,40469340,2561,18527
1402,11,0,17,8,57182160,3620,40469340,2559,18538
1403,11,0,17,8,57212100,3619,40469340,2557,18549
1404,14,0,19,6,57256080,3619,40469340,2555,18563
1405,21,2,25,0,57300180,3619,40472760,2552,18584
1406,13,0,17,8,57364620,3618,40475100,2550,18597
1407,10,0,16,9,57400260,3617,40475100,2548,18607
1408,9,0,13,12,57428940,3616,40475100,2547,18616
1409,5,0,11,14,57464700,3617,40475100,2546,18621
1410,5,0,12,13,57483540,3617,40475100,2545,18626
1411,5,0,13,12,57497700,3617,40475100,2544,18631
1412,3,0,9,16,57515400,3617,40475100,2544,18634
1413,4,0,11,14,57527100,3617,40475100,2543,18638
1414,12,0,20,5,57532680,3617,40475100,2541,18650
1415,6,0,19,6,57560100,3617,40475100,2540,18656
1416,6,0,16,9,57604620,3618,40475100,2539,18662
1417,5,0,13,12,57646860,3618,40475100,2538,18667
1418,4,0,11,14,57671040,3619,40475100,2538,18671
1419,6,0,11,14,57693480,3619,40475100,2537,18677
1420,6,0,11,14,57711000,3618,40475100,2536,18683
1421,4,0,11,14,57725280,3618,40475100,2535,18687
1422,9,0,12,13,57746880,3618,40475100,2534,18696
1423,13,0,15,10,57770220,3617,40475100,2532,18709
1424,11,0,19,6,57789780,3617,40475100,2530,18720
1425,15,0,22,3,57819720,3616,40475100,2528,18735
1426,8,0,15,10,57875760,3616,40475100,2526,18743
1427,9,0,18,7,57897480,3616,40475100,2525,18752
1428,9,0,18,7,57935220,3616,40475100,2524,18761
1429,14,0,20,5,57977280,3616,40475100,2521,18775
1430,9,0,20,5,58020180,3617,40475100,2520,18784
1431,8,0,16,9,58070820,3617,40475100,2519,18792
1432,9,0,14,11,58114980,3618,40475100,2517,18801
1433,8,0,15,10,58137240,3617,40475100,2516,18809
1434,11,0,17,8,58166820,3617,40475100,2514,18820
1435,9,0,18,7,58195140,3617,40475100,2513,18829
1436,9,0,17,8,58224420,3617,40475100,2511,18838
1437,6,0,17,8,58255920,3617,40475100,2511,18844
1438,7,0,17,8,58291560,3618,40475100,2509,18851
1439,3,0,15,10,58313100,3618,40475100,2509,18854
1440,4,0,11,14,58355520,3619,40475100,2508,18858
1441,11,0,14,11,58380480,3619,40475100,2507,18869
1442,4,0,11,14,58399140,3618,40475100,2506,18873
1443,8,0,15,10,58416540,3619,40475100,2505,18881
1444,5,0,12,13,58435260,3618,40475100,2504,18886
1445,11,0,12,13,58467120,3618,40475100,2502,18897
1446,8,0,17,8,58474620,3617,40475100,2501,18905
1447,10,0,15,10,58520760,3617,40475100,2500,18915
1448,7,0,15,10,58548720,3618,40475100,2498,18922
1449,9,0,17,8,58583040,3618,40475100,2497,18931
1450,9,0,14,11,58617780,3618,40475100,2496,18940
1451,7,0,13,12,58641060,3617,40475100,2495,18947
1452,11,0,16,9,58672560,3617,40475100,2493,18958
1453,10,0,19,6,58690980,3617,40475100,2491,18968
1454,7,0,16,9,58736100,3618,40475100,2490,18975
1455,14,0,16,9,58774020,3617,40475100,2488,18989
1456,13,0,15,10,58818120,3616,40475100,2486,19002
1457,10,0,16,9,58846740,3616,40475100,2485,19012
1458,5,0,10,15,58884240,3616,40475100,2484,19017
1459,5,0,13,12,58890420,3616,40475100,2483,19022
1460,12,0,18,7,58905600,3615,40475100,2481,19034
1461,3,0,14,11,58939680,3616,40475100,2481,19037
1462,8,0,17,8,58964580,3616,40475100,2480,19045
1463,4,0,14,11,58999020,3617,40475100,2479,19049
1464,7,0,16,9,59028540,3618,40475100,2478,19056
1465,3,0,14,11,59058540,3618,40475100,2477,19059
1466,5,0,12,13,59097000,3619,40475100,2477,19064
1467,9,0,17,8,59102460,3619,40475100,2475,19073
1468,6,0,14,11,59145240,3619,40475100,2474,19079
1469,7,0,14,11,59174160,3619,40475100,2473,19086
1470,3,0,13,12,59184960,3619,40475100,2473,19089
1471,13,0,19,6,59215500,3619,40475100,2471,19102
1472,12,0,22,3,59241720,3619,40475100,2469,19114
1473,9,0,20,5,59291580,3620,40475100,2468,19123
1474,14,0,16,9,59355900,3620,40475100,2466,19137
1475,7,0,12,13,59390040,3619,40475100,2465,19144
1476,7,0,12,13,59412900,3619,40475100,2464,19151
1477,9,0,15,10,59429700,3619,40475100,2462,19160
1478,15,0,21,4,59455560,3618,40475100,2460,19175
1479,11,0,17,8,59497860,3618,40475100,2458,19186
1480,8,0,17,8,59530740,3618,40475100,2457,19194
1481,13,0,19,6,59572260,3618,40475100,2455,19207
1482,14,0,20,5,59621220,3618,40475640,2453,19221
1483,9,0,19,6,59662080,3618,40475640,2452,19230
1484,7,0,20,5,59695320,3619,40475640,2451,19237
1485,6,0,14,11,59748180,3620,40475640,2450,19243
1486,1,0,8,17,59795880,3621,40475640,2450,19244
1487,6,0,10,15,59800320,3620,40475640,2449,19250
1488,5,0,13,12,59810280,3621,40475640,2448,19255
1489,3,0,11,14,59830860,3621,40475640,2448,19258
1490,5,0,11,14,59847780,3621,40475640,2447,19263
1491,4,0,13,12,59858880,3621,40475640,2446,19267
1492,4,0,14,11,59868780,3621,40475640,2446,19271
1493,5,0,12,13,59905140,3622,40475640,2445,19276
1494,12,0,13,12,59924580,3620,40475640,2443,19288
1495,10,0,16,9,59938380,3620,40475640,2442,19298
1496,10,0,15,10,59981820,3620,40475640,2440,19308
1497,2,0,10,15,60011040,3620,40475640,2440,19310
1498,10,0,15,10,60025620,3620,40475640,2439,19320
1499,12,0,19,6,60050520,3620,40475640,2437,19332
1500,13,0,22,3,60084180,3619,40475640,2435,19345
1501,5,0,14,11,60138060,3620,40475640,2434,19350
1502,17,0,25,0,60159960,3620,40475640,2432,19367
1503,10,0,18,7,60227220,3620,40475640,2430,19377
1504,8,0,11,14,60275640,3620,40475640,2429,19385
1505,9,0,14,11,60292320,3620,40475640,2428,19394
1506,6,0,13,12,60323760,3620,40475640,2427,19400
1507,9,0,14,11,60349320,3620,40475640,2426,19409
1508,6,0,12,13,60370140,3619,40475640,2425,19415
1509,7,0,12,13,60388080,3619,40475640,2424,19422
1510,10,0,15,10,60409020,3619,40475640,2422,19432
1511,3,0,13,12,60433020,3619,40475640,2422,19435
1512,9,0,12,13,60462660,3619,40475640,2420,19444
1513,4,0,10,15,60482580,3618,40475640,2420,19448
1514,5,0,11,14,60497760,3618,40475640,2419,19453
1515,3,0,11,14,60501660,3618,40475640,2419,19456
1516,8,0,12,13,60529200,3618,40475640,2418,19464
1517,4,0,10,15,60540240,3618,40475640,2417,19468
1518,7,0,13,12,60560880,3618,40475640,2416,19475
1519,11,0,19,6,60576240,3618,40475640,2414,19486
1520,7,0,11,14,60630000,3618,40475640,2413,19493
1521,8,0,16,9,60635760,3617,40475640,2412,19501
1522,10,0,20,5,60655860,3617,40475640,2411,19511
1523,12,0,22,3,60704880,3618,40475640,2409,19523
1524,7,0,15,10,60751260,3618,40475640,2408,19530
1525,10,0,16,9,60786540,3618,40475640,2407,19540
1526,8,0,17,8,60803760,3617,40475640,2405,19548
1527,16,0,21,4,60843240,3617,40475640,2403,19564
1528,12,1,25,0,60861000,3617,40475640,2402,19576
1529,9,0,14,11,60958980,3618,40475940,2400,19585
1530,4,0,13,12,60975360,3618,40475940,2400,19589
1531,11,0,18,7,60999960,3618,40475940,2398,19600
1532,11,0,16,9,61038540,3618,40475940,2397,19611
1533,10,0,16,9,61081500,3618,40475940,2395,19621
1534,5,0,16,9,61098420,3618,40475940,2394,19626
1535,6,0,13,12,61133100,3618,40475940,2394,19632
1536,2,0,10,15,61154880,3618,40475940,2393,19634
1537,3,0,10,15,61165440,3618,40475940,2393,19637
1538,3,0,10,15,61173240,3618,40475940,2392,19640
1539,6,0,13,12,61184760,3618,40475940,2392,19646
1540,4,0,12,13,61198740,3618,40475940,2391,19650
1541,5,0,11,14,61214160,3618,40475940,2390,19655
1542,8,0,13,12,61237800,3618,40475940,2389,19663
1543,5,0,14,11,61251660,3618,40475940,2388,19668
1544,13,0,18,7,61280820,3617,40475940,2387,19681
1545,14,0,22,3,61312500,3617,40475940,2385,19695
1546,9,0,16,9,61383300,3618,40475940,2383,19704
1547,11,0,19,6,61411140,3618,40475940,2382,19715
1548,7,0,17,8,61454940,3619,40475940,2381,19722
1549,11,0,17,8,61489740,3618,40475940,2379,19733
1550,16,0,20,5,61540560,3619,40475940,2377,19749
1551,11,0,17,8,61580160,3618,40475940,2376,19760
1552,4,0,12,13,61623360,3619,40475940,2375,19764
1553,7,0,17,8,61633560,3619,40475940,2374,19771
1554,12,0,19,6,61672440,3619,40475940,2372,19783
1555,9,0,15,10,61718160,3619,40475940,2371,19792
1556,13,0,19,6,61749420,3619,40475940,2369,19805
1557,6,0,16,9,61787760,3619,40475940,2368,19811
1558,9,0,19,6,61821780,3620,40475940,2367,19820
1559,2,0,11,14,61863600,3620,40475940,2367,19822
1560,3,0,9,16,61889160,3621,40475940,2367,19825
1561,2,0,8,17,61896540,3620,40475940,2366,19827
1562,5,0,10,15,61901340,3620,40475940,2366,19832
1563,4,0,13,12,61902060,3620,40475940,2365,19836
1564,7,0,14,11,61923840,3620,40475940,2364,19843
1565,3,0,12,13,61939500,3620,40475940,2364,19846
1566,6,0,14,11,61958400,3620,40475940,2363,19852
1567,11,0,16,9,61978080,3619,40475940,2361,19863
1568,5,0,14,11,62006100,3619,40475940,2361,19868
1569,7,0,18,7,62019960,3620,40475940,2360,19875
1570,9,0,20,5,62063220,3621,40475940,2358,19884
1571,9,0,19,6,62096340,3620,40475940,2357,19893
1572,6,0,13,12,62144580,3621,40475940,2356,19899
1573,18,0,25,0,62154060,3620,40475940,2354,19917
1574,9,0,20,5,62206740,3620,40475940,2353,19926
1575,5,0,11,14,62275200,3621,40475940,2352,19931
1576,16,0,20,5,62287620,3620,40475940,2350,19947
1577,12,0,13,12,62337360,3619,40475940,2348,19959
1578,10,0,15,10,62356080,3619,40475940,2347,19969
1579,13,0,22,3,62381040,3619,40475940,2345,19982
1580,5,0,19,6,62406660,3619,40475940,2344,19987
1581,8,0,18,7,62449380,3619,40475940,2343,19995
1582,6,0,14,11,62497860,3620,40475940,2342,20001
1583,6,0,13,12,62524680,3620,40475940,2342,20007
1584,8,0,15,10,62544060,3620,40475940,2341,20015
1585,9,0,18,7,62564760,3620,40475940,2339,20024
1586,4,0,15,10,62596020,3620,40475940,2339,20028
1587,6,0,14,11,62632920,3621,40475940,2338,20034
1588,3,0,12,13,62651880,3621,40475940,2338,20037
1589,11,0,16,9,62685120,3621,40475940,2336,20048
1590,3,0,13,12,62703120,3621,40475940,2336,20051
1591,10,0,13,12,62741940,3621,40475940,2334,20061
1592,6,0,11,14,62762940,3621,40475940,2333,20067
1593,9,0,14,11,62781660,3621,40475940,2332,20076
1594,12,0,20,5,62795400,3620,40475940,2331,20088
1595,15,0,22,3,62829840,3620,40475940,2329,20103
1596,14,0,21,4,62879160,3619,40475940,2327,20117
1597,11,0,21,4,62922960,3620,40475940,2325,20128
1598,9,0,16,9,62977800,3620,40475940,2324,20137
1599,9,0,13,12,63014280,3619,40475940,2323,20146
1600,12,0,18,7,63036540,3619,40475940,2321,20158
1601,8,0,16,9,63067020,3619,40475940,2320,20166
1602,9,0,18,7,63099060,3619,40475940,2319,20175
1603,5,0,15,10,63122820,3619,40475940,2318,20180
1604,6,0,13,12,63167640,3620,40475940,2318,20186
1605,7,0,17,8,63184200,3620,40475940,2317,20193
1606,8,0,15,10,63212460,3620,40475940,2316,20201
1607,8,0,16,9,63241620,3620,40475940,2315,20209
1608,11,0,21,4,63275940,3621,40475940,2313,20220
1609,4,0,11,14,63333300,3621,40475940,2313,20224
1610,9,0,15,10,63348480,3621,40475940,2311,20233
1611,11,0,21,4,63369540,3621,40475940,2310,20244
1612,11,0,18,7,63414120,3621,40475940,2308,20255
1613,6,0,17,8,63453780,3621,40475940,2308,20261
1614,6,0,16,9,63478980,3621,40475940,2307,20267
1615,10,0,17,8,63531360,3623,40475940,2306,20277
1616,4,0,13,12,63556560,3622,40475940,2305,20281
1617,4,0,12,13,63582660,3623,40475940,2305,20285
1618,6,0,14,11,63609300,3624,40475940,2304,20291
1619,9,0,18,7,63621060,3623,40475940,2303,20300
1620,18,0,22,3,63670800,3623,40475940,2300,20318
1621,13,0,23,2,63711240,3623,40475940,2298,20331
1622,8,0,18,7,63759660,3623,40475940,2297,20339
1623,9,0,18,7,63810420,3624,40475940,2296,20348
1624,10,0,15,10,63852240,3624,40475940,2295,20358
1625,10,0,15,10,63892560,3624,40475940,2294,20368
1626,8,0,12,13,63918540,3623,40475940,2293,20376
1627,7,0,13,12,63932700,3623,40475940,2292,20383
1628,4,0,10,15,63951060,3622,40475940,2291,20387
1629,10,0,14,11,63969000,3622,40475940,2290,20397
1630,7,0,17,8,63977460,3622,40475940,2289,20404
1631,4,0,11,14,64026660,3623,40475940,2288,20408
1632,6,0,14,11,64039980,3623,40475940,2288,20414
1633,8,0,12,13,64068480,3622,40475940,2287,20422
1634,3,0,12,13,64083060,3622,40475940,2286,20425
1635,2,0,10,15,64106940,3623,40475940,2286,20427
1636,4,0,10,15,64121940,3623,40475940,2286,20431
1637,7,0,14,11,64130280,3623,40475940,2285,20438
1638,5,0,12,13,64153260,3623,40475940,2284,20443
1639,7,0,14,11,64175580,3623,40475940,2283,20450
1640,8,0,14,11,64198380,3623,40475940,2282,20458
1641,15,0,22,3,64217280,3622,40475940,2280,20473
1642,12,0,19,6,64272360,3622,40475940,2279,20485
1643,5,0,15,10,64304520,3622,40475940,2278,20490
1644,11,0,17,8,64340400,3622,40475940,2276,20501
1645,10,0,14,11,64386180,3622,40475940,2275,20511
1646,14,1,19,6,64406700,3622,40475940,2274,20525
1647,6,0,17,8,64440120,3622,40479000,2273,20531
1648,8,0,19,6,64471140,3622,40479000,2272,20539
1649,13,0,19,6,64527540,3623,40479000,2270,20552
1650,8,0,16,9,64568040,3623,40479000,2269,20560
1651,8,0,20,5,64587720,3623,40479000,2268,20568
1652,6,0,17,8,64626120,3624,40479000,2267,20574
1653,5,0,9,16,64688280,3625,40479000,2267,20579
1654,8,0,11,14,64700700,3624,40479000,2266,20587
1655,8,0,15,10,64714500,3624,40479000,2265,20595
1656,7,0,18,7,64734720,3624,40479000,2264,20602
1657,4,0,13,12,64773900,3625,40479000,2263,20606
1658,7,0,16,9,64798920,3625,40479000,2262,20613
1659,4,0,14,11,64823820,3625,40479000,2262,20617
1660,6,0,11,14,64862940,3626,40479000,2261,20623
1661,6,0,14,11,64871640,3626,40479000,2260,20629
1662,6,0,12,13,64897380,3625,40479000,2260,20635
1663,6,0,14,11,64915440,3626,40479000,2259,20641
1664,8,0,15,10,64948740,3626,40479000,2258,20649
1665,8,0,15,10,64973340,3626,40479000,2257,20657
1666,6,0,13,12,65001120,3626,40479000,2256,20663
1667,7,0,18,7,65008380,3626,40479000,2255,20670
1668,9,0,14,11,65051460,3626,40479000,2254,20679
1669,8,0,15,10,65074440,3625,40479000,2253,20687
1670,8,0,13,12,65119380,3626,40479000,2252,20695
1671,8,0,16,9,65132160,3626,40479000,2251,20703
1672,11,0,20,5,65148540,3625,40479000,2250,20714
1673,14,0,19,6,65206500,3625,40479000,2248,20728
1674,5,0,17,8,65231580,3625,40479000,2247,20733
1675,7,0,15,10,65282640,3626,40479000,2246,20740
1676,12,0,16,9,65318760,3626,40479000,2245,20752
1677,7,0,14,11,65350680,3626,40479000,2244,20759
1678,6,0,12,13,65383080,3626,40479000,2243,20765
1679,6,0,13,12,65394120,3626,40479000,2243,20771
1680,7,0,16,9,65405940,3626,40479000,2242,20778
1681,11,0,17,8,65451180,3626,40479000,2240,20789
1682,20,1,25,0,65474280,3625,40479540,2238,20809
1683,14,0,22,3,65542200,3625,40480020,2236,20823
1684,28,13,25,0,65576400,3625,40482240,2234,20851
1685,33,33,25,0,65644260,3626,40493700,2230,20884
1686,46,39,25,0,65705340,3627,40505940,2228,20930
1687,36,40,25,0,65786880,3629,40536180,2228,20966
1688,36,39,25,0,65846880,3630,40551600,2228,21002
1689,26,40,22,3,65910540,3631,40590180,2228,21028
1690,30,40,25,0,65954760,3631,40708740,2233,21058
1691,37,39,25,0,66043080,3632,40779060,2235,21095
1692,22,35,25,0,66109080,3631,40920780,2240,21117
1693,26,40,25,0,66150120,3631,40927620,2238,21143
1694,36,38,25,0,66219960,3631,40968660,2238,21179
1695,33,40,25,0,66288780,3630,41022540,2238,21212
1696,30,39,25,0,66352380,3631,41032560,2238,21242
1697,33,39,25,0,66429780,3631,41127240,2240,21275
1698,34,40,25,0,66484920,3632,41141400,2239,21309
1699,37,39,25,0,66556800,3632,41207700,2241,21346
1700,17,26,25,0,66617580,3629,41706000,2266,21363
1701,30,29,25,0,66682200,3627,41981820,2277,21393
1702,33,40,25,0,66727440,3627,42026760,2276,21426
1703,30,40,25,0,66787980,3628,42044460,2276,21456
1704,28,35,25,0,66892140,3628,42290760,2286,21484
1705,32,38,25,0,66938880,3627,42322440,2285,21516
1706,34,40,25,0,66989640,3627,42405120,2288,21550
1707,37,40,25,0,67068840,3627,42449760,2288,21587
1708,31,40,25,0,67113420,3628,42455280,2287,21618
1709,22,23,25,0,67219260,3626,43102620,2319,21640
1710,35,35,25,0,67258020,3624,43371660,2330,21675
1711,29,40,19,6,67319520,3625,43376880,2328,21704
1712,29,37,25,0,67384980,3626,43422360,2329,21733
1713,28,40,25,0,67439640,3626,43472220,2329,21761
1714,28,36,25,0,67502160,3627,43602180,2335,21789
1715,44,40,25,0,67572900,3626,43709220,2337,21833
1716,28,38,25,0,67625520,3627,43721220,2337,21861
1717,29,36,25,0,67713120,3627,43768140,2337,21890
1718,26,39,25,0,67760400,3627,43794000,2336,21916
1719,25,40,25,0,67828800,3627,43852800,2337,21941
1720,32,38,25,0,67893840,3628,43904280,2338,21973
1721,32,40,25,0,67952520,3627,43968840,2339,22005
1722,27,37,25,0,68033280,3627,44000460,2338,22032
1723,36,40,25,0,68077740,3628,44017920,2337,22068
1724,33,40,25,0,68164200,3627,44186580,2343,22101
1725,28,40,25,0,68209140,3627,44195640,2342,22129
1726,35,40,25,0,68257620,3627,44252220,2343,22164
1727,26,40,25,0,68325720,3627,44410500,2349,22190
1728,33,39,25,0,68413140,3627,44427420,2347,22223
1729,29,39,25,0,68473680,3627,44444100,2346,22252
1730,36,40,25,0,68534880,3627,44589540,2352,22288
1731,34,37,25,0,68605860,3627,44656320,2353,22322
1732,35,39,22,3,68663040,3625,45003060,2368,22357
1733,36,38,25,0,68716680,3626,45028260,2368,22393
1734,33,40,25,0,68768880,3627,45048600,2368,22426
1735,39,40,25,0,68847540,3628,45117540,2370,22465
1736,31,40,25,0,68901960,3628,45136920,2369,22496
1737,28,40,25,0,68984940,3629,45218940,2371,22524
1738,35,38,25,0,69059040,3627,45253320,2369,22559
1739,28,40,25,0,69107520,3626,45315720,2369,22587
1740,29,40,25,0,69163320,3626,45387840,2371,22616
1741,35,38,25,0,69225780,3627,45402540,2371,22651
1742,31,40,25,0,69306780,3626,45643560,2380,22682
1743,25,40,25,0,69350580,3626,45664020,2379,22707
1744,29,28,25,0,69442380,3626,46231740,2407,22736
1745,31,32,25,0,69505680,3624,47198340,2454,22767
1746,38,39,19,6,69549780,3624,47201580,2452,22805
1747,28,40,25,0,69619140,3625,47233920,2451,22833
1748,32,37,25,0,69671640,3626,47427060,2460,22865
1749,33,40,24,1,69721080,3625,47466660,2460,22898
1750,28,39,25,0,69784920,3626,47483760,2459,22926
1751,33,40,25,0,69871800,3625,47610780,2462,22959
1752,23,40,25,0,69917220,3624,47663100,2462,22982
1753,27,40,25,0,69989880,3625,47677800,2461,23009
1754,31,39,24,1,70061040,3624,47725620,2461,23040
1755,35,40,25,0,70119360,3625,47733840,2460,23075
1756,16,33,25,0,70180080,3625,47864100,2465,23091
1757,27,40,23,2,70239420,3625,48195540,2479,23118
1758,28,39,25,0,70290120,3626,48221340,2479,23146
1759,38,40,25,0,70339380,3626,48229200,2478,23184
1760,31,36,25,0,70438500,3626,48340920,2481,23215
1761,35,40,25,0,70471560,3626,48352680,2479,23250
1762,39,40,16,9,70504200,3625,48352920,2479,23289
1763,28,38,25,0,70585320,3627,48416220,2480,23317
1764,39,40,23,2,70612140,3627,48424140,2479,23356
1765,27,40,21,4,70683120,3627,48554340,2483,23383
1766,34,39,18,7,70713240,3627,48562140,2484,23417
1767,31,40,25,0,70780500,3629,48711120,2489,23448
1768,29,39,25,0,70828560,3629,48721440,2488,23477
1769,25,38,25,0,70908660,3628,49046580,2502,23502
1770,31,40,25,0,70954620,3629,49054800,2500,23533
1771,25,38,25,0,71031780,3629,49197600,2505,23558
1772,33,40,16,9,71085360,3629,49204080,2505,23591
1773,31,38,25,0,71133840,3630,49283880,2507,23622
1774,33,37,22,3,71177100,3630,49308000,2507,23655
1775,32,38,25,0,71247900,3631,49351260,2507,23687
1776,29,40,25,0,71270040,3631,49355940,2506,23716
1777,38,40,24,1,71375820,3632,49402680,2506,23754
1778,19,36,24,1,71423160,3632,49449840,2507,23773
1779,22,29,25,0,71511420,3632,50062440,2535,23795
1780,31,40,20,5,71542320,3631,50064540,2533,23826
1781,36,40,25,0,71597700,3632,50090460,2533,23862
1782,28,36,25,0,71685120,3633,50173500,2535,23890
1783,26,35,25,0,71752020,3633,50224560,2535,23916
1784,28,40,25,0,71801400,3632,50285460,2535,23944
1785,32,37,25,0,71880840,3632,50304780,2534,23976
1786,32,40,25,0,71934720,3632,50345340,2534,24008
1787,36,40,25,0,71996760,3632,50363520,2532,24044
1788,35,40,25,0,72058800,3633,50372460,2531,24079
1789,34,39,25,0,72131820,3633,50401020,2530,24113
1790,29,36,25,0,72203460,3633,50515680,2534,24142
1791,20,39,25,0,72246120,3633,50526180,2533,24162
1792,35,38,25,0,72337320,3634,50575800,2533,24197
1793,30,39,25,0,72396540,3632,50634360,2532,24227
1794,35,37,23,2,72439680,3632,50657340,2532,24262
1795,31,39,19,6,72506040,3632,50676180,2531,24293
1796,38,40,25,0,72550800,3631,50763660,2533,24331
1797,34,38,25,0,72613680,3631,50788680,2532,24365
1798,36,39,25,0,72687480,3631,50863980,2533,24401
1799,33,35,25,0,72763560,3631,51094320,2542,24434
1800,23,23,25,0,72834840,3628,53653020,2666,24457
1801,30,40,22,3,72875400,3628,53655540,2663,24487
1802,31,39,25,0,72926340,3629,53677680,2662,24518
1803,34,40,25,0,73011360,3630,53713980,2662,24552
1804,29,39,25,0,73069680,3631,53722140,2661,24581
1805,22,39,25,0,73142160,3631,54046200,2675,24603
1806,35,39,25,0,73216500,3631,54109200,2675,24638
1807,43,38,25,0,73276860,3630,54134220,2673,24681
1808,30,40,25,0,73333860,3630,54150360,2672,24711
1809,26,38,25,0,73388340,3630,54190740,2672,24737
1810,35,40,25,0,73462860,3631,54195780,2670,24772
1811,32,37,25,0,73548720,3631,54238140,2669,24804
1812,26,39,25,0,73592280,3631,54373920,2674,24830
1813,26,39,25,0,73654560,3631,54396480,2673,24856
1814,36,35,25,0,73738320,3631,54560220,2679,24892
1815,32,40,25,0,73768080,3630,54674100,2682,24924
1816,36,39,25,0,73833660,3632,54686520,2681,24960
1817,36,39,25,0,73930440,3633,54747240,2682,24996
1818,38,39,25,0,73996800,3632,54837300,2683,25034
1819,30,36,25,0,74054820,3632,54913080,2685,25064
1820,37,40,25,0,74113320,3630,55046760,2687,25101
1821,29,40,25,0,74171040,3630,55084080,2688,25130
1822,28,36,25,0,74251260,3630,55129980,2687,25158
1823,35,40,20,5,74293080,3629,55182120,2687,25193
1824,31,40,25,0,74350020,3630,55193760,2686,25224
1825,25,40,25,0,74411700,3629,55246380,2686,25249
1826,27,36,25,0,74494380,3629,55394220,2690,25276
1827,30,40,24,1,74543460,3628,55730220,2704,25306
1828,29,40,21,4,74605440,3629,55748400,2704,25335
1829,33,40,17,8,74659620,3630,55759080,2703,25368
1830,23,31,25,0,74708280,3629,55995660,2712,25391
1831,34,40,25,0,74762040,3629,56000880,2710,25425
1832,34,39,24,1,74823480,3628,56112660,2713,25459
1833,30,38,25,0,74893260,3629,56158620,2713,25489
1834,27,35,25,0,74965620,3629,56215980,2714,25516
1835,29,39,25,0,75030900,3629,56257980,2713,25545
1836,31,39,25,0,75087720,3629,56281800,2712,25576
1837,35,40,25,0,75151980,3630,56312940,2711,25611
1838,30,38,25,0,75219900,3630,56350440,2711,25641
1839,25,40,18,7,75285840,3630,56413860,2712,25666
1840,25,39,25,0,75339180,3630,56439360,2711,25691
1841,24,32,25,0,75410160,3629,56642880,2719,25715
1842,36,38,25,0,75470400,3629,56660580,2717,25751
1843,27,40,25,0,75524220,3630,56670180,2715,25778
1844,32,37,25,0,75602460,3630,56765100,2717,25810
1845,31,40,25,0,75661500,3630,56770620,2715,25841
1846,16,35,25,0,75727800,3631,56909760,2721,25857
1847,19,15,25,0,75798120,3627,60470460,2888,25876
1848,20,18,25,0,75856260,3627,60703560,2897,25896
1849,7,7,25,0,75932640,3628,61674060,2942,25903
1850,5,0,12,13,75997080,3627,62871720,2998,25908
1851,2,0,11,14,76010040,3627,62871720,2998,25910
1852,3,0,10,15,76032480,3627,62871720,2998,25913
1853,5,0,13,12,76043400,3627,62871720,2997,25918
1854,4,0,13,12,76058940,3627,62871720,2996,25922
1855,11,0,16,9,76082640,3627,62871720,2995,25933
1856,7,0,16,9,76103460,3627,62871720,2994,25940
1857,7,0,13,12,76140840,3627,62871720,2993,25947
1858,10,0,16,9,76172940,3627,62871720,2991,25957
1859,11,0,17,8,76194660,3626,62871720,2990,25968
1860,8,0,17,8,76230540,3627,62871720,2989,25976
1861,9,0,17,8,76251660,3626,62871720,2987,25985
1862,13,0,18,7,76300140,3626,62871720,2986,25998
1863,8,0,19,6,76315260,3626,62871720,2984,26006
1864,10,0,17,8,76369140,3626,62871720,2983,26016
1865,12,0,20,5,76398720,3626,62871720,2981,26028
1866,10,0,17,8,76453200,3627,62871720,2980,26038
1867,8,0,15,10,76480440,3626,62871720,2979,26046
1868,7,0,13,12,76512660,3626,62871720,2978,26053
1869,4,0,14,11,76521720,3626,62871720,2977,26057
1870,4,0,14,11,76545120,3627,62871720,2977,26061
1871,4,0,14,11,76562220,3627,62871720,2976,26065
1872,5,0,14,11,76594380,3627,62871720,2975,26070
1873,4,0,10,15,76628820,3628,62871720,2975,26074
1874,8,0,15,10,76633980,3627,62871720,2974,26082
1875,8,0,16,9,76657080,3627,62871720,2973,26090
1876,6,0,14,11,76689360,3627,62871720,2972,26096
1877,5,0,11,14,76723140,3628,62871720,2971,26101
1878,4,0,11,14,76740420,3628,62871720,2970,26105
1879,10,0,16,9,76750380,3627,62871720,2969,26115
1880,6,0,17,8,76768440,3627,62871720,2968,26121
1881,14,0,21,4,76809960,3628,62871720,2966,26135
1882,11,0,21,4,76865700,3628,62871720,2965,26146
1883,12,0,22,3,76907760,3628,62871720,2963,26158
1884,8,0,20,5,76956600,3629,62871720,2962,26166
1885,10,0,18,7,77010360,3629,62871720,2961,26176
1886,10,0,15,10,77050020,3629,62871720,2959,26186
1887,7,0,12,13,77082660,3629,62871720,2958,26193
1888,6,0,17,8,77085180,3629,62871720,2957,26199
1889,4,0,13,12,77111040,3629,62871720,2957,26203
1890,7,0,13,12,77145060,3629,62871720,2956,26210
1891,11,0,19,6,77163120,3629,62871720,2954,26221
1892,5,0,12,13,77200740,3629,62871720,2954,26226
1893,4,0,12,13,77218320,3629,62871720,2953,26230
1894,12,0,16,9,77242500,3629,62871720,2951,26242
1895,4,0,13,12,77272380,3629,62871720,2951,26246
1896,7,0,15,10,77289480,3629,62871720,2950,26253
1897,4,0,16,9,77298480,3629,62871720,2949,26257
1898,7,0,14,11,77347560,3630,62871720,2948,26264
1899,7,0,13,12,77378760,3630,62871720,2947,26271
1900,7,0,15,10,77401560,3630,62871720,2946,26278
1901,8,0,14,11,77433780,3630,62871720,2945,26286
1902,10,0,18,7,77464920,3630,62871720,2944,26296
1903,12,0,17,8,77499960,3630,62871720,2942,26308
1904,7,0,18,7,77531280,3630,62871720,2941,26315
1905,9,0,16,9,77575200,3630,62871720,2940,26324
1906,10,0,18,7,77597400,3630,62871720,2939,26334
1907,6,0,15,10,77642160,3631,62871720,2938,26340
1908,5,0,16,9,77661900,3631,62871720,2937,26345
1909,16,0,21,4,77708640,3631,62871720,2935,26361
1910,12,0,22,3,77744100,3631,62871720,2933,26373
1911,8,0,15,10,77801700,3631,62871720,2932,26381
1912,10,0,19,6,77827320,3631,62871720,2931,26391
1913,9,0,22,3,77851920,3632,62871720,2930,26400
1914,5,0,16,9,77908020,3632,62871720,2929,26405
1915,6,0,12,13,77957100,3633,62871720,2928,26411
1916,9,0,15,10,77977740,3633,62871720,2927,26420
1917,5,0,15,10,77991840,3633,62871720,2926,26425
1918,2,0,11,14,78027480,3633,62871720,2926,26427
1919,5,0,11,14,78059640,3634,62871720,2925,26432
1920,5,0,9,16,78081060,3634,62871720,2925,26437
1921,4,0,8,17,78091200,3633,62871720,2924,26441
1922,2,0,9,16,78092040,3633,62871720,2924,26443
1923,7,0,13,12,78101220,3633,62871720,2923,26450
1924,8,0,16,9,78115980,3633,62871720,2922,26458
1925,5,0,16,9,78141120,3633,62871720,2921,26463
1926,9,0,16,9,78186420,3634,62871720,2920,26472
1927,5,0,12,13,78221700,3634,62871720,2919,26477
1928,9,0,18,7,78232080,3634,62871720,2918,26486
1929,12,0,21,4,78267720,3634,62871720,2916,26498
1930,6,0,16,9,78312360,3634,62871720,2915,26504
1931,5,0,14,11,78343740,3635,62871720,2915,26509
1932,10,0,17,8,78364920,3634,62871720,2913,26519
1933,10,0,15,10,78409800,3634,62871720,2912,26529
1934,7,0,15,10,78433980,3634,62871720,2911,26536
1935,10,0,14,11,78466260,3634,62871720,2910,26546
1936,19,1,25,0,78481020,3634,62871960,2907,26565
1937,13,1,25,0,78537780,3634,62882160,2906,26578
1938,6,0,14,11,78597600,3634,62884140,2905,26584
1939,5,0,14,11,78629520,3634,62884140,2905,26589
1940,6,0,11,14,78648420,3634,62884140,2904,26595
1941,14,0,14,11,78666600,3633,62884140,2902,26609
1942,5,0,14,11,78685800,3633,62884140,2901,26614
1943,3,0,14,11,78701460,3633,62884140,2901,26617
1944,5,0,13,12,78731460,3633,62884140,2900,26622
1945,5,0,11,14,78756720,3633,62884140,2900,26627
1946,4,0,11,14,78770460,3633,62884140,2899,26631
1947,10,0,16,9,78788340,3633,62884140,2898,26641
1948,6,0,18,7,78807000,3634,62884140,2897,26647
1949,5,0,11,14,78859260,3634,62884140,2896,26652
1950,8,0,12,13,78878640,3634,62884140,2895,26660
1951,6,0,13,12,78897540,3634,62884140,2894,26666
1952,9,0,13,12,78922860,3633,62884140,2893,26675
1953,13,0,17,8,78950280,3633,62884140,2891,26688
1954,15,0,23,2,78972960,3633,62884140,2889,26703
1955,10,0,20,5,79007460,3632,62884140,2888,26713
1956,11,0,16,9,79067460,3632,62884140,2887,26724
1957,16,0,24,1,79085280,3632,62884140,2884,26740
1958,11,0,21,4,79140540,3632,62884140,2883,26751
1959,10,0,19,6,79184880,3632,62884140,2882,26761
1960,12,0,17,8,79246200,3632,62884140,2880,26773
1961,10,0,20,5,79257720,3632,62884140,2879,26783
1962,9,0,19,6,79291140,3632,62884140,2878,26792
1963,6,0,13,12,79359600,3633,62884140,2877,26798
1964,6,0,13,12,79383420,3633,62884140,2876,26804
1965,13,0,19,6,79403100,3633,62884140,2874,26817
1966,5,0,13,12,79440540,3633,62884140,2874,26822
1967,10,0,17,8,79464360,3633,62884140,2872,26832
1968,8,0,16,9,79500180,3633,62884140,2871,26840
1969,4,0,14,11,79526400,3633,62884140,2871,26844
1970,3,0,11,14,79550820,3633,62884140,2870,26847
1971,7,0,11,14,79574940,3633,62884140,2869,26854
1972,3,0,10,15,79582140,3633,62884140,2869,26857
1973,3,0,7,18,79596060,3632,62884140,2869,26860
1974,5,0,11,14,79597920,3632,62884140,2868,26865
1975,8,0,14,11,79605180,3632,62884140,2867,26873
1976,5,0,13,12,79629780,3632,62884140,2866,26878
1977,13,0,20,5,79642800,3632,62884140,2865,26891
1978,6,0,14,11,79686540,3632,62884140,2864,26897
1979,14,0,20,5,79716300,3632,62884140,2862,26911
1980,9,0,15,10,79747740,3631,62884140,2861,26920
1981,10,0,15,10,79780140,3630,62884140,2860,26930
1982,13,0,21,4,79802400,3630,62884140,2858,26943
1983,9,0,17,8,79848480,3630,62884140,2857,26952
1984,10,0,20,5,79874880,3630,62884140,2855,26962
1985,11,0,20,5,79923240,3631,62884140,2854,26973
1986,11,0,16,9,79973700,3631,62884140,2853,26984
1987,13,0,20,5,80010540,3631,62884140,2851,26997
1988,5,0,12,13,80053500,3631,62884140,2850,27002
1989,10,0,14,11,80076660,3630,62884140,2849,27012
1990,1,0,9,16,80102820,3630,62884140,2849,27013
1991,7,0,11,14,80120880,3630,62884140,2848,27020
1992,6,0,11,14,80135340,3630,62884140,2847,27026
1993,9,0,15,10,80151960,3630,62884140,2846,27035
1994,9,0,15,10,80181360,3630,62884140,2845,27044
1995,6,0,14,11,80207700,3630,62884140,2844,27050
1996,4,0,14,11,80229120,3630,62884140,2844,27054
1997,7,0,14,11,80257440,3630,62884140,2843,27061
1998,4,0,11,14,80283720,3630,62884140,2842,27065
1999,6,0,12,13,80302380,3630,62884140,2841,27071
2000,9,0,18,7,80313120,3630,62884140,2840,27080
2001,13,0,18,7,80348400,3630,62884140,2839,27093
2002,11,0,20,5,80376780,3630,62884140,2837,27104
2003,15,0,19,6,80421600,3629,62884140,2835,27119
2004,13,0,23,2,80451060,3629,62884140,2834,27132
2005,10,0,20,5,80501700,3629,62884140,2832,27142
2006,12,0,20,5,80569020,3630,62884200,2831,27154
2007,10,0,21,4,80593440,3630,62884200,2829,27164
2008,13,0,21,4,80648760,3630,62884200,2828,27177
2009,9,0,18,7,80692380,3630,62884200,2827,27186
2010,9,0,17,8,80733720,3630,62884200,2826,27195
2011,6,0,14,11,80770800,3631,62884200,2825,27201
2012,7,0,15,10,80789760,3631,62884200,2824,27208
2013,7,0,16,9,80816220,3631,62884200,2823,27215
2014,4,0,9,16,80852160,3631,62884200,2822,27219
2015,5,0,11,14,80862840,3631,62884200,2822,27224
2016,3,0,9,16,80884140,3631,62884200,2821,27227
2017,4,0,13,12,80884140,3631,62884200,2821,27231
2018,2,0,12,13,80892720,3631,62884200,2821,27233
2019,8,0,17,8,80906520,3631,62884200,2820,27241
2020,9,0,14,11,80943120,3630,62884200,2819,27250
2021,4,0,14,11,80959680,3630,62884200,2818,27254
2022,7,0,12,13,80979180,3630,62884200,2817,27261
2023,11,0,14,11,81012420,3630,62884200,2816,27272
2024,13,0,21,4,81031620,3630,62884200,2814,27285
2025,8,0,16,9,81076380,3630,62884200,2813,27293
2026,9,0,14,11,81114240,3630,62884200,2812,27302
2027,16,0,21,4,81143700,3629,62884260,2810,27318
2028,11,0,18,7,81186900,3629,62884260,2809,27329
2029,12,0,20,5,81228840,3629,62884260,2807,27341
2030,9,0,16,9,81282360,3630,62884260,2806,27350
2031,8,0,18,7,81294360,3629,62884260,2805,27358
2032,10,0,19,6,81329040,3629,62884260,2804,27368
2033,7,0,16,9,81363600,3629,62884260,2803,27375
2034,10,0,20,5,81393660,3630,62884260,2802,27385
2035,9,0,20,5,81431340,3630,62884260,2800,27394
2036,11,0,20,5,81476220,3630,62884260,2799,27405
2037,6,0,15,10,81516060,3630,62884260,2798,27411
2038,5,0,11,14,81562860,3631,62884260,2798,27416
2039,3,0,13,12,81565740,3631,62884260,2797,27419
2040,5,0,14,11,81578100,3631,62884260,2797,27424
2041,5,0,14,11,81600600,3631,62884260,2796,27429
2042,3,0,14,11,81613440,3631,62884260,2796,27432
2043,3,0,11,14,81652980,3632,62884260,2795,27435
2044,5,0,11,14,81666960,3631,62884260,2795,27440
2045,6,0,16,9,81668700,3631,62884260,2794,27446
2046,2,0,12,13,81697680,3632,62884260,2794,27448
2047,8,0,15,10,81711060,3631,62884260,2793,27456
2048,12,0,19,6,81737460,3631,62884260,2791,27468
2049,8,0,20,5,81757380,3631,62884260,2790,27476
2050,8,0,18,7,81811320,3632,62884260,2789,27484
2051,9,0,16,9,81845520,3632,62884260,2788,27493
2052,9,0,16,9,81880560,3632,62884260,2787,27502
2053,13,0,19,6,81901140,3631,62884260,2785,27515
2054,13,0,22,3,81951180,3632,62884260,2784,27528
2055,12,0,23,2,81978540,3631,62884260,2782,27540
2056,5,0,14,11,82032360,3631,62884260,2782,27545
2057,9,0,16,9,82063980,3631,62884260,2781,27554
2058,10,0,20,5,82084800,3631,62884260,2779,27564
2059,7,0,15,10,82128900,3631,62884260,2779,27571
2060,5,0,15,10,82153920,3632,62884260,2778,27576
2061,2,0,10,15,82181520,3632,62884260,2778,27578
2062,6,0,11,14,82194420,3632,62884260,2777,27584
2063,6,0,13,12,82203780,3631,62884260,2776,27590
2064,6,0,15,10,82210320,3631,62884260,2775,27596
2065,9,0,19,6,82215540,3630,62884260,2774,27605
2066,6,0,16,9,82263000,3631,62884260,2774,27611
2067,3,0,13,12,82293120,3631,62884260,2773,27614
2068,4,0,13,12,82315560,3632,62884260,2773,27618
2069,2,0,12,13,82327680,3632,62884260,2773,27620
2070,7,0,13,12,82357260,3632,62884260,2772,27627
2071,8,0,17,8,82371360,3632,62884260,2771,27635
2072,8,0,17,8,82392300,3632,62884260,2770,27643
2073,4,0,13,12,82424940,3632,62884260,2769,27647
2074,11,0,16,9,82452300,3632,62884260,2768,27658
2075,9,0,14,11,82484100,3632,62884260,2767,27667
2076,15,2,20,5,82497900,3631,62885640,2765,27682
2077,14,6,23,2,82528920,3631,62888700,2764,27696
2078,11,3,25,0,82593300,3632,62911320,2763,27707
2079,10,0,16,9,82666620,3632,62923080,2762,27717
2080,7,0,17,8,82690860,3632,62923080,2762,27724
2081,7,0,15,10,82731960,3632,62923080,2761,27731
2082,12,0,20,5,82754880,3632,62923080,2759,27743
2083,16,0,25,0,82779000,3632,62924160,2757,27759
2084,6,0,15,10,82844100,3632,62924160,2757,27765
2085,10,0,19,6,82871640,3632,62924160,2755,27775
2086,6,0,16,9,82912680,3633,62924160,2755,27781
2087,9,0,16,9,82951920,3633,62924160,2754,27790
2088,2,0,10,15,82975320,3633,62924160,2753,27792
2089,5,0,13,12,82985160,3633,62924160,2753,27797
2090,3,0,13,12,82994880,3633,62924160,2752,27800
2091,4,0,15,10,83007840,3633,62924160,2752,27804
2092,10,0,16,9,83033280,3633,62924160,2751,27814
2093,3,0,14,11,83052540,3633,62924160,2750,27817
2094,9,0,14,11,83077500,3632,62924160,2749,27826
2095,7,0,15,10,83109120,3633,62924160,2748,27833
2096,8,0,18,7,83124060,3633,62924160,2748,27841
2097,10,0,20,5,83151840,3632,62924160,2746,27851
2098,9,0,18,7,83191980,3632,62924160,2745,27860
2099,10,0,18,7,83235360,3633,62924160,2744,27870
2100,7,0,14,11,83273280,3633,62924160,2743,27877
2101,10,0,13,12,83301900,3632,62924160,2742,27887
2102,10,0,15,10,83318160,3632,62924160,2741,27897
2103,9,0,15,10,83336640,3631,62924160,2740,27906
2104,16,0,21,4,83368020,3631,62924160,2738,27922
2105,12,0,17,8,83404320,3630,62924160,2736,27934
2106,7,0,16,9,83436300,3630,62924160,2736,27941
2107,10,0,15,10,83468820,3630,62924160,2734,27951
2108,4,0,10,15,83494920,3629,62924160,2734,27955
2109,8,0,13,12,83509920,3629,62924160,2733,27963
2110,8,0,17,8,83519640,3629,62924160,2732,27971
2111,5,0,14,11,83550960,3629,62924160,2731,27976
2112,6,0,14,11,83571660,3629,62924160,2731,27982
2113,6,0,15,10,83589480,3629,62924160,2730,27988
2114,8,0,15,10,83615820,3629,62924160,2729,27996
2115,2,0,13,12,83631960,3629,62924160,2729,27998
2116,8,0,17,8,83646900,3629,62924160,2728,28006
2117,8,0,15,10,83680680,3629,62924160,2727,28014
2118,4,0,16,9,83697660,3629,62924160,2726,28018
2119,8,0,17,8,83736960,3630,62924160,2725,28026
2120,8,0,16,9,83767140,3630,62924160,2725,28034
2121,11,0,23,2,83772900,3629,62924160,2723,28045
2122,11,0,21,4,83840400,3630,62924160,2722,28056
2123,15,2,25,0,83876400,3630,62925540,2720,28071
2124,7,0,15,10,83961960,3631,62927460,2720,28078
2125,8,0,15,10,83983560,3631,62927460,2719,28086
2126,14,0,22,3,84006300,3631,62927460,2717,28100
2127,10,0,19,6,84043500,3630,62927460,2716,28110
2128,6,0,18,7,84078900,3631,62927460,2715,28116
2129,9,0,16,9,84131760,3631,62927460,2714,28125
2130,8,0,17,8,84157200,3631,62927460,2713,28133
2131,12,0,21,4,84179280,3631,62927460,2712,28145
2132,13,0,20,5,84241620,3631,62927460,2710,28158
2133,6,0,16,9,84277680,3631,62927460,2709,28164
2134,5,0,15,10,84304740,3632,62927460,2709,28169
2135,3,0,13,12,84331500,3632,62927460,2709,28172
2136,7,0,13,12,84357540,3632,62927460,2708,28179
2137,5,0,13,12,84371220,3632,62927460,2707,28184
2138,6,0,12,13,84402300,3632,62927460,2706,28190
2139,4,0,13,12,84406440,3632,62927460,2706,28194
2140,6,0,14,11,84425880,3632,62927460,2705,28200
2141,6,0,12,13,84450660,3632,62927460,2705,28206
2142,2,0,11,14,84463680,3632,62927460,2704,28208
2143,9,0,16,9,84478380,3632,62927460,2703,28217
2144,5,0,18,7,84485580,3632,62927460,2703,28222
2145,5,0,14,11,84527280,3632,62927460,2702,28227
2146,12,0,19,6,84541920,3631,62927460,2701,28239
2147,13,0,21,4,84591360,3632,62927460,2699,28252
2148,7,0,14,11,84645780,3632,62927460,2698,28259
2149,8,0,13,12,84667680,3632,62927460,2697,28267
2150,9,0,12,13,84707880,3632,62927460,2696,28276
2151,14,0,18,7,84732360,3632,62927460,2695,28290
2152,6,0,14,11,84764940,3631,62927460,2694,28296
2153,16,0,21,4,84788880,3631,62927460,2692,28312
2154,8,0,20,5,84826200,3631,62927460,2691,28320
2155,12,0,20,5,84866700,3631,62927460,2690,28332
2156,7,0,17,8,84908580,3631,62927460,2689,28339
2157,2,0,9,16,84959100,3632,62927460,2689,28341
2158,7,0,15,10,84961800,3632,62927460,2688,28348
2159,6,0,16,9,84972420,3632,62927460,2687,28354
2160,3,0,13,12,84995340,3632,62927460,2687,28357
2161,5,0,12,13,85021020,3632,62927460,2687,28362
2162,2,0,12,13,85027920,3632,62927460,2686,28364
2163,4,0,11,14,85050840,3632,62927460,2686,28368
2164,4,0,10,15,85062480,3632,62927460,2685,28372
2165,6,0,14,11,85064100,3631,62927460,2685,28378
2166,11,0,18,7,85092000,3632,62927460,2683,28389
2167,12,0,19,6,85124880,3631,62927460,2682,28401
2168,7,0,18,7,85159740,3632,62927460,2681,28408
2169,11,0,19,6,85201020,3632,62927460,2680,28419
2170,11,0,19,6,85232400,3631,62927460,2679,28430
2171,14,0,23,2,85283820,3632,62927460,2677,28444
2172,10,0,22,3,85320360,3632,62927460,2676,28454
2173,9,0,19,6,85371180,3632,62927460,2675,28463
2174,10,0,20,5,85418040,3633,62927460,2674,28473
2175,9,0,18,7,85460040,3633,62927460,2673,28482
2176,8,0,19,6,85489140,3633,62927460,2672,28490
2177,12,0,19,6,85528440,3633,62927460,2671,28502
2178,8,0,19,6,85571100,3633,62927460,2670,28510
2179,4,0,14,11,85618080,3634,62927460,2669,28514
2180,8,0,13,12,85651680,3634,62927460,2668,28522
2181,9,0,13,12,85674540,3634,62927460,2667,28531
2182,6,0,12,13,85693800,3633,62927460,2667,28537
2183,3,0,10,15,85710420,3633,62927460,2666,28540
2184,12,0,17,8,85720440,3633,62927460,2665,28552
2185,4,0,17,8,85736580,3633,62927460,2664,28556
2186,7,0,14,11,85785780,3634,62927460,2664,28563
2187,10,0,17,8,85812000,3634,62927460,2663,28573
2188,9,0,15,10,85853340,3634,62927460,2662,28582
2189,9,0,15,10,85879020,3633,62927460,2661,28591
2190,2,0,13,12,85896180,3633,62927460,2660,28593
2191,7,0,14,11,85918620,3633,62927460,2659,28600
2192,7,0,14,11,85950480,3634,62927460,2659,28607
2193,8,0,17,8,85959240,3633,62927460,2658,28615
2194,8,0,17,8,85988100,3633,62927460,2657,28623
2195,12,0,23,2,86015340,3634,62927460,2656,28635
2196,9,0,21,4,86053440,3634,62927460,2655,28644
2197,10,0,18,7,86103000,3634,62927460,2653,28654
2198,14,0,21,4,86149020,3634,62927460,2652,28668
2199,6,0,17,8,86191740,3634,62927460,2651,28674
2200,13,0,16,9,86244420,3634,62927460,2650,28687
2201,5,0,15,10,86266680,3634,62927460,2649,28692
2202,7,0,15,10,86293260,3634,62927460,2648,28699
2203,6,0,13,12,86317620,3634,62927460,2648,28705
2204,6,0,16,9,86332500,3634,62927460,2647,28711
2205,10,0,20,5,86347380,3634,62927460,2646,28721
2206,7,0,18,7,86391600,3634,62927460,2645,28728
2207,9,0,17,8,86445960,3635,62927460,2644,28737
2208,6,0,14,11,86475960,3635,62927460,2644,28743
2209,4,0,13,12,86499360,3635,62927460,2643,28747
2210,9,0,20,5,86505060,3635,62927460,2642,28756
2211,8,0,19,6,86534940,3635,62927460,2641,28764
2212,9,0,18,7,86582520,3636,62927460,2640,28773
2213,5,0,17,8,86605200,3636,62927460,2640,28778
2214,9,0,17,8,86633160,3635,62927460,2639,28787
2215,9,0,13,12,86682540,3636,62927460,2638,28796
2216,10,0,12,13,86704560,3635,62927460,2637,28806
2217,4,0,12,13,86717100,3635,62927460,2636,28810
2218,7,0,16,9,86722800,3634,62927460,2635,28817
2219,12,0,21,4,86750340,3635,62927460,2634,28829
2220,13,0,18,7,86798820,3634,62927460,2633,28842
2221,13,0,21,4,86828100,3634,62927460,2631,28855
2222,13,0,20,5,86875740,3634,62927460,2630,28868
2223,10,0,21,4,86903340,3633,62927460,2629,28878
2224,13,0,20,5,86963640,3634,62927460,2627,28891
2225,8,0,22,3,86984220,3634,62927460,2626,28899
2226,8,0,20,5,87042960,3635,62927460,2625,28907
2227,6,0,17,8,87089640,3635,62927460,2625,28913
2228,4,0,14,11,87123240,3636,62927460,2624,28917
2229,12,0,19,6,87144480,3636,62927460,2623,28929
2230,7,0,17,8,87180360,3636,62927460,2622,28936
2231,4,0,14,11,87208020,3636,62927460,2622,28940
2232,8,0,16,9,87229620,3636,62927460,2621,28948
2233,4,0,14,11,87264420,3636,62927460,2620,28952
2234,3,0,10,15,87286440,3636,62927460,2620,28955
2235,1,0,10,15,87295980,3636,62927460,2620,28956
2236,6,0,15,10,87305520,3637,62927460,2619,28962
2237,9,0,18,7,87316080,3636,62927460,2618,28971
2238,8,0,18,7,87346380,3636,62927460,2618,28979
2239,10,0,19,6,87392100,3637,62927460,2616,28989
2240,14,0,20,5,87431160,3636,62927460,2615,29003
2241,9,0,18,7,87458160,3636,62927460,2614,29012
2242,12,0,18,7,87501660,3636,62927460,2613,29024
2243,15,0,22,3,87541920,3636,62927460,2611,29039
2244,12,0,24,1,87576600,3636,62929440,2610,29051
2245,10,0,23,2,87628560,3636,62929740,2609,29061
2246,9,0,20,5,87703080,3638,62929740,2608,29070
2247,14,0,23,2,87741900,3638,62929740,2606,29084
2248,5,0,15,10,87789480,3638,62929740,2606,29089
2249,7,0,13,12,87827100,3638,62929740,2605,29096
2250,4,0,13,12,87839280,3638,62929740,2605,29100
2251,8,0,13,12,87875820,3638,62929740,2604,29108
2252,3,0,15,10,87879900,3638,62929740,2603,29111
2253,5,0,12,13,87916380,3638,62929740,2603,29116
2254,8,0,14,11,87934020,3638,62929740,2602,29124
2255,8,0,18,7,87943680,3638,62929740,2601,29132
2256,5,0,12,13,87990960,3638,62929740,2601,29137
2257,3,0,11,14,88007340,3638,62929740,2600,29140
2258,7,0,14,11,88020180,3638,62929740,2599,29147
2259,5,0,12,13,88048680,3638,62929740,2599,29152
2260,10,0,12,13,88075620,3638,62929740,2598,29162
2261,5,0,13,12,88085820,3638,62929740,2597,29167
2262,6,0,16,9,88098840,3638,62929740,2597,29173
2263,4,0,15,10,88129440,3638,62929740,2596,29177
2264,5,0,13,12,88155120,3638,62929740,2596,29182
2265,10,0,18,7,88180080,3639,62929740,2595,29192
2266,7,0,16,9,88210560,3639,62929740,2594,29199
2267,14,0,21,4,88244160,3639,62929740,2592,29213
2268,12,0,23,2,88284540,3639,62929740,2591,29225
2269,11,0,14,11,88363680,3639,62929740,2590,29236
2270,9,0,16,9,88381860,3639,62929740,2589,29245
2271,8,0,14,11,88408380,3638,62929740,2588,29253
2272,10,0,15,10,88427460,3638,62929740,2587,29263
2273,14,0,21,4,88456440,3638,62929740,2586,29277
2274,5,0,18,7,88484640,3638,62929740,2585,29282
2275,6,0,13,12,88530720,3638,62929740,2584,29288
2276,9,0,20,5,88540140,3638,62929740,2583,29297
2277,6,0,18,7,88569960,3638,62929740,2583,29303
2278,8,0,17,8,88604700,3638,62929740,2582,29311
2279,4,0,11,14,88646940,3638,62929740,2582,29315
2280,7,0,14,11,88658520,3638,62929740,2581,29322
2281,7,0,14,11,88676040,3638,62929740,2580,29329
2282,8,0,15,10,88696920,3638,62929740,2579,29337
2283,3,0,12,13,88720920,3638,62929740,2579,29340
2284,5,0,12,13,88731900,3638,62929740,2578,29345
2285,6,0,15,10,88746000,3638,62929740,2578,29351
2286,8,0,12,13,88778460,3637,62929740,2577,29359
2287,6,0,15,10,88786800,3637,62929740,2576,29365
2288,6,0,14,11,88807620,3637,62929740,2576,29371
2289,7,0,15,10,88828680,3637,62929740,2575,29378
2290,6,0,15,10,88842540,3637,62929740,2574,29384
2291,10,0,18,7,88876560,3637,62929740,2573,29394
2292,10,0,20,5,88904820,3637,62929740,2572,29404
2293,6,0,16,9,88942020,3637,62929740,2572,29410
2294,8,0,15,10,88968000,3637,62929740,2571,29418
2295,9,0,17,8,88994640,3637,62929740,2570,29427
2296,8,0,19,6,89020380,3637,62929740,2569,29435
2297,9,0,13,12,89064180,3637,62929740,2568,29444
2298,4,0,11,14,89089740,3637,62929740,2568,29448
2299,7,0,11,14,89101200,3636,62929740,2567,29455
2300,4,0,12,13,89114640,3636,62929740,2566,29459
2301,7,0,11,14,89131020,3636,62929740,2566,29466
2302,5,0,13,12,89142000,3636,62929740,2565,29471
2303,6,0,14,11,89161320,3636,62929740,2565,29477
2304,4,0,10,15,89192100,3636,62929740,2564,29481
2305,5,0,10,15,89206560,3636,62929740,2564,29486
2306,4,0,13,12,89208540,3636,62929740,2563,29490
2307,4,0,15,10,89216700,3636,62929740,2563,29494
2308,4,0,12,13,89244720,3636,62929740,2562,29498
2309,7,0,16,9,89252760,3636,62929740,2562,29505
2310,5,0,17,8,89266740,3636,62929740,2561,29510
2311,8,0,15,10,89313120,3636,62929740,2560,29518
2312,6,0,16,9,89338620,3636,62929740,2560,29524
2313,10,0,15,10,89372220,3636,62929740,2559,29534
2314,14,0,17,8,89406720,3636,62929740,2557,29548
2315,8,0,17,8,89430720,3635,62929740,2556,29556
2316,13,0,20,5,89470320,3636,62929740,2555,29569
2317,9,0,18,7,89506080,3635,62929740,2554,29578
2318,10,0,17,8,89537340,3635,62929740,2553,29588
2319,13,0,22,3,89566260,3635,62929740,2552,29601
2320,12,0,21,4,89622000,3635,62929800,2550,29613
2321,9,0,19,6,89666580,3636,62929800,2549,29622
2322,13,0,17,8,89715960,3635,62929800,2548,29635
2323,7,0,14,11,89751720,3635,62929800,2547,29642
2324,7,0,17,8,89763060,3635,62929800,2547,29649
2325,3,0,13,12,89797800,3636,62929800,2546,29652
2326,10,0,19,6,89812200,3636,62929800,2545,29662
2327,2,0,13,12,89852760,3636,62929800,2545,29664
2328,4,0,11,14,89882880,3636,62929800,2545,29668
2329,2,0,11,14,89888940,3636,62929800,2544,29670
2330,7,0,14,11,89907600,3637,62929800,2544,29677
2331,2,0,13,12,89918040,3637,62929800,2544,29679
2332,7,0,15,10,89940480,3637,62929800,2543,29686
2333,8,0,17,8,89958600,3637,62929800,2542,29694
2334,7,0,15,10,89995800,3637,62929800,2541,29701
2335,6,0,15,10,90009960,3636,62929800,2541,29707
2336,9,0,16,9,90036000,3636,62929800,2540,29716
2337,11,0,19,6,90061740,3636,62929800,2539,29727
2338,9,0,18,7,90095100,3636,62929800,2538,29736
2339,7,0,16,9,90130020,3636,62929800,2537,29743
2340,11,0,20,5,90157320,3636,62929800,2536,29754
2341,10,0,20,5,90199560,3636,62929800,2535,29764
2342,11,0,22,3,90239400,3637,62929800,2534,29775
2343,11,0,22,3,90280440,3637,62929800,2533,29786
2344,13,1,19,6,90339420,3637,62929800,2531,29799
2345,5,0,16,9,90382380,3637,62930460,2531,29804
2346,9,0,20,5,90397140,3637,62930460,2530,29813
2347,7,0,19,6,90442500,3638,62930460,2529,29820
2348,8,0,15,10,90505140,3639,62930460,2528,29828
2349,11,0,15,10,90541620,3638,62930460,2527,29839
2350,7,0,17,8,90558960,3638,62930460,2527,29846
2351,11,0,20,5,90592200,3639,62930460,2525,29857
2352,7,0,18,7,90630540,3639,62930460,2525,29864
2353,6,0,16,9,90676200,3640,62930460,2524,29870
2354,11,0,18,7,90695520,3639,62930460,2523,29881
2355,18,0,23,2,90730860,3638,62930460,2521,29899
2356,26,14,25,0,90765960,3638,62937600,2519,29925
2357,33,40,20,5,90812460,3639,62940840,2516,29958
2358,31,40,25,0,90876720,3640,62974140,2516,29989
2359,39,39,25,0,90914400,3641,62996880,2516,30028
2360,20,39,25,0,90980100,3641,63037740,2517,30048
2361,34,37,25,0,91056660,3642,63111840,2518,30082
2362,28,40,25,0,91119360,3642,63211860,2520,30110
2363,23,40,25,0,91146360,3642,63266100,2521,30133
2364,30,36,25,0,91239540,3642,63302820,2521,30163
2365,37,39,25,0,91291800,3642,63318300,2520,30200
2366,25,38,25,0,91359240,3643,63365460,2520,30225
2367,40,38,25,0,91420800,3642,63395100,2519,30265
2368,32,40,25,0,91460820,3641,63468540,2520,30297
2369,35,40,22,3,91524720,3641,63528120,2521,30332
2370,35,39,24,1,91581480,3641,63554100,2520,30367
2371,33,39,25,0,91647780,3642,63598560,2521,30400
2372,26,39,25,0,91701000,3641,63763560,2525,30426
2373,36,40,25,0,91756800,3641,63792480,2525,30462
2374,33,38,25,0,91840320,3641,63849840,2525,30495
2375,35,40,25,0,91876680,3641,63856440,2524,30530
2376,27,34,25,0,91948020,3641,63921420,2525,30557
2377,25,33,25,0,92025360,3640,64321440,2539,30582
2378,36,40,25,0,92067420,3640,64329360,2536,30618
2379,27,40,25,0,92140260,3640,64352940,2536,30645
2380,37,39,25,0,92189520,3639,64462380,2538,30682
2381,24,40,25,0,92242440,3639,64549500,2540,30706
2382,24,39,25,0,92290380,3639,64580940,2540,30730
2383,20,21,25,0,92395740,3638,65580540,2578,30750
2384,30,35,23,2,92427600,3637,65765700,2583,30780
2385,28,39,25,0,92486460,3638,65787720,2581,30808
2386,25,40,25,0,92514240,3638,65798280,2581,30833
2387,29,35,25,0,92623380,3640,65883660,2583,30862
2388,30,39,25,0,92682480,3640,65896020,2581,30892
2389,36,40,25,0,92719080,3639,65910300,2580,30928
2390,39,39,25,0,92784360,3639,65983680,2581,30967
2391,28,40,25,0,92837220,3639,66049980,2583,30995
2392,24,36,25,0,92930220,3640,66127020,2584,31019
2393,35,40,25,0,92970240,3639,66134820,2582,31054
2394,36,37,25,0,93042720,3639,66184680,2582,31090
2395,33,40,25,0,93096960,3638,66210120,2581,31123
2396,36,40,25,0,93163680,3638,66227160,2580,31159
2397,32,37,25,0,93228480,3638,66313200,2581,31191
2398,32,38,25,0,93276960,3638,66321180,2580,31223
2399,27,39,25,0,93354600,3638,66396900,2581,31250

