Hour,Arrivals,Waiting,Treating,Available Rooms,Total Treatment Time,Average Treatment Time,Total Wait Time,Average Wait Time,Total Arrivals
1,6,0,5,20,960,960,0,0,6
2,4,0,3,22,22980,3282,0,0,10
3,3,0,4,21,27120,3013,0,0,13
4,7,0,6,19,41160,2940,0,0,20
5,10,0,12,13,56160,3120,0,0,30
6,6,0,7,18,105900,3651,0,0,36
7,8,0,9,16,133440,3812,0,0,44
8,7,0,7,18,149280,3392,0,0,51
9,8,0,6,19,190020,3585,0,0,59
10,10,0,8,17,214440,3515,0,0,69
11,11,0,9,16,237000,3338,0,0,80
12,16,0,14,11,271140,3306,0,0,96
13,9,0,10,15,312780,3292,0,0,105
14,9,0,9,16,354180,3373,0,0,114
15,7,0,11,14,372720,3388,0,0,121
16,12,0,13,12,424260,3535,0,0,133
17,8,0,10,15,457140,3489,0,0,141
18,5,0,4,21,502140,3536,0,0,146
19,9,0,5,20,529740,3531,0,0,155
20,10,0,8,17,543720,3463,0,0,165
21,5,0,5,20,569520,3451,0,0,170
22,3,0,5,20,582120,3465,0,0,173
23,7,0,5,20,608460,3476,0,0,180
24,4,0,3,22,626760,3462,0,0,184
25,7,0,9,16,631260,3468,0,0,191
26,5,0,7,18,660240,3493,0,0,196
27,5,0,6,19,678840,3481,0,0,201
28,8,0,8,17,697080,3468,0,0,209
29,11,0,9,16,730620,3462,0,0,220
30,7,0,8,17,760140,3470,0,0,227
31,11,0,7,18,808620,3500,0,0,238
32,7,0,8,17,822660,3471,0,0,245
33,6,0,7,18,853020,3495,0,0,251
34,9,0,9,16,887220,3534,0,0,260
35,12,0,12,13,906900,3488,0,0,272
36,6,0,8,17,948120,3511,0,0,278
37,13,0,12,13,979200,3509,0,0,291
38,6,0,6,19,1016280,3492,0,0,297
39,15,0,15,10,1043580,3513,0,0,312
40,13,0,10,15,1099380,3490,0,0,325
41,17,0,14,11,1136100,3463,0,0,342
42,12,0,9,16,1177500,3413,0,0,354
43,10,0,8,17,1217520,3420,0,0,364
44,6,0,9,16,1228440,3402,0,0,370
45,7,0,7,18,1265340,3419,0,0,377
46,3,0,5,20,1296540,3457,0,0,380
47,7,0,8,17,1309680,3455,0,0,387
48,6,0,6,19,1345140,3475,0,0,393
49,3,0,1,24,1372080,3473,0,0,396
50,4,0,2,23,1382340,3473,0,0,400
51,6,0,5,20,1386960,3458,0,0,406
52,7,0,8,17,1395540,3445,0,0,413
53,7,0,7,18,1422540,3444,0,0,420
54,6,0,5,20,1445460,3433,0,0,426
55,13,0,8,17,1470780,3412,0,0,439
56,8,0,9,16,1489500,3400,0,0,447
57,7,0,5,20,1524300,3394,0,0,454
58,8,0,8,17,1545840,3404,0,0,462
59,12,0,9,16,1573200,3383,0,0,474
60,10,0,13,12,1591980,3380,0,0,484
61,14,0,14,11,1655820,3421,0,0,498
62,12,0,19,6,1676460,3414,0,0,510
63,9,0,8,17,1771320,3466,0,0,519
64,13,0,12,13,1795200,3452,0,0,532
65,11,0,12,13,1846020,3476,0,0,543
66,10,0,11,14,1888380,3484,0,0,553
67,9,0,10,15,1918920,3476,0,0,562
68,5,0,8,17,1951860,3491,0,0,567
69,7,0,7,18,1986420,3503,0,0,574
70,3,0,6,19,2005140,3511,0,0,577
71,5,0,5,20,2024160,3508,0,0,582
72,5,0,5,20,2049600,3521,0,0,587
73,2,0,5,20,2057580,3523,0,0,589
74,10,0,10,15,2074920,3522,0,0,599
75,5,0,6,19,2101920,3514,0,0,604
76,5,0,5,20,2125980,3519,0,0,609
77,5,0,9,16,2127000,3515,0,0,614
78,8,0,9,16,2164020,3530,0,0,622
79,5,0,6,19,2194200,3533,0,0,627
80,7,0,9,16,2209800,3535,0,0,634
81,10,0,11,14,2236380,3532,0,0,644
82,8,0,8,17,2278980,3538,0,0,652
83,8,0,9,16,2303220,3537,0,0,660
84,9,0,8,17,2335320,3533,0,0,669
85,13,0,11,14,2362620,3521,0,0,682
86,10,0,8,17,2397120,3504,0,0,692
87,10,0,10,15,2421000,3498,0,0,702
88,12,0,11,14,2459880,3499,0,0,714
89,7,0,8,17,2499900,3506,0,0,721
90,1,0,4,21,2519880,3509,0,0,722
91,6,0,4,21,2548080,3519,0,0,728
92,7,0,5,20,2573700,3525,0,0,735
93,4,0,4,21,2588160,3521,0,0,739
94,8,0,8,17,2597820,3515,0,0,747
95,12,0,13,12,2616780,3507,0,0,759
96,9,0,11,14,2653080,3504,0,0,768
97,10,0,15,10,2670660,3500,0,0,778
98,9,0,9,16,2726460,3504,0,0,787
99,6,0,6,19,2777160,3528,0,0,793
100,6,0,5,20,2807100,3535,0,0,799
101,4,0,6,19,2820240,3538,0,0,803
102,8,0,5,20,2846880,3532,0,0,811
103,12,0,11,14,2857500,3519,0,0,823
104,10,0,10,15,2884440,3504,0,0,833
105,9,0,10,15,2923800,3514,0,0,842
106,9,0,8,17,2957940,3508,0,0,851
107,9,0,7,18,2995620,3511,0,0,860
108,12,0,11,14,3009180,3494,0,0,872
109,13,0,15,10,3040620,3494,0,0,885
110,6,0,8,17,3086100,3495,0,0,891
111,13,0,12,13,3118440,3496,0,0,904
112,7,0,10,15,3151140,3497,0,0,911
113,12,0,10,15,3193080,3497,0,0,923
114,15,0,11,14,3241740,3497,0,0,938
115,9,0,10,15,3274260,3494,0,0,947
116,5,0,6,19,3310440,3499,0,0,952
117,6,0,7,18,3337740,3509,0,0,958
118,6,0,8,17,3358200,3512,0,0,964
119,11,0,8,17,3400020,3516,0,0,975
120,3,0,5,20,3416940,3511,0,0,978
121,2,0,3,22,3446460,3527,0,0,980
122,6,0,8,17,3447600,3525,0,0,986
123,8,0,6,19,3479880,3522,0,0,994
124,5,0,4,21,3503760,3521,0,0,999
125,8,0,7,18,3520560,3520,0,0,1007
126,10,0,8,17,3539160,3507,0,0,1017
127,7,0,7,18,3577980,3518,0,0,1024
128,11,0,12,13,3598320,3517,0,0,1035
129,11,0,9,16,3643080,3513,0,0,1046
130,7,0,7,18,3681840,3519,0,0,1053
131,10,0,9,16,3715500,3525,0,0,1063
132,10,0,13,12,3733560,3522,0,0,1073
133,8,0,7,18,3780840,3520,0,0,1081
134,9,0,6,19,3812460,3517,0,0,1090
135,8,0,7,18,3837540,3517,0,0,1098
136,10,0,7,18,3863220,3508,0,0,1108
137,7,0,3,22,3903720,3510,0,0,1115
138,3,0,4,21,3908640,3508,0,0,1118
139,7,0,8,17,3921840,3511,0,0,1125
140,8,0,5,20,3957480,3508,0,0,1133
141,6,0,3,22,3976500,3500,0,0,1139
142,6,0,6,19,3982980,3496,0,0,1145
143,4,0,4,21,4000140,3493,0,0,1149
144,8,0,5,20,4018020,3487,0,0,1157
145,7,0,7,18,4042860,3494,0,0,1164
146,6,0,7,18,4063320,3493,0,0,1170
147,5,0,6,19,4096620,3504,0,0,1175
148,6,0,7,18,4119720,3509,0,0,1181
149,3,0,3,22,4149300,3513,0,0,1184
150,2,0,4,21,4157040,3516,0,0,1186
151,10,0,9,16,4178400,3520,0,0,1196
152,7,0,9,16,4208880,3525,0,0,1203
153,9,0,11,14,4232100,3523,0,0,1212
154,9,0,12,13,4264500,3527,0,0,1221
155,10,0,11,14,4302900,3526,0,0,1231
156,12,0,10,15,4359000,3535,0,0,1243
157,8,0,12,13,4375080,3531,0,0,1251
158,16,0,15,10,4421340,3531,0,0,1267
159,14,0,13,12,4474860,3529,0,0,1281
160,15,0,7,18,4535820,3518,0,0,1296
161,10,0,13,12,4549260,3518,0,0,1306
162,9,0,12,13,4589880,3522,0,0,1315
163,7,0,7,18,4637760,3526,0,0,1322
164,9,0,6,19,4678140,3530,0,0,1331
165,5,0,5,20,4704840,3534,0,0,1336
166,6,0,7,18,4716780,3533,0,0,1342
167,5,0,4,21,4741500,3530,0,0,1347
168,6,0,5,20,4755840,3528,0,0,1353
169,15,0,9,16,4782420,3519,0,0,1368
170,8,0,11,14,4801560,3517,0,0,1376
171,7,0,5,20,4848600,3518,0,0,1383
172,1,0,2,23,4870620,3524,0,0,1384
173,10,0,5,20,4891440,3521,0,0,1394
174,6,0,7,18,4902840,3519,0,0,1400
175,5,0,5,20,4930020,3521,0,0,1405
176,6,0,4,21,4960020,3525,0,0,1411
177,13,0,10,15,4976820,3519,0,0,1424
178,6,0,5,20,5004000,3511,0,0,1430
179,11,0,7,18,5018700,3499,0,0,1441
180,9,0,7,18,5040540,3493,0,0,1450
181,15,0,11,14,5067840,3485,0,0,1465
182,11,0,7,18,5122800,3487,0,0,1476
183,12,0,13,12,5144400,3487,0,0,1488
184,8,0,9,16,5191980,3491,0,0,1496
185,11,0,11,14,5219220,3488,0,0,1507
186,9,0,11,14,5261580,3496,0,0,1516
187,11,0,12,13,5302920,3500,0,0,1527
188,7,1,13,12,5317380,3498,0,0,1534
189,7,0,10,15,5381760,3515,720,0,1541
190,7,0,11,14,5405940,3517,720,0,1548
191,7,0,5,20,5460540,3522,720,0,1555
192,4,0,4,21,5477340,3522,720,0,1559
193,7,0,7,18,5497380,3526,720,0,1566
194,7,0,10,15,5512680,3526,720,0,1573
195,9,0,9,16,5554860,3531,720,0,1582
196,12,0,12,13,5585280,3530,720,0,1594
197,9,0,14,11,5628360,3542,720,0,1603
198,8,0,7,18,5695740,3550,720,0,1611
199,8,0,5,20,5722920,3545,720,0,1619
200,13,0,8,17,5743200,3536,720,0,1632
201,7,0,9,16,5757900,3532,720,0,1639
202,9,0,9,16,5794620,3535,720,0,1648
203,11,0,12,13,5823480,3535,720,0,1659
204,10,0,8,17,5864340,3530,720,0,1669
205,12,0,10,15,5901960,3531,720,0,1681
206,9,0,7,18,5935260,3526,720,0,1690
207,10,0,9,16,5962680,3526,720,0,1700
208,9,0,7,18,6001140,3525,720,0,1709
209,18,0,16,9,6028680,3523,720,0,1727
210,9,0,11,14,6074580,3521,720,0,1736
211,7,0,6,19,6117960,3522,720,0,1743
212,11,0,4,21,6150600,3514,720,0,1754
213,6,0,6,19,6156000,3509,720,0,1760
214,4,0,3,22,6184080,3511,720,0,1764
215,10,0,10,15,6190680,3509,720,0,1774
216,2,0,6,19,6215340,3511,720,0,1776
217,7,0,5,20,6253980,3517,720,0,1783
218,4,0,4,21,6264660,3513,720,0,1787
219,3,0,4,21,6279780,3516,720,0,1790
220,10,0,9,16,6293220,3513,720,0,1800
221,3,0,5,20,6320700,3515,720,0,1803
222,11,0,9,16,6346320,3515,720,0,1814
223,4,0,9,16,6365220,3518,720,0,1818
224,5,0,5,20,6408060,3524,720,0,1823
225,11,0,10,15,6422700,3521,720,0,1834
226,9,0,8,17,6452220,3516,720,0,1843
227,9,0,9,16,6465600,3508,720,0,1852
228,13,0,11,14,6505080,3508,720,0,1865
229,17,0,17,8,6536520,3504,720,0,1882
230,4,0,7,18,6587340,3505,720,0,1886
231,11,0,6,19,6622200,3501,720,0,1897
232,18,0,14,11,6641520,3493,720,0,1915
233,11,0,13,12,6674580,3489,720,0,1926
234,7,0,6,19,6738240,3496,720,0,1933
235,8,0,6,19,6752040,3489,720,0,1941
236,1,0,3,22,6767640,3490,720,0,1942
237,5,0,3,22,6779280,3487,720,0,1947
238,6,0,6,19,6795960,3490,720,0,1953
239,5,0,8,17,6807060,3490,720,0,1958
240,8,0,10,15,6836880,3495,720,0,1966
241,5,0,10,15,6865680,3501,720,0,1971
242,5,0,9,16,6893460,3504,720,0,1976
243,4,0,8,17,6925500,3511,720,0,1980
244,5,0,5,20,6968340,3519,720,0,1985
245,5,0,5,20,6988080,3520,720,0,1990
246,7,0,6,19,7016700,3524,720,0,1997
247,6,0,6,19,7037280,3523,720,0,2003
248,7,0,7,18,7050540,3519,720,0,2010
249,11,0,8,17,7083660,3518,720,0,2021
250,12,0,12,13,7106460,3516,720,0,2033
251,14,0,13,12,7162380,3521,720,0,2047
252,3,0,7,18,7198920,3523,720,0,2050
253,19,0,13,12,7237080,3519,720,0,2069
254,13,0,16,9,7269900,3518,720,0,2082
255,17,0,15,10,7345680,3524,720,0,2099
256,5,0,4,21,7415160,3531,720,0,2104
257,11,0,10,15,7438260,3533,720,0,2115
258,5,0,4,21,7464120,3527,720,0,2120
259,5,0,3,22,7486500,3528,720,0,2125
260,8,0,7,18,7490640,3523,720,0,2133
261,7,0,10,15,7498020,3520,720,0,2140
262,4,0,9,16,7521180,3522,720,0,2144
263,5,0,4,21,7571280,3529,720,0,2149
264,5,0,3,22,7597800,3532,720,0,2154
265,7,0,7,18,7608540,3532,720,0,2161
266,6,0,10,15,7626360,3535,720,0,2167
267,3,0,6,19,7660920,3540,720,0,2170
268,9,0,10,15,7686960,3544,720,0,2179
269,5,0,7,18,7710900,3541,720,0,2184
270,6,0,5,20,7747260,3545,720,0,2190
271,8,0,4,21,7771260,3542,720,0,2198
272,10,0,7,18,7793220,3540,720,0,2208
273,10,0,11,14,7815900,3541,720,0,2218
274,5,0,3,22,7861800,3541,720,0,2223
275,6,0,6,19,7878120,3543,720,0,2229
276,13,0,13,12,7894860,3541,720,0,2242
277,10,0,13,12,7917420,3536,720,0,2252
278,11,0,14,11,7959480,3539,720,0,2263
279,13,0,13,12,8020620,3544,720,0,2276
280,14,0,13,12,8059080,3539,720,0,2290
281,11,0,9,16,8113620,3539,720,0,2301
282,7,0,8,17,8147400,3542,720,0,2308
283,6,0,9,16,8166360,3542,720,0,2314
284,5,0,5,20,8206020,3546,720,0,2319
285,10,0,5,20,8237640,3544,720,0,2329
286,7,0,5,20,8248620,3538,720,0,2336
287,6,0,4,21,8275260,3539,720,0,2342
288,6,0,5,20,8285400,3536,720,0,2348
289,5,0,4,21,8301840,3534,720,0,2353
290,4,0,5,20,8319660,3537,720,0,2357
291,5,0,3,22,8338440,3534,720,0,2362
292,9,0,10,15,8339700,3532,720,0,2371
293,3,0,5,20,8371620,3533,720,0,2374
294,8,0,4,21,8403660,3533,720,0,2382
295,9,0,10,15,8408400,3531,720,0,2391
296,5,0,7,18,8444760,3534,720,0,2396
297,6,0,6,19,8480340,3539,720,0,2402
298,5,0,7,18,8497860,3540,720,0,2407
299,12,0,9,16,8521320,3535,720,0,2419
300,10,0,10,15,8551920,3535,720,0,2429
301,8,0,8,17,8589120,3536,720,0,2437
302,6,0,8,17,8617920,3539,720,0,2443
303,10,0,9,16,8647500,3538,720,0,2453
304,15,0,9,16,8689560,3533,720,0,2468
305,12,0,16,9,8704620,3532,720,0,2480
306,6,0,7,18,8749380,3529,720,0,2486
307,7,0,6,19,8776560,3528,720,0,2493
308,6,0,8,17,8798700,3532,720,0,2499
309,4,0,2,23,8828760,3530,720,0,2503
310,9,0,8,17,8838600,3529,720,0,2512
311,2,0,5,20,8849700,3527,720,0,2514
312,5,0,7,18,8871660,3531,720,0,2519
313,7,0,6,19,8901360,3532,720,0,2526
314,5,0,4,21,8917560,3528,720,0,2531
315,5,0,7,18,8928060,3530,720,0,2536
316,0,0,1,24,8953020,3531,720,0,2536
317,4,0,2,23,8962980,3531,720,0,2540
318,6,0,3,22,8972520,3528,720,0,2546
319,6,0,7,18,8982720,3529,720,0,2552
320,13,0,10,15,9001320,3523,720,0,2565
321,13,0,10,15,9037920,3519,720,0,2578
322,9,0,10,15,9061800,3516,720,0,2587
323,11,0,13,12,9089820,3516,720,0,2598
324,10,0,10,15,9142020,3518,720,0,2608
325,11,0,9,16,9179640,3517,720,0,2619
326,9,0,12,13,9197100,3515,720,0,2628
327,5,0,10,15,9230700,3519,720,0,2633
328,13,0,15,10,9269760,3523,720,0,2646
329,14,0,17,8,9321720,3526,720,0,2660
330,13,0,7,18,9403860,3527,720,0,2673
331,7,0,8,17,9434160,3530,720,0,2680
332,7,0,6,19,9462300,3529,720,0,2687
333,9,0,5,20,9500220,3530,720,0,2696
334,6,0,8,17,9510480,3530,720,0,2702
335,3,0,3,22,9536220,3529,720,0,2705
336,6,0,3,22,9559140,3529,720,0,2711
337,8,0,9,16,9564240,3529,720,0,2719
338,13,0,14,11,9587280,3527,720,0,2732
339,22,0,18,7,9648660,3526,720,0,2754
340,29,1,25,0,9695280,3516,720,0,2783
341,35,17,25,0,9765300,3517,10140,3,2818
342,23,27,25,0,9831900,3525,29160,10,2841
343,41,39,19,6,9942480,3538,45660,15,2882
344,31,40,13,12,9977340,3543,45660,15,2913
345,30,38,25,0,10045560,3549,140700,48,2943
346,28,28,25,0,10148580,3538,294300,100,2971
347,31,26,25,0,10243560,3531,396780,134,3002
348,32,33,22,3,10337700,3529,434880,145,3034
349,35,38,21,4,10413240,3537,456000,151,3069
350,32,40,25,0,10463220,3542,471960,156,3101
351,28,21,25,0,10574700,3528,940920,309,3129
352,28,4,25,0,10675320,3509,1194000,388,3157
353,35,12,25,0,10745220,3501,1247880,401,3192
354,32,28,25,0,10824180,3508,1261380,402,3224
355,37,40,24,1,10894440,3516,1267860,401,3261
356,28,39,25,0,11008500,3531,1294260,407,3289
357,27,40,24,1,11088600,3538,1320300,413,3316
358,21,36,25,0,11178540,3549,1440180,448,3337
359,31,39,25,0,11273100,3553,1478160,456,3368
360,33,40,21,4,11368020,3555,1507380,462,3401
361,22,39,14,11,11435580,3560,1513080,463,3423
362,17,22,25,0,11488680,3551,1964880,598,3440
363,27,18,25,0,11576220,3544,2107200,636,3467
364,27,19,25,0,11664600,3543,2247000,673,3494
365,22,24,25,0,11749260,3550,2259720,673,3516
366,43,40,25,0,11828460,3556,2271240,669,3559
367,19,40,25,0,11916240,3564,2303820,676,3578
368,27,28,25,0,12042660,3560,2487000,724,3605
369,28,26,25,0,12118860,3551,2710500,782,3633
370,29,38,16,9,12192540,3555,2723100,781,3662
371,29,40,23,2,12241080,3560,2748540,785,3691
372,27,37,25,0,12353340,3566,2856240,810,3718
373,27,33,25,0,12438300,3558,3018960,849,3745
374,28,36,25,0,12540120,3562,3031380,846,3773
375,28,40,25,0,12615600,3565,3054480,848,3801
376,37,40,25,0,12696600,3566,3096540,854,3838
377,33,37,25,0,12803160,3567,3235980,886,3871
378,32,40,25,0,12876120,3570,3241680,883,3903
379,25,26,25,0,12991680,3573,3523740,955,3928
380,23,12,25,0,13081260,3561,4068480,1096,3951
381,38,24,25,0,13173240,3561,4116060,1098,3989
382,26,40,15,10,13236960,3565,4116420,1094,4015
383,30,40,25,0,13317600,3574,4144440,1093,4045
384,35,39,25,0,13397100,3575,4218000,1106,4080
385,38,39,25,0,13516260,3578,4288440,1116,4118
386,30,40,24,1,13571100,3576,4309260,1117,4148
387,29,37,24,1,13648680,3581,4406460,1138,4177
388,34,40,23,2,13739580,3581,4467360,1146,4211
389,30,37,25,0,13828980,3589,4547520,1162,4241
390,34,35,25,0,13925340,3592,4614120,1172,4275
391,30,33,25,0,14005860,3591,4708260,1189,4305
392,34,40,21,4,14072460,3588,4893000,1229,4339
393,30,40,22,3,14135940,3593,4921320,1232,4369
394,30,39,22,3,14220480,3596,4956240,1234,4399
395,27,29,25,0,14319420,3590,5350140,1323,4426
396,36,34,21,4,14410560,3582,5936400,1456,4462
397,32,39,25,0,14487660,3586,5959320,1452,4494
398,23,22,25,0,14595480,3578,6356220,1540,4517
399,28,0,20,5,14685300,3552,6756180,1626,4545
400,24,0,19,6,14749440,3546,6756180,1617,4569
401,27,0,25,0,14810220,3543,6756540,1606,4596
402,31,14,19,6,14908500,3547,6759060,1596,4627
403,28,40,12,13,14944320,3548,6760980,1592,4655
404,29,38,20,5,15015480,3557,6797460,1588,4684
405,34,40,25,0,15060600,3558,6846780,1593,4718
406,26,40,25,0,15158280,3563,6927120,1605,4744
407,43,40,25,0,15251760,3569,6936660,1599,4787
408,40,39,25,0,15359700,3574,7017540,1609,4827
409,29,38,25,0,15448800,3573,7116180,1623,4856
410,35,40,25,0,15503820,3570,7134420,1619,4891
411,32,39,25,0,15595860,3573,7151520,1615,4923
412,39,40,19,6,15706020,3574,7238520,1627,4962
413,32,38,18,7,15766020,3578,7258920,1626,4994
414,30,39,12,13,15827460,3575,7332240,1637,5024
415,36,35,25,0,15892980,3573,7454580,1654,5060
416,33,39,25,0,15985260,3572,7496100,1652,5093
417,30,31,25,0,16080960,3563,7673400,1679,5123
418,35,33,25,0,16172280,3557,7927980,1722,5158
419,30,40,25,0,16234920,3559,7934640,1715,5188
420,32,37,25,0,16338660,3562,8026620,1726,5220
421,33,40,23,2,16415520,3566,8037840,1723,5253
422,26,31,23,2,16507500,3572,8134860,1740,5279
423,39,40,17,8,16578540,3569,8208720,1748,5318
424,28,39,22,3,16640580,3574,8226180,1744,5346
425,26,31,25,0,16735020,3575,8475900,1789,5372
426,33,32,25,0,16830480,3571,8775420,1840,5405
427,40,38,19,6,16906920,3573,8806440,1839,5445
428,35,40,22,3,16944720,3575,8825820,1839,5480
429,37,33,25,0,17077140,3578,9098160,1884,5517
430,39,40,22,3,17134860,3574,9105120,1876,5556
431,36,40,25,0,17228940,3581,9202080,1887,5592
432,41,40,25,0,17330160,3582,9238620,1885,5633
433,31,38,25,0,17416500,3579,9297120,1886,5664
434,35,39,25,0,17491920,3576,9336540,1884,5699
435,37,40,25,0,17586180,3580,9343080,1878,5736
436,36,40,25,0,17682600,3581,9385260,1876,5772
437,25,23,25,0,17788260,3579,10284000,2049,5797
438,31,20,25,0,17868780,3570,10689000,2118,5828
439,32,35,21,4,17949840,3572,10706340,2107,5860
440,25,40,25,0,18007740,3575,10729740,2104,5885
441,22,38,25,0,18094800,3578,10788600,2107,5907
442,28,30,25,0,18229980,3580,11240760,2184,5935
443,43,40,14,11,18272640,3575,11243820,2177,5978
444,35,40,25,0,18339960,3579,11352900,2189,6013
445,32,40,25,0,18416580,3573,11454720,2196,6045
446,31,36,25,0,18521220,3574,11517420,2197,6076
447,40,40,25,0,18599280,3575,11528280,2189,6116
448,30,40,13,12,18687120,3574,11572620,2191,6146
449,26,33,24,1,18736140,3576,11729580,2215,6172
450,29,22,25,0,18817800,3566,12737640,2392,6201
451,30,23,25,0,18907020,3563,12942120,2418,6231
452,29,33,25,0,18987600,3565,12946500,2405,6260
453,28,38,25,0,19088580,3569,12986100,2400,6288
454,36,40,25,0,19181700,3572,12999660,2392,6324
455,40,40,25,0,19265700,3567,13075560,2393,6364
456,33,40,23,2,19352520,3565,13131300,2392,6397
457,26,31,25,0,19435980,3564,13283340,2411,6423
458,28,31,25,0,19534680,3564,13429320,2426,6451
459,21,29,25,0,19613640,3563,13484220,2426,6472
460,29,20,25,0,19713900,3557,13892400,2487,6501
461,37,40,24,1,19768860,3558,13898640,2473,6538
462,29,39,25,0,19877520,3566,13932360,2471,6567
463,28,39,25,0,19960560,3567,13961280,2467,6595
464,32,36,25,0,20050920,3570,14005920,2467,6627
465,32,40,25,0,20139780,3568,14179020,2484,6659
466,28,40,25,0,20227680,3571,14254920,2489,6687
467,29,39,25,0,20313600,3576,14261340,2483,6716
468,35,39,24,1,20396520,3575,14301360,2480,6751
469,28,38,24,1,20491380,3579,14372160,2483,6779
470,31,36,20,5,20557260,3578,14449140,2490,6810
471,33,40,20,5,20632560,3577,14586600,2504,6843
472,32,40,16,9,20727180,3582,14634600,2505,6875
473,35,40,25,0,20790180,3582,14670660,2500,6910
474,37,38,25,0,20882280,3584,14716140,2498,6947
475,29,40,25,0,20963040,3585,14741280,2494,6976
476,28,39,25,0,21057000,3584,14814240,2495,7004
477,24,40,20,5,21120300,3587,14817480,2492,7028
478,36,38,25,0,21223140,3590,14900460,2494,7064
479,34,35,25,0,21331140,3589,15051600,2508,7098
480,28,40,21,4,21411720,3587,15138060,2512,7126
481,24,37,25,0,21471780,3588,15174540,2510,7150
482,32,29,25,0,21601500,3586,15563820,2561,7182
483,38,40,25,0,21658080,3586,15576960,2552,7220
484,34,36,25,0,21740220,3589,15614460,2552,7254
485,30,37,25,0,21828720,3588,15765600,2565,7284
486,38,37,25,0,21946860,3593,15781680,2558,7322
487,21,34,25,0,22019400,3592,15897780,2569,7343
488,29,40,20,5,22103220,3591,16043100,2583,7372
489,28,40,13,12,22170420,3596,16052820,2582,7400
490,26,40,13,12,22231260,3600,16075800,2581,7426
491,32,38,25,0,22280820,3600,16197360,2591,7458
492,22,18,25,0,22364340,3589,17745180,2829,7480
493,30,40,15,10,22434600,3591,17748420,2821,7510
494,37,39,14,11,22500240,3596,17764260,2815,7547
495,27,35,25,0,22568700,3598,17830860,2816,7574
496,28,37,25,0,22665540,3599,17879280,2812,7602
497,24,32,25,0,22739820,3595,18005340,2821,7626
498,36,40,24,1,22814760,3598,18015480,2814,7662
499,32,39,21,4,22904460,3603,18036540,2810,7694
500,27,20,25,0,23022720,3597,19000380,2948,7721
501,35,40,17,8,23089740,3595,19078020,2945,7756
502,28,40,24,1,23133720,3598,19099260,2942,7784
503,17,37,25,0,23230260,3605,19138260,2942,7801
504,16,30,25,0,23329800,3608,19250400,2952,7817
505,3,0,9,16,23439840,3597,20085600,3078,7820
506,4,0,6,19,23483940,3600,20085600,3076,7824
507,5,0,2,23,23519640,3601,20085600,3074,7829
508,2,0,2,23,23524080,3600,20085600,3073,7831
509,3,0,3,22,23534340,3601,20085600,3072,7834
510,3,0,2,23,23544840,3600,20085600,3070,7837
511,7,0,6,19,23551500,3600,20085600,3067,7844
512,11,0,6,19,23579400,3598,20085600,3062,7855
513,11,0,9,16,23604420,3597,20085600,3057,7866
514,8,0,10,15,23615520,3595,20085600,3053,7874
515,6,0,11,14,23648040,3597,20085600,3050,7880
516,9,0,9,16,23696280,3599,20085600,3046,7889
517,14,0,13,12,23725440,3598,20085600,3040,7903
518,13,0,12,13,23773680,3597,20085600,3034,7916
519,11,0,11,14,23808360,3596,20085600,3029,7927
520,9,0,10,15,23846580,3596,20085600,3024,7936
521,5,0,7,18,23884440,3598,20085600,3022,7941
522,13,0,11,14,23914680,3597,20085600,3016,7954
523,10,0,15,10,23937960,3598,20085600,3012,7964
524,9,0,13,12,23988180,3599,20085600,3008,7973
525,4,0,8,17,24032280,3601,20085600,3006,7977
526,7,0,9,16,24061380,3602,20085600,3003,7984
527,2,0,2,23,24096120,3602,20085600,3002,7986
528,4,0,3,22,24108540,3603,20085600,3000,7990
529,2,0,3,22,24114540,3602,20085600,2999,7992
530,7,0,4,21,24129600,3601,20085600,2996,7999
531,4,0,4,21,24147900,3602,20085600,2994,8003
532,7,0,6,19,24158280,3601,20085600,2991,8010
533,4,0,6,19,24176820,3602,20085600,2989,8014
534,10,0,10,15,24194160,3601,20085600,2985,8024
535,8,0,6,19,24239700,3601,20085600,2981,8032
536,4,0,3,22,24260220,3601,20085600,2980,8036
537,8,0,6,19,24267660,3599,20085600,2976,8044
538,13,0,15,10,24281100,3599,20085600,2970,8057
539,9,0,13,12,24314160,3598,20085600,2966,8066
540,18,0,17,8,24387600,3601,20085600,2958,8084
541,14,0,17,8,24433860,3601,20085600,2952,8098
542,5,0,7,18,24480780,3600,20085600,2950,8103
543,10,0,9,16,24501660,3598,20085600,2946,8113
544,7,0,4,21,24548580,3599,20085600,2943,8120
545,12,0,10,15,24567720,3599,20085600,2938,8132
546,10,0,10,15,24601440,3598,20085600,2933,8142
547,8,0,10,15,24622440,3597,20085600,2930,8150
548,10,0,12,13,24663540,3599,20085600,2926,8160
549,3,0,7,18,24698820,3600,20085600,2924,8163
550,3,0,4,21,24738960,3603,20085600,2923,8166
551,5,0,5,20,24755460,3603,20085600,2921,8171
552,3,0,5,20,24764160,3603,20085600,2920,8174
553,5,0,6,19,24792360,3605,20085600,2918,8179
554,4,0,3,22,24816360,3604,20085600,2916,8183
555,11,0,8,17,24831300,3603,20085600,2911,8194
556,6,0,5,20,24856080,3602,20085600,2909,8200
557,3,0,6,19,24865200,3603,20085600,2908,8203
558,5,0,6,19,24890040,3604,20085600,2905,8208
559,9,0,10,15,24902580,3603,20085600,2902,8217
560,5,0,4,21,24949920,3604,20085600,2900,8222
561,10,0,7,18,24964800,3602,20085600,2895,8232
562,15,0,8,17,24992640,3599,20085600,2889,8247
563,11,0,13,12,25005300,3598,20085600,2885,8258
564,9,0,11,14,25034940,3596,20085600,2881,8267
565,12,0,12,13,25082280,3598,20085600,2876,8279
566,9,0,8,17,25128120,3597,20085600,2872,8288
567,9,0,10,15,25156800,3598,20085600,2868,8297
568,7,0,9,16,25176840,3597,20085600,2866,8304
569,13,0,12,13,25222320,3598,20085600,2860,8317
570,10,0,10,15,25259280,3597,20085600,2856,8327
571,9,0,11,14,25288800,3597,20085600,2853,8336
572,6,0,6,19,25334040,3598,20085600,2850,8342
573,8,0,10,15,25361400,3600,20085600,2847,8350
574,9,0,12,13,25389540,3600,20085600,2843,8359
575,7,0,8,17,25426920,3600,20085600,2840,8366
576,8,0,6,19,25475400,3602,20085600,2837,8374
577,4,0,6,19,25490040,3602,20085600,2836,8378
578,7,0,2,23,25527480,3602,20085600,2833,8385
579,7,0,6,19,25532100,3601,20085600,2830,8392
580,4,0,5,20,25551960,3601,20085600,2828,8396
581,4,0,4,21,25578540,3602,20085600,2827,8400
582,7,0,8,17,25585860,3602,20085600,2824,8407
583,8,0,10,15,25606440,3601,20085600,2821,8415
584,12,0,12,13,25633560,3600,20085600,2816,8427
585,11,0,10,15,25693320,3602,20085600,2812,8438
586,16,0,15,10,25717440,3600,20085600,2806,8454
587,8,0,14,11,25758900,3601,20085600,2802,8462
588,4,0,10,15,25807080,3604,20085600,2801,8466
589,11,0,12,13,25853340,3606,20085600,2797,8477
590,12,0,15,10,25889280,3606,20085600,2792,8489
591,10,0,12,13,25940940,3607,20085600,2788,8499
592,12,0,11,14,26000820,3609,20085600,2783,8511
593,12,0,13,12,26047680,3610,20085600,2779,8523
594,2,0,8,17,26084760,3612,20085600,2778,8525
595,7,0,8,17,26126880,3614,20085600,2775,8532
596,5,0,4,21,26156220,3614,20085600,2773,8537
597,9,0,9,16,26171400,3614,20085600,2770,8546
598,6,0,6,19,26201640,3614,20085600,2768,8552
599,12,0,11,14,26228940,3614,20085600,2763,8564
600,1,0,4,21,26254020,3613,20085600,2763,8565
601,4,0,5,20,26281920,3616,20085600,2761,8569
602,7,0,7,18,26296560,3615,20085600,2759,8576
603,6,0,6,19,26315820,3614,20085600,2756,8582
604,9,0,9,16,26337900,3614,20085600,2753,8591
605,9,0,8,17,26378160,3615,20085600,2749,8600
606,9,0,9,16,26405940,3615,20085600,2746,8609
607,4,0,6,19,26432880,3615,20085600,2745,8613
608,4,0,5,20,26459280,3616,20085600,2743,8617
609,12,0,8,17,26491260,3616,20085600,2739,8629
610,3,0,3,22,26523420,3616,20085600,2737,8632
611,12,0,12,13,26533320,3616,20085600,2733,8644
612,16,0,16,9,26567460,3615,20085600,2727,8660
613,18,0,14,11,26617920,3612,20085600,2720,8678
614,12,0,14,11,26660640,3612,20085600,2716,8690
615,12,0,10,15,26725680,3613,20085600,2712,8702
616,12,0,13,12,26769060,3614,20085600,2707,8714
617,7,0,14,11,26787120,3614,20085600,2705,8721
618,11,0,14,11,26846640,3617,20085600,2701,8732
619,6,0,10,15,26881740,3617,20085600,2698,8738
620,6,0,5,20,26918520,3616,20085600,2696,8744
621,11,0,8,17,26952720,3617,20085600,2692,8755
622,5,0,4,21,26977920,3616,20085600,2690,8760
623,6,0,7,18,26983680,3615,20085600,2688,8766
624,4,0,8,17,26998380,3616,20085600,2687,8770
625,4,0,6,19,27029460,3617,20085600,2685,8774
626,5,0,4,21,27058740,3617,20085600,2684,8779
627,5,0,6,19,27066360,3617,20085600,2682,8784
628,8,0,10,15,27093300,3619,20085600,2679,8792
629,7,0,8,17,27127440,3619,20085600,2677,8799
630,5,0,4,21,27164640,3620,20085600,2675,8804
631,9,0,8,17,27183300,3620,20085600,2672,8813
632,8,0,13,12,27199620,3620,20085600,2669,8821
633,7,0,8,17,27252120,3622,20085600,2666,8828
634,9,0,10,15,27285360,3623,20085600,2663,8837
635,10,0,8,17,27325800,3622,20085600,2659,8847
636,3,0,4,21,27355260,3623,20085600,2658,8850
637,14,0,10,15,27373620,3621,20085600,2654,8864
638,11,0,9,16,27408360,3620,20085600,2650,8875
639,6,0,5,20,27455520,3622,20085600,2648,8881
640,8,0,6,19,27472020,3620,20085600,2645,8889
641,12,0,10,15,27492180,3619,20085600,2641,8901
642,9,0,6,19,27533640,3619,20085600,2637,8910
643,12,0,9,16,27557880,3617,20085600,2633,8922
644,5,0,9,16,27580260,3618,20085600,2632,8927
645,7,0,7,18,27623580,3619,20085600,2629,8934
646,2,0,5,20,27635040,3619,20085600,2629,8936
647,10,0,7,18,27665520,3619,20085600,2625,8946
648,8,0,5,20,27689760,3618,20085600,2622,8954
649,8,0,8,17,27711000,3618,20085600,2620,8962
650,7,0,4,21,27748380,3618,20085600,2617,8969
651,7,0,6,19,27762360,3617,20085600,2615,8976
652,7,0,9,16,27776520,3617,20085600,2612,8983
653,7,0,8,17,27805620,3617,20085600,2610,8990
654,11,0,10,15,27841920,3618,20085600,2606,9001
655,7,0,5,20,27876960,3617,20085600,2604,9008
656,8,0,8,17,27890340,3616,20085600,2601,9016
657,8,0,7,18,27918360,3615,20085600,2599,9024
658,14,0,14,11,27942600,3615,20085600,2594,9038
659,8,0,9,16,27978900,3614,20085600,2591,9046
660,7,0,10,15,28018320,3616,20085600,2589,9053
661,13,0,8,17,28065180,3615,20085600,2585,9066
662,16,0,13,12,28089480,3613,20085600,2579,9082
663,13,0,10,15,28148520,3613,20085600,2575,9095
664,15,0,15,10,28191720,3614,20085600,2570,9110
665,14,0,16,9,28226940,3613,20085600,2565,9124
666,6,0,4,21,28303680,3614,20085600,2563,9130
667,13,0,14,11,28306320,3613,20085600,2559,9143
668,3,0,10,15,28339740,3614,20085600,2558,9146
669,10,0,8,17,28401360,3617,20085600,2555,9156
670,10,0,12,13,28426440,3617,20085600,2552,9166
671,4,0,5,20,28468140,3617,20085600,2550,9170
672,6,0,8,17,28488120,3618,20085600,2548,9176
673,6,0,14,11,28488120,3618,20085600,2546,9182
674,4,0,12,13,28504080,3618,20085600,2545,9186
675,1,0,9,16,28524060,3618,20085600,2545,9187
676,6,0,13,12,28536720,3619,20085600,2543,9193
677,6,0,12,13,28549080,3617,20085600,2541,9199
678,10,0,17,8,28567800,3618,20085600,2538,9209
679,6,0,15,10,28604220,3618,20085600,2536,9215
680,10,0,16,9,28643160,3619,20085600,2533,9225
681,8,0,15,10,28676820,3619,20085600,2530,9233
682,11,1,19,6,28694220,3619,20085780,2527,9244
683,11,0,18,7,28748040,3620,20087340,2523,9255
684,6,0,17,8,28775460,3620,20087340,2521,9261
685,9,0,17,8,28823220,3622,20088060,2519,9270
686,19,9,19,6,28850580,3622,20088360,2515,9289
687,11,6,25,0,28898700,3624,20106300,2512,9300
688,16,10,23,2,28953480,3625,20111880,2508,9316
689,12,0,18,7,29037540,3623,20173320,2511,9328
690,10,0,17,8,29077140,3623,20173320,2508,9338
691,5,0,16,9,29101020,3623,20173320,2506,9343
692,6,0,12,13,29148060,3624,20173320,2505,9349
693,8,0,16,9,29158860,3624,20173320,2502,9357
694,9,0,15,10,29196300,3624,20173320,2499,9366
695,7,0,18,7,29213460,3624,20173320,2497,9373
696,1,0,13,12,29246580,3626,20173320,2497,9374
697,4,0,10,15,29280480,3627,20173320,2496,9378
698,5,0,10,15,29302020,3627,20173320,2494,9383
699,11,0,17,8,29309460,3626,20173320,2491,9394
700,7,0,15,10,29325300,3624,20173320,2488,9401
701,4,0,10,15,29363700,3625,20173320,2487,9405
702,7,0,11,14,29378460,3624,20173320,2485,9412
703,6,0,14,11,29385420,3624,20173320,2483,9418
704,9,0,14,11,29408220,3623,20173320,2481,9427
705,3,0,10,15,29436060,3623,20173320,2480,9430
706,7,0,14,11,29446740,3623,20173320,2477,9437
707,11,0,17,8,29468280,3622,20173320,2474,9448
708,16,0,21,4,29499960,3620,20173320,2469,9464
709,13,0,24,1,29533680,3620,20173320,2465,9477
710,11,0,22,3,29590620,3621,20173500,2462,9488
711,12,0,17,8,29653800,3622,20173500,2458,9500
712,9,0,19,6,29688540,3623,20173500,2456,9509
713,5,0,15,10,29723640,3623,20173500,2454,9514
714,5,0,14,11,29760300,3625,20173500,2453,9519
715,8,0,12,13,29796240,3625,20173500,2450,9527
716,11,0,15,10,29827620,3625,20173500,2447,9538
717,3,0,15,10,29841720,3625,20173500,2446,9541
718,8,0,14,11,29888640,3627,20173500,2444,9549
719,4,0,13,12,29902140,3627,20173500,2443,9553
720,5,0,12,13,29931420,3628,20173500,2441,9558
721,2,0,10,15,29951760,3628,20173500,2441,9560
722,7,0,13,12,29964660,3628,20173500,2439,9567
723,6,0,13,12,29981340,3627,20173500,2437,9573
724,9,0,15,10,30003600,3627,20173500,2434,9582
725,5,0,12,13,30031560,3627,20173500,2433,9587
726,7,0,13,12,30052020,3627,20173500,2431,9594
727,6,0,14,11,30066240,3626,20173500,2429,9600
728,6,0,11,14,30105480,3627,20173500,2427,9606
729,9,0,16,9,30117000,3627,20173500,2424,9615
730,13,0,18,7,30148920,3626,20173500,2421,9628
731,7,0,19,6,30172860,3626,20173500,2419,9635
732,14,0,23,2,30219480,3627,20173500,2415,9649
733,10,0,17,8,30281460,3628,20173500,2412,9659
734,9,0,18,7,30318660,3629,20173500,2409,9668
735,10,0,17,8,30355080,3628,20173500,2406,9678
736,10,0,16,9,30392580,3628,20173500,2403,9688
737,13,0,23,2,30416400,3628,20173500,2400,9701
738,13,0,25,0,30454140,3628,20173500,2396,9714
739,7,0,19,6,30510840,3629,20173500,2394,9721
740,5,0,13,12,30565080,3631,20173500,2393,9726
741,5,0,12,13,30584700,3631,20173500,2391,9731
742,5,0,13,12,30608460,3632,20173500,2390,9736
743,9,0,16,9,30627360,3631,20173500,2387,9745
744,3,0,13,12,30649440,3631,20173500,2386,9748
745,5,0,13,12,30675300,3632,20173500,2385,9753
746,2,0,8,17,30699480,3632,20173500,2384,9755
747,7,0,12,13,30710880,3632,20173500,2382,9762
748,5,0,12,13,30722520,3631,20173500,2381,9767
749,9,0,15,10,30735360,3630,20173500,2378,9776
750,8,0,13,12,30766320,3630,20173500,2376,9784
751,10,0,15,10,30787740,3629,20173500,2373,9794
752,10,0,14,11,30812940,3627,20173500,2371,9804
753,9,0,18,7,30838740,3628,20173500,2368,9813
754,12,0,17,8,30886680,3628,20173500,2365,9825
755,13,0,20,5,30909180,3626,20173500,2361,9838
756,14,0,19,6,30969420,3627,20173680,2357,9852
757,9,0,12,13,31022880,3627,20173680,2355,9861
758,11,0,15,10,31042680,3626,20173680,2352,9872
759,10,0,15,10,31070580,3625,20173680,2349,9882
760,8,0,18,7,31096080,3625,20173680,2347,9890
761,16,0,20,5,31136880,3624,20173680,2343,9906
762,5,0,18,7,31179540,3626,20173680,2341,9911
763,12,0,20,5,31226940,3628,20174340,2338,9923
764,10,0,15,10,31275900,3627,20174340,2335,9933
765,8,0,12,13,31318920,3627,20174340,2333,9941
766,9,0,14,11,31345200,3627,20174340,2331,9950
767,6,0,11,14,31368600,3626,20174340,2329,9956
768,5,0,11,14,31387380,3626,20174340,2328,9961
769,2,0,10,15,31401300,3627,20174340,2327,9963
770,7,0,13,12,31418640,3627,20174340,2325,9970
771,3,0,8,17,31443660,3627,20174340,2325,9973
772,6,0,12,13,31452480,3627,20174340,2323,9979
773,9,0,15,10,31466280,3626,20174340,2321,9988
774,11,0,13,12,31501860,3625,20174340,2318,9999
775,7,0,12,13,31525380,3624,20174340,2316,10006
776,7,0,13,12,31545300,3624,20174340,2314,10013
777,15,0,20,5,31566600,3623,20174340,2310,10028
778,18,8,22,3,31599660,3623,20178660,2306,10046
779,11,0,21,4,31675740,3624,20203140,2306,10057
780,12,0,21,4,31718160,3624,20203140,2302,10069
781,9,0,14,11,31783260,3624,20203140,2300,10078
782,15,0,18,7,31808340,3623,20203140,2296,10093
783,12,0,19,6,31853400,3623,20203140,2293,10105
784,13,0,19,6,31893420,3623,20203140,2290,10118
785,8,0,16,9,31938180,3623,20203140,2288,10126
786,10,0,15,10,31981980,3624,20203140,2285,10136
787,11,0,16,9,32003460,3622,20203140,2282,10147
788,7,0,13,12,32041380,3622,20203140,2280,10154
789,6,0,14,11,32059800,3622,20203140,2279,10160
790,4,0,12,13,32080020,3622,20203140,2278,10164
791,6,0,12,13,32104500,3622,20203140,2276,10170
792,4,0,14,11,32110200,3622,20203140,2275,10174
793,4,0,13,12,32128200,3622,20203140,2274,10178
794,6,0,12,13,32165160,3623,20203140,2273,10184
795,4,0,11,14,32178180,3623,20203140,2272,10188
796,3,0,9,16,32194140,3623,20203140,2271,10191
797,4,0,9,16,32206380,3622,20203140,2270,10195
798,7,0,15,10,32206980,3622,20203140,2268,10202
799,8,0,14,11,32231820,3621,20203140,2266,10210
800,16,0,23,2,32254320,3621,20203140,2262,10226
801,9,0,18,7,32292840,3619,20203140,2260,10235
802,10,0,17,8,32334540,3620,20203140,2257,10245
803,9,0,17,8,32366760,3620,20203140,2255,10254
804,13,0,21,4,32399520,3620,20203140,2252,10267
805,12,0,20,5,32455320,3621,20203140,2249,10279
806,13,0,20,5,32490480,3619,20203140,2245,10292
807,8,0,12,13,32546580,3619,20203140,2243,10300
808,9,0,16,9,32565480,3619,20203140,2241,10309
809,12,0,20,5,32588760,3618,20203140,2238,10321
810,6,0,17,8,32617680,3618,20203140,2237,10327
811,10,0,18,7,32655360,3619,20203140,2234,10337
812,6,0,13,12,32689740,3618,20203140,2233,10343
813,8,0,15,10,32710920,3618,20203140,2231,10351
814,3,0,12,13,32737920,3619,20203140,2230,10354
815,9,0,13,12,32764440,3618,20203140,2228,10363
816,3,0,12,13,32778420,3618,20203140,2227,10366
817,6,0,13,12,32788680,3617,20203140,2225,10372
818,8,0,13,12,32826960,3618,20203140,2224,10380
819,1,0,10,15,32840400,3618,20203140,2223,10381
820,12,0,14,11,32857860,3617,20203140,2220,10393
821,6,0,14,11,32874060,3616,20203140,2219,10399
822,5,0,12,13,32907780,3617,20203140,2218,10404
823,3,0,9,16,32935320,3618,20203140,2217,10407
824,11,0,15,10,32945100,3617,20203140,2214,10418
825,9,0,15,10,32965740,3616,20203140,2212,10427
826,7,0,13,12,33003480,3616,20203140,2210,10434
827,10,0,16,9,33022680,3616,20203140,2208,10444
828,11,0,15,10,33065520,3616,20203140,2205,10455
829,10,0,18,7,33091620,3616,20203140,2203,10465
830,10,0,18,7,33138060,3617,20203140,2201,10475
831,9,0,18,7,33163320,3616,20203140,2198,10484
832,11,0,19,6,33214680,3618,20203140,2196,10495
833,12,0,17,8,33267600,3618,20203140,2193,10507
834,8,0,14,11,33297180,3617,20203140,2191,10515
835,3,0,10,15,33337260,3618,20203140,2190,10518
836,8,0,15,10,33349740,3619,20203140,2188,10526
837,7,0,16,9,33366720,3618,20203140,2187,10533
838,4,0,16,9,33384240,3618,20203140,2186,10537
839,4,0,10,15,33439920,3620,20203140,2185,10541
840,3,0,10,15,33451440,3621,20203140,2184,10544
841,7,0,14,11,33461340,3620,20203140,2182,10551
842,6,0,12,13,33474780,3619,20203140,2181,10557
843,3,0,10,15,33491640,3619,20203140,2180,10560
844,4,0,10,15,33502260,3618,20203140,2179,10564
845,7,0,13,12,33518040,3618,20203140,2178,10571
846,5,0,13,12,33527760,3617,20203140,2177,10576
847,10,0,16,9,33546840,3617,20203140,2174,10586
848,12,0,18,7,33562320,3615,20203140,2171,10598
849,9,0,16,9,33599880,3614,20203140,2169,10607
850,11,0,17,8,33628440,3614,20203140,2167,10618
851,8,0,15,10,33669780,3614,20203140,2165,10626
852,14,0,22,3,33710460,3616,20203140,2162,10640
853,14,0,23,2,33749460,3615,20203140,2158,10654
854,10,0,19,6,33807420,3616,20203140,2156,10664
855,11,0,17,8,33851040,3615,20203140,2154,10675
856,11,0,20,5,33879360,3615,20203140,2151,10686
857,11,0,20,5,33925260,3616,20203140,2149,10697
858,11,0,17,8,33975240,3616,20204100,2146,10708
859,8,0,14,11,34019880,3616,20204100,2144,10716
860,4,0,9,16,34050420,3616,20204100,2143,10720
861,6,0,13,12,34056000,3616,20204100,2142,10726
862,1,0,11,14,34067400,3616,20204100,2142,10727
863,7,0,14,11,34082940,3616,20204100,2140,10734
864,4,0,14,11,34100100,3616,20204100,2139,10738
865,4,0,11,14,34134120,3617,20204100,2138,10742
866,2,0,9,16,34151040,3618,20204100,2138,10744
867,7,0,14,11,34158900,3618,20204100,2136,10751
868,9,0,13,12,34183260,3616,20204100,2134,10760
869,5,0,12,13,34213320,3617,20204100,2133,10765
870,6,0,14,11,34226160,3617,20204100,2132,10771
871,7,0,13,12,34262160,3618,20204100,2130,10778
872,9,0,13,12,34276320,3616,20204100,2128,10787
873,11,0,17,8,34298520,3616,20204100,2126,10798
874,9,0,19,6,34313640,3615,20204100,2124,10807
875,9,0,13,12,34378440,3616,20204100,2122,10816
876,15,0,19,6,34403940,3615,20204100,2118,10831
877,14,0,23,2,34432740,3614,20204340,2115,10845
878,15,0,19,6,34510320,3615,20204340,2112,10860
879,12,0,17,8,34548540,3614,20204340,2109,10872
880,8,0,16,9,34583040,3614,20204340,2108,10880
881,9,0,17,8,34615020,3614,20204340,2106,10889
882,9,0,17,8,34637460,3613,20204340,2104,10898
883,12,0,16,9,34673760,3612,20204340,2101,10910
884,1,0,10,15,34703340,3613,20204340,2101,10911
885,3,0,9,16,34722600,3613,20204340,2100,10914
886,7,0,12,13,34738140,3613,20204340,2099,10921
887,5,0,15,10,34743240,3613,20204340,2098,10926
888,5,0,14,11,34777020,3614,20204340,2096,10931
889,4,0,12,13,34807140,3615,20204340,2096,10935
890,7,0,13,12,34828680,3615,20204340,2094,10942
891,5,0,12,13,34846860,3615,20204340,2093,10947
892,6,0,12,13,34874940,3615,20204340,2092,10953
893,11,0,16,9,34889880,3614,20204340,2089,10964
894,5,0,12,13,34918020,3614,20204340,2088,10969
895,9,0,17,8,34927380,3613,20204340,2086,10978
896,11,0,12,13,34965600,3611,20204340,2084,10989
897,8,0,12,13,34987500,3611,20204340,2082,10997
898,8,0,11,14,35014020,3610,20204340,2080,11005
899,11,0,14,11,35029200,3609,20204340,2078,11016
900,11,0,19,6,35047380,3608,20204340,2076,11027
901,14,1,18,7,35087940,3607,20204880,2073,11041
902,3,0,18,7,35112000,3608,20213040,2073,11044
903,4,0,12,13,35168100,3610,20213040,2072,11048
904,7,0,11,14,35197800,3610,20213040,2071,11055
905,10,0,17,8,35207220,3610,20213040,2069,11065
906,11,0,15,10,35244360,3609,20213040,2066,11076
907,9,0,15,10,35273880,3608,20213040,2064,11085
908,10,0,18,7,35293920,3608,20213040,2062,11095
909,7,0,14,11,35337420,3608,20213040,2061,11102
910,6,0,15,10,35360820,3609,20213040,2060,11108
911,6,0,12,13,35394780,3609,20213040,2058,11114
912,3,0,8,17,35410260,3608,20213040,2058,11117
913,1,0,7,18,35416740,3608,20213040,2057,11118
914,5,0,10,15,35418180,3607,20213040,2056,11123
915,7,0,12,13,35428560,3607,20213040,2055,11130
916,7,0,13,12,35441220,3606,20213040,2053,11137
917,3,0,11,14,35464380,3606,20213040,2053,11140
918,7,0,15,10,35475120,3606,20213040,2051,11147
919,10,0,11,14,35514720,3605,20213040,2049,11157
920,5,0,14,11,35518080,3605,20213040,2048,11162
921,7,0,15,10,35534520,3604,20213040,2047,11169
922,6,0,14,11,35563800,3605,20213040,2046,11175
923,11,0,18,7,35592720,3605,20213040,2043,11186
924,18,0,24,1,35622600,3604,20213040,2040,11204
925,8,0,15,10,35688720,3604,20213400,2038,11212
926,8,0,17,8,35710920,3604,20213400,2036,11220
927,9,0,19,6,35740500,3605,20213400,2034,11229
928,12,0,20,5,35784060,3605,20213400,2032,11241
929,12,1,21,4,35814360,3604,20213400,2030,11253
930,10,0,22,3,35861100,3605,20213880,2028,11263
931,6,0,19,6,35919000,3608,20213880,2026,11269
932,5,0,13,12,35971080,3609,20213880,2025,11274
933,5,0,11,14,36000180,3610,20213880,2024,11279
934,4,0,12,13,36008580,3609,20213880,2024,11283
935,11,0,18,7,36026460,3609,20213880,2021,11294
936,6,0,13,12,36057840,3609,20213880,2020,11300
937,5,0,12,13,36084180,3609,20213880,2019,11305
938,3,0,10,15,36102960,3609,20213880,2018,11308
939,2,0,10,15,36114600,3610,20213880,2018,11310
940,10,0,13,12,36133080,3609,20213880,2016,11320
941,7,0,17,8,36137160,3608,20213880,2015,11327
942,9,0,16,9,36175980,3608,20213880,2013,11336
943,8,0,17,8,36199380,3608,20213880,2011,11344
944,6,0,15,10,36234660,3609,20213880,2010,11350
945,9,0,14,11,36269640,3609,20213880,2008,11359
946,13,0,20,5,36289440,3608,20213880,2006,11372
947,11,0,18,7,36338040,3608,20213880,2003,11383
948,11,0,18,7,36376680,3608,20213880,2001,11394
949,13,0,21,4,36403800,3607,20213880,1999,11407
950,7,0,17,8,36450600,3608,20213880,1997,11414
951,6,0,16,9,36478020,3608,20213880,1996,11420
952,10,0,15,10,36533640,3610,20213880,1994,11430
953,12,0,18,7,36574320,3611,20213880,1992,11442
954,8,0,15,10,36600420,3609,20213880,1990,11450
955,12,0,18,7,36636420,3610,20213880,1988,11462
956,9,0,21,4,36653700,3609,20213880,1986,11471
957,11,0,17,8,36701760,3609,20213880,1984,11482
958,3,0,12,13,36735060,3609,20213880,1983,11485
959,5,0,12,13,36768120,3611,20213880,1982,11490
960,6,0,12,13,36781860,3610,20213880,1981,11496
961,7,0,14,11,36802560,3610,20213880,1980,11503
962,7,0,15,10,36820740,3610,20213880,1979,11510
963,5,0,16,9,36838920,3610,20213880,1978,11515
964,9,0,13,12,36885480,3610,20213880,1976,11524
965,8,0,14,11,36902040,3610,20213880,1974,11532
966,5,0,13,12,36922980,3609,20213880,1973,11537
967,7,0,15,10,36948060,3610,20213880,1972,11544
968,11,0,18,7,36972480,3610,20213880,1970,11555
969,7,1,21,4,36985800,3610,20213880,1969,11562
970,14,3,25,0,37034880,3612,20219040,1967,11576
971,13,0,23,2,37100160,3612,20228880,1965,11589
972,6,0,14,11,37166820,3613,20228880,1964,11595
973,4,0,13,12,37195140,3614,20228880,1963,11599
974,6,0,15,10,37208940,3614,20228880,1962,11605
975,14,0,20,5,37245900,3615,20228880,1959,11619
976,11,0,18,7,37296780,3615,20228880,1957,11630
977,10,0,15,10,37342020,3615,20228880,1955,11640
978,9,0,17,8,37360860,3614,20228880,1953,11649
979,12,0,18,7,37402860,3614,20228880,1951,11661
980,5,0,12,13,37436100,3614,20228880,1950,11666
981,5,0,14,11,37447440,3614,20228880,1949,11671
982,5,0,13,12,37471140,3614,20228880,1948,11676
983,7,0,12,13,37504860,3614,20228880,1947,11683
984,2,0,11,14,37514880,3614,20228880,1947,11685
985,4,0,11,14,37529460,3614,20228880,1946,11689
986,3,0,13,12,37531560,3614,20228880,1945,11692
987,7,0,13,12,37556940,3614,20228880,1944,11699
988,5,0,12,13,37573980,3614,20228880,1943,11704
989,10,0,17,8,37596780,3614,20228880,1941,11714
990,9,0,17,8,37619760,3613,20228880,1940,11723
991,11,0,16,9,37663560,3613,20228880,1938,11734
992,8,0,12,13,37709580,3614,20228880,1936,11742
993,5,0,11,14,37725780,3613,20228880,1935,11747
994,12,0,18,7,37735560,3612,20228880,1933,11759
995,9,0,19,6,37763460,3612,20228880,1931,11768
996,6,0,17,8,37801440,3613,20228880,1930,11774
997,9,0,17,8,37833600,3613,20228880,1928,11783
998,11,0,19,6,37871880,3614,20228880,1926,11794
999,7,0,16,9,37909860,3614,20228880,1925,11801
1000,10,0,18,7,37941000,3614,20228880,1923,11811
1001,12,0,16,9,37970700,3612,20228880,1921,11823
1002,8,0,14,11,38014380,3613,20228880,1920,11831
1003,5,0,15,10,38035500,3613,20228880,1919,11836
1004,6,0,17,8,38056500,3614,20228880,1918,11842
1005,6,0,15,10,38086560,3614,20228880,1917,11848
1006,11,0,18,7,38141940,3617,20228880,1915,11859
1007,7,0,16,9,38179320,3617,20228880,1913,11866
1008,10,0,17,8,38214720,3617,20228880,1911,11876
1009,6,0,16,9,38242500,3618,20228880,1910,11882
1010,12,0,18,7,38286540,3618,20228880,1908,11894
1011,22,0,24,1,38318640,3616,20228880,1904,11916
1012,30,22,20,5,38364360,3616,20236080,1900,11946
1013,30,39,17,8,38405520,3618,20244120,1897,11976
1014,32,40,20,5,38446440,3620,20284680,1899,12008
1015,30,40,25,0,38472120,3621,20323320,1901,12038
1016,33,40,25,0,38547900,3624,20419380,1908,12071
1017,35,40,25,0,38629500,3625,20467920,1909,12106
1018,37,40,25,0,38685960,3625,20555940,1915,12143
1019,36,37,25,0,38753100,3626,20651820,1921,12179
1020,34,40,23,2,38798100,3626,20657760,1919,12213
1021,37,38,20,5,38870400,3627,20699640,1921,12250
1022,25,40,25,0,38923560,3626,20839020,1930,12275
1023,26,39,25,0,38988120,3627,20849160,1928,12301
1024,31,40,25,0,39062820,3627,20935260,1932,12332
1025,34,40,25,0,39115020,3626,20993520,1935,12366
1026,27,40,25,0,39182940,3626,21117780,1943,12393
1027,32,40,25,0,39240660,3626,21134760,1941,12425
1028,37,40,25,0,39305940,3625,21180780,1942,12462
1029,27,39,25,0,39378180,3625,21280320,1948,12489
1030,31,40,25,0,39429840,3626,21294780,1946,12520
1031,28,39,25,0,39498060,3627,21306660,1945,12548
1032,28,38,23,2,39560280,3626,21400560,1950,12576
1033,32,40,25,0,39612420,3626,21444840,1952,12608
1034,35,40,25,0,39679200,3626,21479880,1951,12643
1035,30,37,24,1,39758460,3623,21767040,1973,12673
1036,17,38,19,6,39806820,3625,21776880,1972,12690
1037,40,40,25,0,39853920,3624,21789780,1970,12730
1038,32,40,25,0,39922440,3623,21848760,1971,12762
1039,33,38,25,0,39986760,3622,21921240,1974,12795
1040,32,40,25,0,40046040,3622,21927660,1972,12827
1041,29,39,25,0,40101780,3623,21993840,1976,12856
1042,25,40,25,0,40185180,3623,22118580,1983,12881
1043,21,35,25,0,40258320,3623,22182720,1985,12902
1044,37,37,25,0,40318620,3623,22311240,1994,12939
1045,29,39,25,0,40381140,3623,22338900,1993,12968
1046,28,35,25,0,40438920,3622,22369260,1993,12996
1047,32,40,25,0,40513020,3623,22391640,1991,13028
1048,29,40,25,0,40552860,3622,22442880,1993,13057
1049,31,40,25,0,40625460,3623,22452960,1991,13088
1050,28,40,25,0,40704660,3622,22505040,1991,13116
1051,25,40,25,0,40753260,3622,22508760,1989,13141
1052,35,40,25,0,40819260,3623,22585140,1993,13176
1053,31,40,25,0,40897500,3624,22610940,1992,13207
1054,33,39,25,0,40970400,3622,22670100,1993,13240
1055,34,39,25,0,41014440,3620,22711920,1993,13274
1056,37,39,25,0,41088420,3621,22721040,1991,13311
1057,23,39,21,4,41156760,3621,22821120,1997,13334
1058,33,40,25,0,41201580,3621,22929480,2003,13367
1059,31,39,25,0,41276820,3622,22945980,2002,13398
1060,34,40,25,0,41334720,3622,23009340,2005,13432
1061,35,40,25,0,41404200,3623,23022900,2003,13467
1062,37,36,25,0,41487960,3622,23235660,2018,13504
1063,21,39,25,0,41530620,3620,23565840,2043,13525
1064,28,40,25,0,41601240,3621,23590620,2042,13553
1065,31,40,25,0,41662920,3621,23646960,2044,13584
1066,27,40,25,0,41722380,3622,23656260,2042,13611
1067,29,40,23,2,41787960,3623,23692980,2044,13640
1068,31,37,22,3,41839560,3624,23739720,2045,13671
1069,37,40,25,0,41883480,3623,23896560,2055,13708
1070,34,38,25,0,41946840,3623,24106200,2070,13742
1071,27,38,25,0,42025560,3624,24127980,2069,13769
1072,32,37,25,0,42096240,3624,24233760,2075,13801
1073,34,40,25,0,42161520,3624,24256200,2073,13835
1074,31,39,25,0,42218400,3623,24309000,2075,13866
1075,32,40,25,0,42281100,3623,24334080,2074,13898
1076,36,38,25,0,42355500,3623,24383520,2074,13934
1077,23,31,25,0,42420960,3621,25107180,2133,13957
1078,31,40,18,7,42469680,3621,25110240,2130,13988
1079,27,39,18,7,42510240,3622,25130580,2131,14015
1080,29,39,25,0,42547860,3624,25158240,2131,14044
1081,33,40,25,0,42620700,3626,25188300,2131,14077
1082,27,40,25,0,42680340,3626,25209660,2130,14104
1083,31,38,25,0,42760620,3628,25255980,2131,14135
1084,33,38,25,0,42822000,3627,25314300,2132,14168
1085,33,40,25,0,42879180,3625,25502280,2144,14201
1086,30,36,25,0,42953520,3624,25589340,2148,14231
1087,33,38,25,0,43007940,3624,25638720,2149,14264
1088,32,39,25,0,43074720,3623,25691520,2149,14296
1089,32,36,25,0,43141980,3621,25800000,2154,14328
1090,30,40,25,0,43197480,3621,25817100,2152,14358
1091,35,40,25,0,43266300,3622,25829280,2151,14393
1092,31,38,25,0,43333500,3622,25904340,2154,14424
1093,32,40,23,2,43388580,3622,25923600,2153,14456
1094,24,34,25,0,43454160,3623,26166060,2171,14480
1095,28,38,25,0,43523580,3621,26427780,2187,14508
1096,29,40,25,0,43569000,3621,26438940,2186,14537
1097,35,39,25,0,43654080,3619,26530680,2188,14572
1098,36,40,25,0,43693320,3618,26545200,2186,14608
1099,34,38,25,0,43781940,3619,26606880,2188,14642
1100,35,40,25,0,43843800,3617,26641320,2186,14677
1101,37,39,25,0,43880820,3617,26656080,2186,14714
1102,25,40,25,0,43946640,3618,26729040,2189,14739
1103,37,40,25,0,44019540,3620,26739000,2187,14776
1104,26,34,25,0,44095380,3621,26978640,2204,14802
1105,30,35,25,0,44167380,3618,27643320,2254,14832
1106,38,40,25,0,44221020,3618,27650160,2250,14870
1107,36,40,23,2,44267400,3618,27660960,2249,14906
1108,33,40,25,0,44337900,3619,27787620,2256,14939
1109,30,34,25,0,44423100,3619,27895140,2262,14969
1110,32,39,24,1,44480160,3616,29122560,2357,15001
1111,30,40,19,6,44518440,3617,29130120,2355,15031
1112,20,40,25,0,44581860,3619,29172420,2356,15051
1113,31,39,25,0,44645820,3620,29206620,2355,15082
1114,24,34,25,0,44716500,3620,29342460,2364,15106
1115,31,39,25,0,44778720,3617,29532840,2374,15137
1116,31,40,25,0,44824560,3618,29540880,2372,15168
1117,34,40,25,0,44905560,3618,29556780,2370,15202
1118,42,37,25,0,44967360,3618,29697360,2377,15244
1119,38,39,24,1,45031380,3618,29738880,2377,15282
1120,21,39,20,5,45090000,3618,29760840,2376,15303
1121,29,40,24,1,45143280,3619,29793360,2377,15332
1122,35,36,21,4,45202800,3619,29866440,2380,15367
1123,34,40,17,8,45253200,3617,29948280,2383,15401
1124,31,40,25,0,45295500,3618,30049260,2388,15432
1125,27,34,25,0,45362820,3619,30130500,2392,15459
1126,22,38,25,0,45421020,3618,30238800,2397,15481
1127,18,39,21,4,45468900,3620,30245100,2396,15499
1128,26,38,25,0,45546420,3622,30310500,2399,15525
1129,37,40,25,0,45612900,3622,30343320,2397,15562
1130,38,40,18,7,45664140,3622,30349380,2397,15600
1131,17,38,18,7,45718620,3624,30365520,2396,15617
1132,28,37,25,0,45756000,3623,30563820,2408,15645
1133,40,40,25,0,45804120,3624,30601020,2408,15685
1134,30,34,25,0,45896040,3623,30815520,2421,15715
1135,36,40,22,3,45944520,3623,30821280,2418,15751
1136,29,39,25,0,46004940,3622,30874380,2418,15780
1137,29,36,25,0,46090080,3622,30983580,2424,15809
1138,34,39,25,0,46137720,3621,30997020,2421,15843
1139,28,40,25,0,46204920,3621,31021020,2419,15871
1140,42,40,25,0,46250700,3621,31050120,2419,15913
1141,36,40,25,0,46321860,3620,31152180,2422,15949
1142,28,39,25,0,46390080,3621,31172160,2421,15977
1143,37,38,25,0,46453080,3621,31197120,2420,16014
1144,35,39,23,2,46531140,3619,31276860,2421,16049
1145,31,40,25,0,46562700,3620,31282320,2420,16080
1146,29,40,25,0,46656360,3622,31348740,2422,16109
1147,25,39,25,0,46724760,3622,31386660,2421,16134
1148,37,40,25,0,46775700,3621,31425180,2420,16171
1149,29,40,25,0,46831140,3622,31437240,2419,16200
1150,35,40,19,6,46915020,3621,31754580,2441,16235
1151,27,38,13,12,46961400,3622,31763580,2440,16262
1152,29,40,23,2,46985820,3622,31792140,2439,16291
1153,27,40,17,8,47038980,3622,31823460,2440,16318
1154,31,39,25,0,47073360,3622,31862820,2440,16349
1155,33,35,25,0,47138760,3622,31937940,2443,16382
1156,33,39,25,0,47194800,3622,32124720,2453,16415
1157,33,39,25,0,47266380,3622,32158200,2452,16448
1158,26,36,25,0,47339280,3621,32239080,2455,16474
1159,35,39,25,0,47401140,3620,32356560,2459,16509
1160,24,40,25,0,47436480,3620,32365980,2458,16533
1161,25,28,25,0,47545200,3619,33921840,2571,16558
1162,36,40,20,5,47593380,3617,35501340,2688,16594
1163,23,39,18,7,47630700,3618,35518620,2686,16617
1164,26,40,23,2,47674260,3620,35547060,2686,16643
1165,24,39,25,0,47702880,3621,35582700,2688,16667
1166,41,39,25,0,47809980,3624,35613600,2687,16708
1167,34,39,25,0,47859960,3623,35726820,2692,16742
1168,34,37,25,0,47928120,3623,35754960,2690,16776
1169,30,34,25,0,47999460,3622,35937180,2700,16806
1170,40,40,25,0,48040560,3621,36057000,2705,16846
1171,28,39,25,0,48118080,3623,36080400,2704,16874
1172,29,40,25,0,48179760,3624,36088260,2701,16903
1173,34,39,25,0,48263460,3624,36144900,2701,16937
1174,31,38,25,0,48316440,3622,36197340,2701,16968
1175,26,39,25,0,48368580,3621,36205020,2697,16994
1176,24,37,25,0,48444780,3622,36251880,2698,17018
1177,5,14,25,0,48516480,3620,40851780,3039,17023
1178,7,0,14,11,48568440,3615,43141680,3208,17030
1179,7,0,13,12,48590400,3615,43141680,3206,17037
1180,5,0,13,12,48612240,3615,43141680,3205,17042
1181,6,0,12,13,48628680,3614,43141680,3203,17048
1182,11,0,15,10,48653640,3614,43141680,3201,17059
1183,6,0,13,12,48673440,3613,43141680,3199,17065
1184,5,0,12,13,48698040,3613,43141680,3198,17070
1185,12,0,20,5,48704100,3613,43141680,3195,17082
1186,16,0,21,4,48750900,3612,43141680,3192,17098
1187,10,0,17,8,48797340,3612,43141680,3189,17108
1188,6,0,14,11,48839520,3613,43141680,3188,17114
1189,15,0,19,6,48862680,3612,43141680,3184,17129
1190,12,0,19,6,48908820,3612,43141680,3182,17141
1191,8,0,18,7,48938400,3612,43141680,3180,17149
1192,6,0,15,10,48987840,3613,43141680,3178,17155
1193,13,0,16,9,49030080,3613,43141680,3175,17168
1194,9,0,19,6,49052040,3613,43141680,3173,17177
1195,10,0,22,3,49085160,3613,43141680,3171,17187
1196,8,0,15,10,49151880,3614,43141680,3169,17195
1197,6,0,19,6,49165560,3615,43141680,3167,17201
1198,7,0,13,12,49224660,3616,43141680,3166,17208
1199,6,0,14,11,49251240,3616,43141680,3164,17214
1200,5,0,15,10,49263240,3616,43141680,3163,17219
1201,5,0,12,13,49296540,3617,43141680,3162,17224
1202,3,0,9,16,49319940,3617,43141680,3161,17227
1203,2,0,10,15,49322400,3617,43141680,3161,17229
1204,6,0,16,9,49322400,3617,43141680,3160,17235
1205,8,0,17,8,49357440,3617,43141680,3158,17243
1206,7,0,16,9,49402260,3618,43141680,3156,17250
1207,11,0,16,9,49439820,3618,43141680,3154,17261
1208,7,0,17,8,49461780,3618,43141680,3152,17268
1209,4,0,12,13,49503360,3619,43141680,3151,17272
1210,8,0,12,13,49539480,3619,43141680,3149,17280
1211,8,0,14,11,49554720,3619,43141680,3147,17288
1212,14,0,20,5,49575600,3618,43141680,3144,17302
1213,11,0,22,3,49600380,3618,43142220,3142,17313
1214,9,0,17,8,49664340,3619,43142220,3140,17322
1215,13,0,13,12,49718760,3618,43142220,3137,17335
1216,13,0,14,11,49746960,3617,43142220,3134,17348
1217,10,0,18,7,49760280,3617,43142220,3131,17358
1218,8,0,18,7,49795320,3617,43142220,3130,17366
1219,4,0,13,12,49832460,3617,43142220,3129,17370
1220,9,0,13,12,49862400,3617,43142220,3127,17379
1221,7,0,15,10,49877880,3617,43142220,3125,17386
1222,5,0,9,16,49916460,3617,43142220,3124,17391
1223,6,0,12,13,49921080,3616,43142220,3123,17397
1224,5,0,12,13,49934700,3616,43142220,3121,17402
1225,5,0,13,12,49948620,3616,43142220,3120,17407
1226,8,0,16,9,49963920,3616,43142220,3119,17415
1227,10,0,17,8,49992900,3616,43142220,3116,17425
1228,4,0,17,8,50010300,3616,43142220,3115,17429
1229,6,0,16,9,50049480,3617,43142220,3114,17435
1230,7,0,17,8,50085420,3618,43142220,3112,17442
1231,10,0,16,9,50123160,3618,43142220,3110,17452
1232,12,0,14,11,50166660,3617,43142220,3108,17464
1233,7,0,13,12,50182200,3616,43142220,3106,17471
1234,11,0,15,10,50218740,3617,43142220,3103,17482
1235,12,0,16,9,50246040,3616,43142220,3101,17494
1236,8,0,17,8,50261760,3615,43142220,3099,17502
1237,7,0,15,10,50299260,3615,43142220,3097,17509
1238,6,0,15,10,50314500,3615,43142220,3096,17515
1239,10,0,16,9,50350860,3615,43142220,3094,17525
1240,11,0,17,8,50384520,3615,43142220,3091,17536
1241,10,0,18,7,50413920,3615,43142220,3089,17546
1242,5,0,16,9,50461140,3616,43142220,3088,17551
1243,6,0,12,13,50502540,3617,43142220,3087,17557
1244,8,0,18,7,50510820,3617,43142220,3085,17565
1245,2,0,12,13,50552580,3618,43142220,3085,17567
1246,4,0,11,14,50574540,3618,43142220,3084,17571
1247,5,0,12,13,50585040,3618,43142220,3083,17576
1248,6,0,12,13,50610780,3618,43142220,3081,17582
1249,3,0,12,13,50617620,3618,43142220,3081,17585
1250,3,0,9,16,50635020,3617,43142220,3080,17588
1251,6,0,11,14,50646540,3617,43142220,3079,17594
1252,6,0,15,10,50655720,3617,43142220,3077,17600
1253,10,0,18,7,50669700,3616,43142220,3075,17610
1254,4,0,10,15,50726940,3617,43142220,3074,17614
1255,13,0,15,10,50744040,3617,43142220,3071,17627
1256,8,0,17,8,50771460,3617,43142220,3070,17635
1257,6,0,13,12,50804100,3617,43142220,3068,17641
1258,6,0,12,13,50825100,3616,43142220,3067,17647
1259,5,0,14,11,50836800,3616,43142220,3066,17652
1260,8,0,11,14,50871420,3616,43142220,3064,17660
1261,9,0,13,12,50891100,3616,43142220,3062,17669
1262,14,0,21,4,50906880,3615,43142220,3059,17683
1263,11,0,18,7,50952300,3615,43142220,3057,17694
1264,7,0,15,10,50997120,3616,43142220,3055,17701
1265,7,0,13,12,51020100,3615,43142220,3054,17708
1266,6,0,15,10,51037860,3615,43142220,3053,17714
1267,4,0,13,12,51062760,3615,43142220,3052,17718
1268,5,0,11,14,51084120,3615,43142220,3051,17723
1269,5,0,11,14,51106260,3615,43142220,3049,17728
1270,6,0,10,15,51132900,3615,43142220,3048,17734
1271,1,0,8,17,51146400,3616,43142220,3048,17735
1272,1,0,9,16,51146400,3616,43142220,3048,17736
1273,5,0,13,12,51147480,3615,43142220,3047,17741
1274,5,0,15,10,51159240,3616,43142220,3046,17746
1275,8,0,12,13,51191520,3615,43142220,3044,17754
1276,4,0,11,14,51203760,3615,43142220,3043,17758
1277,3,0,12,13,51213840,3615,43142220,3042,17761
1278,9,0,15,10,51232920,3615,43142220,3040,17770
1279,8,0,15,10,51258300,3614,43142220,3039,17778
1280,7,0,15,10,51275640,3614,43142220,3037,17785
1281,7,0,13,12,51308580,3614,43142220,3036,17792
1282,17,0,25,0,51319440,3613,43142220,3032,17809
1283,8,0,20,5,51352620,3612,43142220,3030,17817
1284,9,0,16,9,51419400,3614,43142220,3029,17826
1285,8,0,15,10,51460500,3614,43142220,3027,17834
1286,13,0,20,5,51480120,3614,43142220,3024,17847
1287,12,0,21,4,51511380,3613,43142220,3022,17859
1288,10,0,19,6,51576180,3615,43142220,3019,17869
1289,12,0,18,7,51627120,3615,43142220,3017,17881
1290,7,0,18,7,51655680,3615,43142220,3015,17888
1291,7,0,15,10,51699780,3616,43142220,3014,17895
1292,9,0,14,11,51733680,3615,43142220,3012,17904
1293,12,0,20,5,51747420,3615,43142220,3009,17916
1294,3,0,17,8,51779340,3616,43142220,3009,17919
1295,5,0,14,11,51824640,3617,43142220,3008,17924
1296,8,0,12,13,51858060,3617,43142220,3006,17932
1297,8,0,13,12,51874680,3616,43142220,3004,17940
1298,5,0,11,14,51902100,3616,43142220,3003,17945
1299,2,0,9,16,51928020,3617,43142220,3003,17947
1300,6,0,12,13,51931260,3616,43142220,3002,17953
1301,6,0,13,12,51954000,3617,43142220,3000,17959
1302,8,0,11,14,51979860,3616,43142220,2999,17967
1303,6,0,15,10,51984120,3616,43142220,2998,17973
1304,11,0,16,9,52018440,3616,43142220,2995,17984
1305,10,0,16,9,52036440,3614,43142220,2993,17994
1306,13,0,21,4,52063380,3614,43142220,2991,18007
1307,19,0,25,0,52113600,3614,43143180,2987,18026
1308,8,0,17,8,52166400,3614,43143600,2985,18034
1309,13,0,20,5,52203600,3614,43143600,2982,18047
1310,7,0,14,11,52252620,3614,43143600,2981,18054
1311,11,0,16,9,52278240,3613,43143600,2979,18065
1312,13,0,17,8,52304160,3612,43143600,2976,18078
1313,10,0,15,10,52340400,3612,43143600,2974,18088
1314,6,0,15,10,52357140,3611,43143600,2973,18094
1315,8,0,18,7,52376280,3611,43143600,2971,18102
1316,7,0,17,8,52417440,3612,43143600,2970,18109
1317,5,0,14,11,52456440,3613,43143600,2969,18114
1318,7,0,14,11,52483440,3613,43143600,2967,18121
1319,4,0,12,13,52512660,3614,43143600,2966,18125
1320,5,0,13,12,52526220,3614,43143600,2965,18130
1321,3,0,11,14,52548480,3614,43143600,2965,18133
1322,4,0,11,14,52560960,3614,43143600,2964,18137
1323,7,0,15,10,52572120,3614,43143600,2962,18144
1324,8,0,16,9,52593780,3613,43143600,2961,18152
1325,10,0,16,9,52626540,3613,43143600,2959,18162
1326,9,0,17,8,52652700,3613,43143600,2957,18171
1327,5,0,16,9,52680120,3613,43143600,2956,18176
1328,8,0,12,13,52729320,3614,43143600,2954,18184
1329,10,0,18,7,52747740,3614,43143600,2952,18194
1330,12,0,19,6,52772940,3613,43143600,2950,18206
1331,17,0,22,3,52825860,3613,43143600,2946,18223
1332,12,0,23,2,52856460,3613,43143660,2944,18235
1333,12,0,20,5,52932780,3614,43143660,2942,18247
1334,13,0,21,4,52974780,3614,43143660,2939,18260
1335,10,0,16,9,53027400,3614,43143660,2937,18270
1336,6,0,16,9,53055000,3614,43143660,2936,18276
1337,6,0,12,13,53086320,3614,43143660,2935,18282
1338,9,0,12,13,53107200,3613,43143660,2933,18291
1339,4,0,14,11,53114040,3613,43143660,2932,18295
1340,2,0,10,15,53142300,3614,43143660,2932,18297
1341,10,0,16,9,53160240,3614,43143660,2930,18307
1342,11,0,18,7,53186580,3613,43143660,2927,18318
1343,7,0,14,11,53223900,3613,43143660,2926,18325
1344,6,0,14,11,53256120,3614,43143660,2925,18331
1345,2,0,14,11,53259660,3614,43143660,2924,18333
1346,7,0,19,6,53261700,3613,43143660,2923,18340
1347,5,0,18,7,53278920,3613,43143660,2922,18345
1348,8,0,21,4,53292480,3613,43143660,2921,18353
1349,4,0,18,7,53312460,3612,43143660,2920,18357
1350,5,0,19,6,53330040,3613,43143660,2919,18362
1351,10,0,22,3,53347140,3612,43143660,2917,18372
1352,10,0,23,2,53370540,3611,43143660,2915,18382
1353,14,3,25,0,53404080,3612,43146060,2912,18396
1354,14,11,19,6,53449260,3612,43150740,2911,18410
1355,19,26,20,5,53470800,3612,43158900,2908,18429
1356,7,31,18,7,53502120,3614,43166700,2906,18436
1357,8,36,19,6,53515800,3614,43174920,2905,18444
1358,11,36,25,0,53545560,3615,43228980,2906,18455
1359,8,37,25,0,53573760,3615,43236180,2906,18463
1360,13,36,25,0,53634420,3617,43290360,2907,18476
1361,10,36,25,0,53676420,3617,43370520,2911,18486
1362,10,34,25,0,53716620,3617,43450800,2914,18496
1363,7,35,19,6,53759520,3617,43473780,2914,18503
1364,10,37,21,4,53788920,3618,43513740,2915,18513
1365,5,40,19,6,53803140,3618,43515840,2915,18518
1366,6,36,20,5,53843280,3619,43547400,2916,18524
1367,5,31,25,0,53861340,3619,43740480,2928,18529
1368,1,2,25,0,53913000,3615,44775960,2997,18530
1369,6,0,19,6,53934120,3613,44843640,3000,18536
1370,6,0,19,6,53953440,3613,44843640,2999,18542
1371,5,3,16,9,53972280,3613,44843820,2999,18547
1372,9,9,17,8,53986200,3614,44848320,2997,18556
1373,4,13,17,8,53986200,3614,44848320,2997,18560
1374,10,15,22,3,54013320,3615,44885220,2996,18570
1375,5,16,23,2,54030780,3615,44903220,2997,18575
1376,9,14,25,0,54080880,3616,44945400,2998,18584
1377,5,2,25,0,54116160,3615,45077520,3005,18589
1378,10,0,18,7,54161040,3613,45092880,3004,18599
1379,6,0,18,7,54179100,3613,45092880,3003,18605
1380,12,0,21,4,54201480,3612,45092880,3001,18617
1381,15,6,22,3,54222600,3612,45093240,2998,18632
1382,17,12,25,0,54257760,3612,45099180,2995,18649
1383,10,14,25,0,54302220,3613,45103800,2993,18659
1384,13,19,25,0,54344880,3614,45123360,2992,18672
1385,11,26,20,5,54383100,3614,45129900,2991,18683
1386,9,33,18,7,54414300,3616,45135000,2990,18692
1387,11,40,17,8,54430320,3616,45143700,2988,18703
1388,6,38,18,7,54443700,3616,45160260,2988,18709
1389,5,37,21,4,54470100,3617,45207540,2991,18714
1390,5,33,25,0,54488460,3617,45291720,2995,18719
1391,8,30,25,0,54528060,3617,45443280,3004,18727
1392,4,17,25,0,54584940,3617,45787140,3026,18731
1393,5,0,18,7,54638400,3614,46187160,3051,18736
1394,5,0,18,7,54651180,3613,46187160,3050,18741
1395,4,0,17,8,54664200,3613,46187160,3049,18745
1396,6,0,21,4,54671760,3613,46187160,3048,18751
1397,9,0,19,6,54704460,3613,46187160,3046,18760
1398,9,0,18,7,54734700,3612,46187160,3044,18769
1399,10,0,23,2,54750060,3612,46187160,3042,18779
1400,10,0,24,1,54773280,3611,46187160,3040,18789
1401,7,0,24,1,54812220,3612,46187940,3039,18796
1402,13,4,25,0,54845520,3613,46188780,3037,18809
1403,9,9,21,4,54892680,3614,46192320,3035,18818
1404,9,14,20,5,54928620,3615,46201200,3034,18827
1405,13,24,20,5,54948000,3615,46203540,3031,18840
1406,13,29,25,0,54972300,3616,46229640,3031,18853
1407,15,37,24,1,55009080,3617,46237860,3028,18868
1408,12,39,25,0,55048860,3619,46260060,3028,18880
1409,7,36,25,0,55107600,3620,46336680,3032,18887
1410,12,40,25,0,55143720,3620,46353660,3031,18899
1411,14,28,25,0,55196340,3619,46587060,3044,18913
1412,12,5,25,0,55240500,3614,47056200,3072,18925
1413,10,0,20,5,55281240,3611,47142120,3076,18935
1414,7,0,19,6,55306020,3611,47142120,3074,18942
1415,8,0,19,6,55326900,3611,47142120,3073,18950
1416,5,0,17,8,55350420,3611,47142120,3072,18955
1417,8,0,18,7,55367460,3610,47142120,3070,18963
1418,8,0,18,7,55383300,3609,47142120,3068,18971
1419,4,0,16,9,55404360,3609,47142120,3068,18975
1420,4,0,15,10,55416420,3609,47142120,3067,18979
1421,6,0,16,9,55425660,3608,47142120,3066,18985
1422,8,0,19,6,55440540,3608,47142120,3064,18993
1423,2,0,17,8,55456320,3608,47142120,3064,18995
1424,5,0,20,5,55462800,3608,47142120,3063,19000
1425,8,0,18,7,55493280,3608,47142120,3061,19008
1426,10,0,22,3,55512840,3608,47142120,3059,19018
1427,14,8,20,5,55537860,3607,47143560,3057,19032
1428,13,17,19,6,55564020,3608,47153100,3054,19045
1429,9,17,25,0,55584000,3608,47175900,3054,19054
1430,12,19,25,0,55631400,3609,47197740,3053,19066
1431,12,22,25,0,55664160,3609,47227500,3053,19078
1432,11,21,25,0,55714200,3610,47270700,3053,19089
1433,5,10,25,0,55753920,3608,47413260,3062,19094
1434,12,9,21,4,55803060,3608,47503140,3065,19106
1435,8,10,25,0,55824240,3608,47508120,3064,19114
1436,10,10,25,0,55864080,3609,47523660,3063,19124
1437,6,0,20,5,55918620,3607,47650080,3070,19130
1438,10,0,16,9,55947300,3606,47650080,3068,19140
1439,5,0,18,7,55956900,3606,47650080,3067,19145
1440,9,0,19,6,55975620,3605,47650080,3065,19154
1441,4,0,19,6,55991700,3605,47650080,3064,19158
1442,4,0,18,7,56008680,3605,47650380,3063,19162
1443,3,0,19,6,56023740,3606,47650380,3063,19165
1444,2,0,18,7,56037060,3606,47650380,3062,19167
1445,5,0,17,8,56059200,3606,47650380,3061,19172
1446,11,0,18,7,56077800,3605,47650380,3059,19183
1447,4,0,16,9,56110920,3605,47650380,3059,19187
1448,6,0,18,7,56122500,3605,47650380,3057,19193
1449,8,0,20,5,56139120,3605,47650380,3056,19201
1450,11,1,25,0,56156640,3605,47650380,3054,19212
1451,13,3,25,0,56191680,3605,47655180,3052,19225
1452,9,0,23,2,56234400,3604,47658780,3050,19234
1453,10,0,25,0,56267520,3604,47659620,3048,19244
1454,8,0,21,4,56309340,3604,47660040,3046,19252
1455,12,0,22,3,56336940,3603,47660040,3044,19264
1456,9,0,24,1,56366760,3604,47660040,3042,19273
1457,10,0,24,1,56408460,3604,47663340,3041,19283
1458,11,8,19,6,56446860,3605,47666340,3039,19294
1459,10,17,17,8,56465100,3605,47670180,3038,19304
1460,7,22,16,9,56490000,3606,47678400,3036,19311
1461,10,31,17,8,56490000,3606,47680440,3036,19321
1462,8,35,18,7,56513700,3607,47703300,3035,19329
1463,3,36,18,7,56530200,3608,47712360,3034,19332
1464,6,37,20,5,56553720,3608,47761740,3036,19338
1465,2,34,22,3,56567220,3608,47846640,3041,19340
1466,3,27,25,0,56602560,3609,47988840,3050,19343
1467,3,14,25,0,56655780,3609,48279240,3068,19346
1468,5,0,18,7,56695200,3605,48611100,3088,19351
1469,5,0,16,9,56722500,3606,48611100,3087,19356
1470,6,0,18,7,56731380,3605,48611100,3086,19362
1471,9,0,20,5,56747760,3605,48611100,3084,19371
1472,6,0,19,6,56776320,3605,48611100,3083,19377
1473,12,0,24,1,56795100,3604,48611100,3080,19389
1474,8,0,19,6,56841660,3604,48611100,3079,19397
1475,9,0,22,3,56861220,3604,48611100,3077,19406
1476,8,0,22,3,56884080,3604,48611100,3075,19414
1477,7,0,20,5,56918220,3604,48612360,3074,19421
1478,10,0,23,2,56945700,3604,48612360,3072,19431
1479,7,0,20,5,56980920,3604,48612360,3071,19438
1480,7,0,24,1,56994600,3604,48612360,3069,19445
1481,5,0,20,5,57031500,3605,48612360,3068,19450
1482,10,0,22,3,57062580,3605,48612360,3067,19460
1483,10,1,24,1,57094800,3605,48612420,3065,19470
1484,7,0,22,3,57141360,3606,48613260,3063,19477
1485,6,0,20,5,57173460,3606,48613260,3062,19483
1486,4,0,18,7,57207000,3607,48613260,3061,19487
1487,8,0,23,2,57222780,3607,48613260,3060,19495
1488,6,0,22,3,57237720,3606,48613260,3059,19501
1489,4,0,18,7,57271080,3607,48613260,3058,19505
1490,5,0,17,8,57300480,3607,48613260,3057,19510
1491,3,0,17,8,57318180,3608,48613260,3056,19513
1492,5,0,15,10,57338100,3607,48613260,3055,19518
1493,4,0,18,7,57342420,3607,48613260,3055,19522
1494,5,0,20,5,57349680,3607,48613260,3054,19527
1495,4,0,15,10,57383100,3607,48613260,3053,19531
1496,11,0,23,2,57389340,3607,48613260,3051,19542
1497,8,0,19,6,57423720,3606,48613260,3049,19550
1498,9,0,25,0,57437640,3606,48614940,3048,19559
1499,8,0,22,3,57479100,3607,48614940,3046,19567
1500,12,0,24,1,57514800,3607,48616980,3044,19579
1501,6,0,20,5,57553860,3607,48616980,3043,19585
1502,11,0,23,2,57585000,3607,48616980,3041,19596
1503,9,0,21,4,57616740,3606,48616980,3039,19605
1504,9,0,22,3,57644400,3606,48616980,3037,19614
1505,7,0,17,8,57679920,3606,48616980,3036,19621
1506,13,0,24,1,57705240,3606,48616980,3034,19634
1507,5,0,18,7,57727560,3605,48616980,3033,19639
1508,7,0,21,4,57747900,3605,48616980,3031,19646
1509,6,0,21,4,57772980,3606,48616980,3030,19652
1510,8,0,20,5,57807480,3606,48616980,3029,19660
1511,8,0,19,6,57838140,3606,48616980,3027,19668
1512,1,0,16,9,57861660,3606,48616980,3027,19669
1513,7,0,20,5,57872280,3606,48616980,3026,19676
1514,5,0,18,7,57897840,3606,48616980,3025,19681
1515,4,0,18,7,57907380,3606,48616980,3024,19685
1516,2,0,15,10,57936900,3607,48616980,3024,19687
1517,2,0,15,10,57945960,3607,48616980,3023,19689
1518,9,0,22,3,57949320,3606,48616980,3021,19698
1519,13,0,24,1,57984660,3606,48618540,3019,19711
1520,5,0,22,3,58016940,3607,48618540,3018,19716
1521,9,0,22,3,58048500,3607,48618540,3016,19725
1522,12,0,24,1,58081320,3606,48618840,3014,19737
1523,13,3,22,3,58119360,3606,48619560,3012,19750
1524,10,10,20,5,58138140,3606,48622380,3010,19760
1525,11,19,18,7,58168440,3607,48623880,3009,19771
1526,19,35,19,6,58184220,3608,48627420,3005,19790
1527,11,40,18,7,58207080,3608,48628740,3004,19801
1528,6,39,21,4,58230540,3609,48647820,3004,19807
1529,10,40,25,0,58255380,3610,48703620,3006,19817
1530,5,37,25,0,58294800,3610,48767640,3009,19822
1531,5,31,25,0,58348140,3611,48898320,3016,19827
1532,11,27,25,0,58393920,3611,49055340,3024,19838
1533,3,3,25,0,58438920,3607,49597320,3056,19841
1534,8,0,19,6,58480020,3606,49634400,3057,19849
1535,8,0,20,5,58501560,3606,49634400,3055,19857
1536,5,0,20,5,58529940,3606,49634400,3054,19862
1537,5,0,19,6,58548060,3606,49634400,3054,19867
1538,8,0,20,5,58570560,3606,49634400,3052,19875
1539,5,0,19,6,58598520,3606,49634400,3051,19880
1540,8,0,19,6,58623720,3606,49634400,3050,19888
1541,11,0,23,2,58642200,3606,49634400,3048,19899
1542,3,0,17,8,58676640,3606,49634400,3047,19902
1543,9,0,21,4,58691160,3606,49634400,3045,19911
1544,8,0,20,5,58715460,3605,49634400,3044,19919
1545,11,0,23,2,58738500,3605,49634400,3042,19930
1546,10,0,22,3,58783440,3605,49634520,3040,19940
1547,14,4,25,0,58801620,3605,49635420,3038,19954
1548,14,15,22,3,58834020,3605,49638120,3035,19968
1549,14,28,18,7,58867680,3606,49642980,3033,19982
1550,8,25,24,1,58909440,3608,49697940,3034,19990
1551,13,36,25,0,58915080,3608,49698360,3034,20003
1552,12,38,21,4,58975680,3610,49713840,3032,20015
1553,8,38,21,4,59003520,3610,49734540,3032,20023
1554,4,39,21,4,59019780,3611,49737960,3032,20027
1555,10,35,25,0,59070300,3612,49879080,3039,20037
1556,6,26,25,0,59121300,3612,50140320,3053,20043
1557,9,21,25,0,59163300,3611,50296860,3061,20052
1558,3,0,17,8,59213280,3607,50751000,3088,20055
1559,13,5,21,4,59228100,3607,50752140,3086,20068
1560,6,4,25,0,59246400,3608,50765040,3086,20074
1561,6,0,23,2,59297280,3608,50781540,3086,20080
1562,5,0,20,5,59337360,3609,50781540,3085,20085
1563,5,0,16,9,59366640,3609,50781540,3084,20090
1564,8,0,22,3,59369700,3608,50781540,3082,20098
1565,7,0,17,8,59400720,3608,50781540,3081,20105
1566,3,0,15,10,59414340,3607,50781540,3080,20108
1567,12,1,20,5,59430780,3607,50782320,3078,20120
1568,12,13,18,7,59435640,3607,50782320,3078,20132
1569,10,23,17,8,59444160,3607,50782320,3078,20142
1570,16,36,18,7,59466120,3608,50798820,3072,20158
1571,15,40,25,0,59499780,3609,50836920,3072,20173
1572,6,36,25,0,59544960,3610,50883660,3074,20179
1573,25,36,25,0,59595120,3611,50914860,3073,20204
1574,2,26,25,0,59644560,3611,51100620,3084,20206
1575,9,7,25,0,59695320,3608,51448560,3104,20215
1576,10,3,21,4,59724480,3606,51572220,3109,20225
1577,10,6,23,2,59749080,3606,51582060,3108,20235
1578,8,9,23,2,59770440,3606,51591180,3107,20243
1579,5,8,20,5,59828940,3608,51603120,3107,20248
1580,7,7,25,0,59843580,3608,51643860,3108,20255
1581,9,0,20,5,59888640,3606,51686820,3109,20264
1582,8,1,21,4,59911380,3606,51686820,3107,20272
1583,4,2,19,6,59929860,3606,51687240,3107,20276
1584,8,8,18,7,59952300,3607,51690960,3105,20284
1585,6,13,18,7,59959320,3607,51692880,3105,20290
1586,2,11,19,6,59992140,3609,51709140,3105,20292
1587,3,9,22,3,60005940,3609,51734700,3106,20295
1588,6,1,25,0,60047460,3609,51840780,3111,20301
1589,5,0,17,8,60090480,3609,51840780,3110,20306
1590,10,0,20,5,60104040,3608,51840780,3108,20316
1591,10,0,23,2,60129540,3608,51840780,3106,20326
1592,6,2,22,3,60150600,3608,51841080,3106,20332
1593,18,11,23,2,60195240,3609,51844500,3102,20350
1594,16,26,20,5,60208080,3609,51845460,3102,20366
1595,10,33,18,7,60245220,3610,51856920,3098,20376
1596,10,40,17,8,60257460,3611,51862680,3098,20386
1597,11,38,19,6,60284640,3612,51898140,3099,20397
1598,11,40,18,7,60292740,3612,51898140,3099,20408
1599,6,35,24,1,60323640,3613,52035720,3105,20414
1600,7,35,25,0,60347100,3613,52091700,3107,20421
1601,10,33,25,0,60399180,3613,52238580,3114,20431
1602,10,32,25,0,60442380,3613,52264980,3114,20441
1603,7,30,25,0,60484320,3614,52398480,3121,20448
1604,10,27,25,0,60529200,3614,52676520,3135,20458
1605,5,10,25,0,60577020,3612,52994760,3153,20463
1606,7,0,18,7,60621900,3609,53239680,3166,20470
1607,0,0,14,11,60642660,3610,53239680,3166,20470
1608,3,0,15,10,60645720,3610,53239680,3166,20473
1609,2,0,14,11,60658740,3610,53239680,3166,20475
1610,7,0,18,7,60669720,3610,53239680,3164,20482
1611,5,0,18,7,60678660,3609,53239680,3163,20487
1612,5,0,19,6,60695640,3609,53239680,3162,20492
1613,13,0,23,2,60712920,3608,53240220,3160,20505
1614,6,1,21,4,60739740,3609,53240340,3159,20511
1615,11,7,21,4,60769860,3609,53241840,3157,20522
1616,12,14,21,4,60797160,3610,53250600,3156,20534
1617,10,14,24,1,60845760,3611,53268300,3154,20544
1618,8,11,25,0,60875100,3611,53296980,3154,20552
1619,14,12,19,6,60923100,3610,53348760,3155,20566
1620,7,16,20,5,60936360,3610,53353920,3154,20573
1621,13,27,19,6,60959820,3611,53356920,3152,20586
1622,8,32,18,7,60982860,3611,53359800,3151,20594
1623,6,34,20,5,61003380,3612,53369760,3150,20600
1624,9,37,22,3,61031820,3613,53423640,3151,20609
1625,8,40,25,0,61044300,3613,53492460,3154,20617
1626,9,34,25,0,61115820,3614,53596620,3159,20626
1627,12,32,25,0,61145280,3613,53673180,3161,20638
1628,8,24,25,0,61185480,3612,53882640,3172,20646
1629,9,5,25,0,61247700,3610,54340560,3197,20655
1630,10,0,23,2,61283940,3608,54457380,3202,20665
1631,3,0,16,9,61312620,3608,54457380,3201,20668
1632,3,0,15,10,61335000,3608,54457380,3201,20671
1633,9,0,20,5,61345080,3608,54457380,3199,20680
1634,3,0,18,7,61360620,3608,54457380,3199,20683
1635,5,0,21,4,61378500,3609,54457380,3198,20688
1636,5,0,21,4,61398120,3609,54457380,3197,20693
1637,6,0,17,8,61441320,3609,54457380,3196,20699
1638,9,0,17,8,61463400,3608,54457380,3194,20708
1639,12,0,22,3,61480380,3608,54457380,3192,20720
1640,7,3,19,6,61496280,3607,54457560,3190,20727
1641,1,1,18,7,61524900,3608,54468960,3191,20728
1642,4,0,21,4,61543560,3609,54471180,3190,20732
1643,10,0,21,4,61582200,3609,54471420,3188,20742
1644,7,0,18,7,61609080,3608,54471420,3187,20749
1645,10,0,21,4,61628700,3608,54471420,3185,20759
1646,9,0,24,1,61641780,3608,54471420,3183,20768
1647,7,0,22,3,61674060,3608,54472440,3182,20775
1648,11,6,20,5,61705860,3608,54474240,3180,20786
1649,7,0,23,2,61741500,3608,54490800,3180,20793
1650,12,0,20,5,61787760,3608,54490800,3178,20805
1651,7,0,22,3,61798800,3607,54490800,3176,20812
1652,4,0,16,9,61836360,3607,54490800,3176,20816
1653,5,0,18,7,61847340,3607,54490800,3175,20821
1654,10,0,25,0,61859280,3607,54490800,3173,20831
1655,4,0,19,6,61891140,3607,54491100,3172,20835
1656,4,0,15,10,61913640,3607,54491100,3171,20839
1657,8,0,20,5,61928520,3607,54491100,3170,20847
1658,1,0,15,10,61947960,3607,54491100,3170,20848
1659,3,0,15,10,61955700,3607,54491100,3169,20851
1660,8,0,19,6,61961460,3606,54491100,3168,20859
1661,3,0,20,5,61967220,3606,54491100,3167,20862
1662,7,1,20,5,61995300,3606,54494160,3166,20869
1663,10,4,20,5,62013720,3606,54498780,3165,20879
1664,12,13,18,7,62048880,3607,54506040,3164,20891
1665,9,20,18,7,62062020,3607,54511320,3161,20900
1666,5,23,17,8,62078880,3608,54518040,3161,20905
1667,7,29,18,7,62078880,3608,54518580,3161,20912
1668,12,38,17,8,62119260,3609,54526680,3158,20924
1669,8,40,17,8,62119260,3609,54526680,3158,20932
1670,10,38,24,1,62141880,3610,54607440,3161,20942
1671,5,39,25,0,62158620,3610,54631680,3162,20947
1672,9,39,25,0,62213400,3612,54761760,3167,20956
1673,11,40,18,7,62256840,3612,54763080,3167,20967
1674,11,36,24,1,62283420,3613,54893700,3173,20978
1675,5,31,25,0,62316960,3613,55059960,3182,20983
1676,8,22,25,0,62368860,3613,55367940,3198,20991
1677,5,0,21,4,62414280,3609,55959480,3232,20996
1678,7,0,19,6,62430360,3608,55959480,3230,21003
1679,4,0,17,8,62460060,3608,55959480,3229,21007
1680,3,0,16,9,62472960,3608,55959480,3229,21010
1681,6,0,18,7,62490180,3608,55959480,3228,21016
1682,15,3,25,0,62506020,3608,55960860,3225,21031
1683,22,16,22,3,62543040,3608,55968960,3221,21053
1684,25,32,24,1,62571780,3608,55976700,3219,21078
1685,27,40,17,8,62615220,3609,55978200,3216,21105
1686,31,40,18,7,62637060,3609,55996920,3216,21136
1687,28,38,18,7,62653920,3610,56019420,3217,21164
1688,25,40,25,0,62677620,3611,56086320,3219,21189
1689,34,39,23,2,62716500,3611,56128680,3220,21223
1690,31,39,23,2,62750040,3611,56183820,3222,21254
1691,30,40,23,2,62793000,3612,56219580,3222,21284
1692,31,40,19,6,62810220,3612,56223000,3222,21315
1693,31,40,25,0,62834640,3613,56321760,3226,21346
1694,30,39,25,0,62889900,3613,56366400,3227,21376
1695,27,39,19,6,62933520,3614,56440080,3230,21403
1696,30,40,21,4,62968920,3614,56496420,3231,21433
1697,32,40,20,5,62997780,3613,56573220,3234,21465
1698,27,39,18,7,63025920,3614,56582100,3234,21492
1699,30,38,25,0,63066900,3614,56782920,3242,21522
1700,28,40,25,0,63096660,3613,56787840,3240,21550
1701,34,39,25,0,63146880,3613,56806920,3239,21584
1702,30,40,25,0,63185160,3612,56847300,3238,21614
1703,34,40,21,4,63224220,3612,56902920,3240,21648
1704,28,40,18,7,63250140,3612,56958720,3242,21676
1705,21,40,21,4,63267720,3613,56983680,3243,21697
1706,34,38,24,1,63304200,3613,57037140,3244,21731
1707,29,39,25,0,63355920,3613,57078360,3244,21760
1708,34,40,25,0,63380700,3613,57098340,3243,21794
1709,31,39,25,0,63440040,3613,57154740,3244,21825
1710,28,40,25,0,63476820,3613,57168780,3242,21853
1711,30,40,20,5,63514020,3613,57204240,3243,21883
1712,25,40,23,2,63544500,3613,57258900,3244,21908
1713,39,40,20,5,63576900,3614,57266580,3244,21947
1714,35,40,17,8,63599640,3614,57267120,3244,21982
1715,41,40,21,4,63626100,3615,57278580,3243,22023
1716,37,40,18,7,63637860,3615,57278580,3243,22060
1717,29,40,25,0,63682740,3614,57438720,3248,22089
1718,41,40,24,1,63709860,3614,57492900,3250,22130
1719,38,40,25,0,63751620,3614,57535860,3250,22168
1720,31,40,23,2,63797460,3614,57593220,3251,22199
1721,32,40,20,5,63824040,3613,57650460,3253,22231
1722,27,40,22,3,63857340,3614,57659580,3252,22258
1723,29,40,19,6,63882720,3614,57669840,3252,22287
1724,25,38,22,3,63924840,3616,57681900,3252,22312
1725,38,40,25,0,63941700,3616,57684660,3250,22350
1726,18,34,25,0,64003260,3615,58103040,3271,22368
1727,25,38,25,0,64043400,3615,58253520,3276,22393
1728,25,40,25,0,64066020,3615,58261620,3276,22418
1729,36,40,25,0,64108320,3615,58328880,3277,22454
1730,35,40,17,8,64155300,3615,58332780,3277,22489
1731,34,40,25,0,64188420,3616,58396440,3277,22523
1732,30,39,25,0,64227840,3616,58454340,3279,22553
1733,34,39,21,4,64273860,3615,58502640,3280,22587
1734,28,39,25,0,64290960,3616,58507680,3279,22615
1735,40,40,22,3,64324020,3615,58520100,3278,22655
1736,30,40,22,3,64387440,3616,58534260,3277,22685
1737,31,40,18,7,64409220,3616,58565040,3278,22716
1738,28,40,23,2,64447980,3616,58650840,3280,22744
1739,39,40,18,7,64465320,3616,58650840,3280,22783
1740,35,38,25,0,64506120,3617,58691580,3279,22818
1741,34,40,25,0,64547520,3616,58709220,3277,22852
1742,36,40,20,5,64581420,3616,58751520,3279,22888
1743,31,40,25,0,64599240,3616,58847220,3282,22919
1744,26,39,25,0,64646640,3616,58856580,3281,22945
1745,28,40,20,5,64681320,3616,58876200,3281,22973
1746,31,39,25,0,64712220,3616,58903080,3280,23004
1747,25,40,25,0,64738680,3617,58908180,3279,23029
1748,29,39,25,0,64792500,3617,58947720,3279,23058
1749,26,38,25,0,64837860,3616,59175540,3289,23084
1750,21,40,25,0,64865460,3615,59189460,3287,23105
1751,28,39,25,0,64926780,3615,59226960,3286,23133
1752,32,40,24,1,64952160,3614,59229480,3284,23165
1753,27,40,24,1,64996860,3614,59255160,3284,23192
1754,29,40,20,5,65029500,3615,59260020,3283,23221
1755,31,40,25,0,65066760,3615,59560140,3297,23252
1756,26,39,25,0,65106900,3615,59573940,3296,23278
1757,34,39,25,0,65150520,3615,59610060,3296,23312
1758,28,40,23,2,65193000,3614,59865120,3307,23340
1759,36,39,20,5,65222100,3614,59878620,3308,23376
1760,32,39,24,1,65262240,3615,59908500,3307,23408
1761,30,40,20,5,65278140,3615,59910360,3307,23438
1762,30,37,25,0,65306220,3614,60354000,3329,23468
1763,34,40,25,0,65348760,3614,60367800,3327,23502
1764,32,40,25,0,65366880,3614,60378540,3327,23534
1765,30,36,25,0,65449680,3615,60684060,3341,23564
1766,31,40,25,0,65472900,3614,60690480,3338,23595
1767,29,40,21,4,65531100,3614,61021860,3355,23624
1768,33,40,21,4,65549040,3615,61028940,3354,23657
1769,35,38,25,0,65584200,3616,61061520,3355,23692
1770,31,40,25,0,65620320,3616,61078620,3354,23723
1771,26,39,20,5,65652360,3616,61086480,3353,23749
1772,34,40,25,0,65691600,3615,61174380,3355,23783
1773,27,38,25,0,65735460,3615,61213080,3354,23810
1774,33,39,25,0,65779080,3615,61239960,3354,23843
1775,35,40,25,0,65822340,3615,61246620,3352,23878
1776,25,40,25,0,65856960,3615,61286160,3353,23903
1777,31,40,21,4,65911380,3616,61344060,3354,23934
1778,27,39,25,0,65934180,3616,61375440,3354,23961
1779,31,37,25,0,65977380,3616,61384800,3353,23992
1780,28,40,25,0,66001020,3616,61450500,3355,24020
1781,19,38,25,0,66064440,3616,61523940,3356,24039
1782,34,40,19,6,66103020,3616,61529400,3355,24073
1783,39,38,22,3,66122580,3617,61604640,3358,24112
1784,26,40,24,1,66158700,3617,61622640,3357,24138
1785,23,40,24,1,66180540,3616,61719660,3361,24161
1786,30,40,25,0,66209040,3616,61727220,3360,24191
1787,24,40,25,0,66277020,3616,61834320,3363,24215
1788,27,40,25,0,66302400,3616,61862280,3362,24242
1789,32,40,25,0,66349080,3616,61872720,3361,24274
1790,29,40,22,3,66396420,3617,61901760,3361,24303
1791,30,38,25,0,66450120,3617,62035800,3365,24333
1792,36,39,25,0,66470880,3616,62055900,3364,24369
1793,27,40,24,1,66507420,3616,62067900,3363,24396
1794,34,39,25,0,66540840,3616,62102040,3363,24430
1795,42,40,25,0,66594180,3617,62118540,3362,24472
1796,33,40,23,2,66638040,3617,62161260,3363,24505
1797,43,40,21,4,66670980,3617,62163120,3362,24548
1798,40,40,25,0,66702120,3617,62222280,3363,24588
1799,37,40,25,0,66750480,3617,62287320,3364,24625
1800,28,40,25,0,66790080,3617,62292300,3362,24653
1801,22,40,20,5,66827940,3617,62294280,3361,24675
1802,31,40,18,7,66861060,3618,62301780,3361,24706
1803,27,40,17,8,66866940,3618,62301780,3361,24733
1804,34,40,23,2,66907140,3618,62443800,3365,24767
1805,24,35,25,0,66954060,3617,62711880,3377,24791
1806,28,40,21,4,66973980,3617,62712420,3376,24819
1807,27,39,23,2,67018860,3617,62763060,3376,24846
1808,29,40,25,0,67055340,3616,63620100,3419,24875
1809,26,38,25,0,67101900,3617,63653280,3419,24901
1810,27,40,20,5,67150860,3616,63692040,3419,24928
1811,31,39,19,6,67174200,3616,63703080,3419,24959
1812,20,40,25,0,67204980,3617,63727320,3418,24979
1813,26,39,25,0,67257480,3617,63733440,3416,25005
1814,26,40,25,0,67287360,3617,63763200,3416,25031
1815,37,40,25,0,67310940,3617,63768840,3415,25068
1816,31,40,22,3,67376040,3617,63842940,3417,25099
1817,33,40,19,6,67403580,3618,63849120,3416,25132
1818,32,40,19,6,67433160,3617,63894360,3417,25164
1819,41,40,23,2,67446180,3617,63936480,3417,25205
1820,30,40,20,5,67480980,3617,63941460,3417,25235
1821,20,39,20,5,67512000,3618,63973320,3417,25255
1822,38,40,25,0,67538580,3618,63974940,3416,25293
1823,34,40,25,0,67564080,3618,63990660,3415,25327
1824,25,38,24,1,67632900,3617,64330080,3429,25352
1825,26,40,19,6,67652700,3617,64330080,3429,25378
1826,36,38,21,4,67688760,3618,64348860,3429,25414
1827,33,38,25,0,67721700,3618,64382760,3428,25447
1828,27,38,25,0,67771020,3619,64388160,3426,25474
1829,34,40,25,0,67793880,3618,64942740,3454,25508
1830,29,40,25,0,67850700,3618,64965900,3453,25537
1831,33,39,25,0,67894320,3618,65007240,3452,25570
1832,37,39,25,0,67940040,3618,65096280,3455,25607
1833,28,38,25,0,67983300,3618,65144100,3456,25635
1834,32,39,25,0,68018280,3618,65155380,3454,25667
1835,37,40,20,5,68044680,3619,65157960,3454,25704
1836,25,40,25,0,68072940,3619,65244540,3457,25729
1837,34,40,25,0,68120820,3618,65340000,3459,25763
1838,28,40,22,3,68144040,3618,65366580,3459,25791
1839,30,40,18,7,68196480,3619,65377380,3459,25821
1840,26,40,19,6,68206920,3619,65380860,3458,25847
1841,43,40,21,4,68232240,3618,65515980,3463,25890
1842,30,40,22,3,68267940,3618,65528160,3462,25920
1843,32,40,25,0,68296500,3618,66077340,3488,25952
1844,34,40,25,0,68321760,3618,66081840,3488,25986
1845,31,40,25,0,68384400,3618,66120540,3487,26017
1846,30,40,25,0,68412000,3619,66139560,3487,26047
1847,24,35,25,0,68474460,3619,66259320,3491,26071
1848,6,16,25,0,68523060,3617,74012400,3899,26077
1849,7,0,20,5,68570580,3614,79284900,4175,26084
1850,5,0,18,7,68589420,3614,79284900,4174,26089
1851,6,0,21,4,68603640,3614,79284900,4172,26095
1852,5,0,21,4,68626740,3614,79284900,4171,26100
1853,8,0,25,0,68644500,3615,79284900,4170,26108
1854,7,0,21,4,68692800,3615,79285080,4168,26115
1855,2,0,18,7,68718840,3616,79285080,4168,26117
1856,6,0,20,5,68750940,3616,79285080,4166,26123
1857,12,1,25,0,68765100,3616,79285080,4164,26135
1858,10,0,24,1,68805000,3616,79285740,4161,26145
1859,11,0,24,1,68835840,3615,79289700,4159,26156
1860,14,0,23,2,68883660,3615,79289760,4156,26170
1861,6,0,18,7,68920920,3615,79289760,4155,26176
1862,10,0,22,3,68936640,3615,79289760,4153,26186
1863,12,0,22,3,68965740,3614,79289760,4150,26198
1864,13,0,22,3,69010380,3614,79289760,4147,26211
1865,7,0,21,4,69040140,3614,79289760,4146,26218
1866,6,0,16,9,69075660,3614,79289760,4145,26224
1867,7,0,19,6,69092100,3614,79289760,4143,26231
1868,9,0,23,2,69102420,3613,79289760,4141,26240
1869,7,0,24,1,69129180,3614,79290240,4140,26247
1870,6,0,22,3,69167340,3614,79291140,4138,26253
1871,10,2,25,0,69189960,3614,79292760,4136,26263
1872,8,0,20,5,69248760,3614,79297020,4135,26271
1873,3,0,18,7,69277020,3615,79297020,4134,26274
1874,12,0,23,2,69304080,3615,79297020,4131,26286
1875,6,0,22,3,69328260,3615,79297020,4130,26292
1876,5,0,19,6,69364440,3615,79297020,4129,26297
1877,3,0,20,5,69376320,3616,79297020,4128,26300
1878,8,0,20,5,69406080,3616,79297020,4127,26308
1879,10,0,22,3,69434040,3616,79297020,4125,26318
1880,3,0,18,7,69470640,3616,79297020,4124,26321
1881,9,0,21,4,69487200,3616,79297020,4122,26330
1882,16,0,24,1,69521880,3615,79297020,4119,26346
1883,13,3,25,0,69541680,3615,79297860,4116,26359
1884,9,5,23,2,69592140,3616,79301220,4114,26368
1885,12,7,22,3,69640680,3616,79308360,4112,26380
1886,12,18,19,6,69659820,3616,79309500,4112,26392
1887,5,20,17,8,69694860,3617,79320360,4109,26397
1888,5,23,18,7,69704580,3618,79328700,4109,26402
1889,7,27,19,6,69718620,3618,79338960,4108,26409
1890,6,29,21,4,69737100,3618,79374600,4108,26415
1891,10,30,25,0,69770340,3619,79427160,4109,26425
1892,5,26,25,0,69811080,3620,79510680,4112,26430
1893,8,11,25,0,69880500,3619,79795980,4125,26438
1894,4,0,17,8,69908400,3616,79999920,4135,26442
1895,4,0,19,6,69912600,3616,79999920,4134,26446
1896,7,0,16,9,69943140,3616,79999920,4132,26453
1897,4,0,17,8,69950040,3615,79999920,4131,26457
1898,3,0,17,8,69963180,3616,79999920,4131,26460
1899,2,0,16,9,69972720,3615,79999920,4130,26462
1900,2,0,14,11,69990240,3616,79999920,4130,26464
1901,5,0,18,7,69992460,3616,79999920,4129,26469
1902,10,1,25,0,70001700,3616,79999920,4127,26479
1903,4,0,21,4,70032720,3616,79999920,4126,26483
1904,11,0,20,5,70079040,3616,79999920,4123,26494
1905,11,2,21,4,70100700,3615,80001600,4121,26505
1906,9,5,21,4,70136160,3616,80007660,4120,26514
1907,10,6,25,0,70161060,3616,80013420,4118,26524
1908,12,7,24,1,70203480,3616,80039400,4117,26536
1909,15,17,21,4,70245360,3617,80047620,4114,26551
1910,10,26,19,6,70264740,3617,80050980,4112,26561
1911,13,35,19,6,70295820,3618,80065980,4110,26574
1912,6,40,18,7,70311900,3619,80068440,4110,26580
1913,9,38,18,7,70346040,3620,80102100,4110,26589
1914,11,40,19,6,70346040,3620,80113200,4110,26600
1915,5,37,20,5,70380960,3620,80171340,4112,26605
1916,5,35,25,0,70391760,3621,80283300,4117,26610
1917,4,33,25,0,70427820,3621,80366460,4120,26614
1918,7,28,25,0,70475160,3622,80491740,4125,26621
1919,5,22,25,0,70518660,3622,80665140,4133,26626
1920,3,3,25,0,70578900,3621,81248160,4162,26629
1921,2,0,15,10,70606200,3619,81363600,4168,26631
1922,5,0,16,9,70612560,3619,81363600,4167,26636
1923,5,0,19,6,70620120,3619,81363600,4166,26641
1924,9,0,22,3,70640580,3619,81363600,4164,26650
1925,7,0,21,4,70674120,3619,81364140,4162,26657
1926,3,0,16,9,70706580,3619,81364140,4162,26660
1927,7,0,19,6,70722060,3619,81364140,4160,26667
1928,5,1,19,6,70730700,3619,81364380,4159,26672
1929,11,11,18,7,70742100,3619,81365160,4157,26683
1930,9,15,19,6,70759380,3619,81373800,4155,26692
1931,8,15,24,1,70788000,3620,81396360,4155,26700
1932,20,27,25,0,70820940,3621,81414000,4151,26720
1933,11,28,25,0,70864620,3621,81444420,4151,26731
1934,11,29,25,0,70901820,3621,81470280,4150,26742
1935,12,29,25,0,70942740,3621,81549660,4151,26754
1936,11,29,25,0,70999440,3622,81572340,4150,26765
1937,9,25,25,0,71037960,3621,81605460,4150,26774
1938,14,5,25,0,71091780,3618,82025400,4168,26788
1939,7,0,20,5,71126040,3617,82149900,4173,26795
1940,6,0,18,7,71148600,3616,82149900,4172,26801
1941,4,0,15,10,71175720,3616,82149900,4171,26805
1942,8,0,19,6,71185560,3616,82149900,4169,26813
1943,8,0,20,5,71196480,3615,82149900,4167,26821
1944,8,0,19,6,71228820,3615,82149900,4166,26829
1945,8,0,22,3,71244600,3615,82149900,4164,26837
1946,6,0,18,7,71278200,3615,82149900,4163,26843
1947,3,0,18,7,71288460,3615,82149900,4162,26846
1948,4,0,19,6,71297100,3615,82149900,4161,26850
1949,6,0,23,2,71309280,3615,82149900,4160,26856
1950,6,0,18,7,71355060,3616,82149900,4159,26862
1951,7,0,17,8,71377860,3615,82149900,4157,26869
1952,8,0,21,4,71391240,3615,82149900,4156,26877
1953,4,0,17,8,71427780,3616,82149900,4155,26881
1954,10,0,21,4,71437740,3615,82149900,4153,26891
1955,10,0,20,5,71479740,3615,82150860,4151,26901
1956,12,0,25,0,71502780,3615,82150860,4148,26913
1957,14,7,25,0,71532420,3615,82158480,4146,26927
1958,9,13,18,7,71585940,3616,82163940,4144,26936
1959,14,24,19,6,71599800,3616,82173660,4142,26950
1960,10,31,19,6,71619240,3617,82181760,4140,26960
1961,9,36,19,6,71647380,3618,82191660,4139,26969
1962,8,39,20,5,71662380,3618,82211400,4138,26977
1963,6,35,25,0,71687460,3618,82330860,4143,26983
1964,4,33,25,0,71729220,3619,82373640,4145,26987
1965,9,28,25,0,71782380,3619,82488060,4148,26996
1966,3,21,25,0,71810100,3619,82622700,4154,26999
1967,5,8,25,0,71876460,3619,82993260,4172,27004
1968,4,0,16,9,71914560,3617,83138100,4178,27008
1969,6,0,16,9,71928480,3617,83138100,4177,27014
1970,9,0,21,4,71940480,3617,83138100,4175,27023
1971,5,1,19,6,71953320,3616,83139000,4174,27028
1972,5,0,18,7,71982180,3616,83142900,4173,27033
1973,3,0,18,7,71997180,3617,83142900,4173,27036
1974,6,2,19,6,72003960,3616,83144400,4172,27042
1975,10,0,24,1,72040140,3617,83150400,4170,27052
1976,15,4,25,0,72066960,3616,83151360,4167,27067
1977,8,0,24,1,72120840,3617,83162220,4166,27075
1978,4,1,21,4,72143640,3617,83162640,4165,27079
1979,11,6,21,4,72187680,3618,83172900,4163,27090
1980,13,12,23,2,72208260,3618,83179980,4161,27103
1981,14,22,19,6,72243600,3618,83184960,4158,27117
1982,13,33,19,6,72255660,3619,83194020,4156,27130
1983,13,40,19,6,72286920,3619,83204880,4154,27143
1984,9,40,18,7,72294840,3620,83204880,4154,27152
1985,10,40,19,6,72325140,3620,83226480,4154,27162
1986,13,40,19,6,72333180,3621,83241600,4155,27175
1987,14,36,25,0,72368640,3621,83411940,4162,27189
1988,6,36,25,0,72401040,3622,83448540,4162,27195
1989,9,35,25,0,72450120,3623,83569800,4166,27204
1990,5,29,25,0,72492300,3623,83771940,4175,27209
1991,5,17,25,0,72544680,3622,84141540,4193,27214
1992,9,0,22,3,72591240,3619,84563640,4212,27223
1993,6,0,20,5,72608280,3619,84563640,4210,27229
1994,7,0,18,7,72627480,3618,84563640,4209,27236
1995,5,0,15,10,72664020,3618,84563640,4208,27241
1996,8,0,17,8,72670260,3618,84563640,4206,27249
1997,8,0,21,4,72680820,3617,84563640,4205,27257
1998,4,0,20,5,72705300,3618,84563640,4204,27261
1999,7,0,18,7,72747000,3618,84563640,4202,27268
2000,10,1,22,3,72756840,3618,84563640,4200,27278
2001,9,0,24,1,72778260,3617,84565500,4198,27287
2002,14,5,18,7,72834660,3618,84567780,4196,27301
2003,18,22,17,8,72846960,3618,84572400,4192,27319
2004,14,35,16,9,72867600,3618,84574620,4189,27333
2005,8,40,17,8,72877320,3619,84584460,4189,27341
2006,8,40,17,8,72877320,3619,84584460,4189,27349
2007,5,37,18,7,72917220,3620,84631740,4190,27354
2008,6,40,19,6,72917220,3620,84649560,4191,27360
2009,6,39,19,6,72941520,3621,84726180,4193,27366
2010,6,38,24,1,72954780,3621,84823500,4197,27372
2011,12,40,21,4,72995700,3622,84854640,4198,27384
2012,5,36,18,7,73041120,3623,84929700,4201,27389
2013,10,38,25,0,73048620,3623,85063440,4206,27399
2014,2,31,25,0,73082700,3623,85197120,4212,27401
2015,3,19,25,0,73139520,3623,85573020,4230,27404
2016,9,0,17,8,73197600,3619,86230920,4260,27413
2017,5,0,17,8,73203840,3619,86230920,4259,27418
2018,3,0,19,6,73206600,3619,86230920,4259,27421
2019,7,0,22,3,73214640,3618,86230920,4257,27428
2020,5,0,24,1,73229400,3619,86230920,4256,27433
2021,5,0,22,3,73258380,3619,86230920,4255,27438
2022,3,0,21,4,73275600,3619,86230920,4254,27441
2023,9,1,25,0,73288560,3619,86230920,4253,27450
2024,7,0,25,0,73323300,3619,86232540,4251,27457
2025,2,0,20,5,73347240,3619,86232540,4251,27459
2026,8,0,23,2,73362540,3619,86232540,4249,27467
2027,14,0,25,0,73400760,3619,86233380,4246,27481
2028,14,7,25,0,73418820,3618,86235480,4244,27495
2029,9,13,22,3,73450200,3619,86241120,4242,27504
2030,10,23,20,5,73464900,3619,86241120,4242,27514
2031,8,27,21,4,73492380,3620,86259600,4239,27522
2032,18,40,22,3,73504740,3620,86277960,4238,27540
2033,6,39,21,4,73521480,3621,86291520,4237,27546
2034,7,38,24,1,73557060,3622,86344080,4238,27553
2035,7,40,25,0,73573800,3622,86368080,4239,27560
2036,8,39,25,0,73613520,3623,86444340,4241,27568
2037,7,39,25,0,73629540,3623,86487600,4242,27575
2038,8,35,25,0,73672200,3623,86648100,4249,27583
2039,5,30,25,0,73713420,3624,86809620,4256,27588
2040,7,27,25,0,73748220,3624,86956200,4262,27595
2041,7,25,25,0,73773720,3623,87089160,4267,27602
2042,11,17,25,0,73807920,3622,87415920,4281,27613
2043,4,3,25,0,73841580,3620,87741960,4296,27617
2044,3,0,20,5,73872180,3620,87814320,4299,27620
2045,7,0,22,3,73884180,3619,87814320,4297,27627
2046,5,0,22,3,73895820,3619,87814320,4296,27632
2047,10,0,25,0,73921080,3619,87814320,4294,27642
2048,3,0,20,5,73946460,3619,87814320,4293,27645
2049,5,0,21,4,73970880,3619,87814320,4292,27650
2050,4,0,22,3,73983180,3619,87814320,4292,27654
2051,13,3,25,0,74007300,3619,87817740,4290,27667
2052,9,10,21,4,74029440,3619,87819720,4288,27676
2053,9,16,21,4,74054400,3620,87832740,4286,27685
2054,8,22,21,4,74066400,3620,87840060,4285,27693
2055,14,33,22,3,74089500,3621,87864360,4283,27707
2056,7,33,25,0,74112180,3621,87909000,4284,27714
2057,10,37,25,0,74131260,3621,87925320,4282,27724
2058,14,39,25,0,74175480,3622,87958500,4282,27738
2059,13,38,25,0,74212860,3622,87984420,4281,27751
2060,9,38,25,0,74239800,3622,88019220,4282,27760
2061,7,36,25,0,74281200,3623,88114560,4285,27767
2062,3,32,25,0,74302260,3623,88257060,4291,27770
2063,4,16,25,0,74351280,3621,88670220,4310,27774
2064,5,0,20,5,74381100,3618,89087640,4330,27779
2065,4,0,17,8,74400060,3618,89087640,4329,27783
2066,1,0,17,8,74401080,3618,89087640,4329,27784
2067,6,0,21,4,74402520,3618,89087640,4327,27790
2068,5,0,21,4,74415720,3617,89087640,4326,27795
2069,2,0,20,5,74430840,3618,89087640,4326,27797
2070,6,0,23,2,74442180,3618,89087640,4325,27803
2071,8,0,25,0,74473320,3618,89089080,4323,27811
2072,8,0,25,0,74496060,3618,89089200,4321,27819
2073,13,9,25,0,74518920,3618,89094060,4319,27832
2074,8,16,22,3,74540040,3618,89094840,4318,27840
2075,9,19,25,0,74560800,3619,89109300,4316,27849
2076,9,19,25,0,74616840,3620,89126700,4315,27858
2077,10,21,25,0,74642940,3620,89163480,4315,27868
2078,11,24,25,0,74682420,3620,89174820,4313,27879
2079,13,30,25,0,74708160,3620,89181660,4311,27892
2080,14,39,25,0,74732460,3621,89187780,4309,27906
2081,4,37,25,0,74768820,3621,89195940,4308,27910
2082,8,35,25,0,74809560,3622,89235960,4308,27918
2083,7,33,25,0,74841300,3622,89370660,4313,27925
2084,7,32,25,0,74872860,3622,89436840,4315,27932
2085,9,32,22,3,74904000,3621,89535720,4318,27941
2086,6,33,21,4,74926380,3621,89541180,4317,27947
2087,5,26,25,0,74945280,3621,89661180,4321,27952
2088,7,20,25,0,74984160,3621,90011340,4337,27959
2089,7,7,25,0,75018840,3619,90434460,4356,27966
2090,6,0,23,2,75044400,3617,90652380,4365,27972
2091,6,0,23,2,75068160,3617,90652380,4364,27978
2092,2,0,20,5,75091200,3618,90652380,4363,27980
2093,9,0,24,1,75103260,3617,90652800,4361,27989
2094,4,0,23,2,75119940,3617,90652800,4361,27993
2095,10,2,25,0,75138720,3617,90653340,4359,28003
2096,4,0,21,4,75178680,3617,90656340,4358,28007
2097,11,1,25,0,75198780,3617,90657300,4356,28018
2098,12,5,25,0,75237840,3618,90661320,4353,28030
2099,7,0,24,1,75276420,3617,90676320,4352,28037
2100,14,1,25,0,75306840,3617,90678780,4350,28051
2101,9,4,25,0,75321600,3616,90681420,4348,28060
2102,12,1,25,0,75364140,3616,90698340,4346,28072
2103,8,0,24,1,75389760,3615,90698340,4345,28080
2104,8,0,22,3,75422040,3615,90698580,4343,28088
2105,12,4,22,3,75449220,3615,90699720,4340,28100
2106,9,12,22,3,75455460,3615,90700860,4339,28109
2107,17,25,21,4,75488700,3616,90707460,4337,28126
2108,3,28,21,4,75488700,3616,90707460,4337,28129
2109,4,28,21,4,75521520,3617,90755040,4336,28133
2110,5,27,25,0,75536220,3617,90788940,4337,28138
2111,4,21,25,0,75579120,3617,90936660,4343,28142
2112,5,13,25,0,75618300,3617,91059600,4348,28147
2113,5,0,23,2,75651120,3615,91266420,4357,28152
2114,5,0,21,4,75658200,3614,91266420,4356,28157
2115,6,0,20,5,75689760,3615,91266420,4354,28163
2116,6,0,22,3,75695700,3614,91266420,4353,28169
2117,10,0,25,0,75713520,3614,91269360,4351,28179
2118,8,2,24,1,75742500,3614,91278720,4350,28187
2119,7,0,24,1,75774300,3614,91286340,4349,28194
2120,5,0,21,4,75792780,3613,91286340,4348,28199
2121,10,0,24,1,75814800,3613,91286520,4346,28209
2122,8,2,25,0,75828540,3613,91287120,4345,28217
2123,13,8,25,0,75865380,3614,91290660,4342,28230
2124,9,8,25,0,75896400,3614,91305240,4341,28239
2125,7,0,22,3,75937920,3612,91334040,4340,28246
2126,6,0,22,3,75962400,3613,91334160,4339,28252
2127,7,0,22,3,75989460,3613,91334220,4338,28259
2128,12,1,25,0,76017360,3613,91336080,4335,28271
2129,10,6,25,0,76033980,3613,91341660,4334,28281
2130,6,5,25,0,76081320,3614,91361940,4333,28287
2131,8,1,25,0,76108740,3613,91394220,4333,28295
2132,7,0,22,3,76140540,3613,91394220,4332,28302
2133,8,0,25,0,76165380,3613,91396380,4330,28310
2134,9,0,22,3,76198320,3612,91398060,4328,28319
2135,6,0,22,3,76218120,3612,91398060,4327,28325
2136,6,0,22,3,76246080,3613,91398060,4326,28331
2137,2,0,20,5,76266240,3613,91398060,4326,28333
2138,6,0,23,2,76279080,3613,91398060,4324,28339
2139,6,0,24,1,76300200,3613,91398060,4323,28345
2140,5,0,19,6,76337520,3613,91398060,4322,28350
2141,3,0,21,4,76339440,3613,91398060,4322,28353
2142,12,0,25,0,76374480,3613,91399020,4319,28365
2143,9,0,24,1,76404300,3613,91401600,4317,28374
2144,11,1,25,0,76428360,3613,91405500,4315,28385
2145,13,7,25,0,76460640,3613,91408620,4313,28398
2146,10,9,25,0,76494480,3613,91419120,4311,28408
2147,18,14,25,0,76536480,3613,91430580,4308,28426
2148,7,18,25,0,76551480,3613,91436760,4307,28433
2149,9,21,25,0,76583820,3614,91452900,4306,28442
2150,8,21,25,0,76619760,3614,91507080,4307,28450
2151,10,23,25,0,76653360,3614,91511940,4305,28460
2152,14,32,25,0,76675440,3614,91517820,4303,28474
2153,5,26,25,0,76729440,3615,91544160,4303,28479
2154,10,25,25,0,76758480,3615,91579320,4302,28489
2155,10,31,25,0,76777500,3615,91580880,4301,28499
2156,4,23,25,0,76822140,3615,91676280,4304,28503
2157,4,18,25,0,76836780,3614,91840920,4311,28507
2158,3,0,24,1,76900200,3613,92360640,4335,28510
2159,6,0,21,4,76915320,3612,92360640,4334,28516
2160,6,0,21,4,76930260,3612,92360640,4332,28522
2161,4,0,22,3,76944900,3612,92360640,4332,28526
2162,9,0,24,1,76964160,3612,92360640,4330,28535
2163,0,0,16,9,77008080,3613,92360640,4330,28535
2164,5,0,20,5,77009460,3613,92360640,4329,28540
2165,8,1,25,0,77011680,3612,92360880,4327,28548
2166,9,0,25,0,77047980,3612,92361000,4325,28557
2167,9,0,20,5,77081400,3612,92361840,4324,28566
2168,7,0,23,2,77097300,3612,92361840,4322,28573
2169,9,0,23,2,77120040,3611,92361840,4320,28582
2170,12,3,25,0,77144520,3611,92362680,4319,28594
2171,12,9,25,0,77168100,3611,92368920,4316,28606
2172,12,13,25,0,77207400,3612,92380320,4314,28618
2173,12,19,25,0,77234100,3612,92384580,4312,28630
2174,7,22,25,0,77258040,3612,92396940,4311,28637
2175,9,24,25,0,77299860,3613,92417220,4311,28646
2176,10,23,25,0,77341260,3613,92434500,4309,28656
2177,16,32,24,1,77369820,3613,92461440,4307,28672
2178,14,40,21,4,77388360,3613,92464020,4305,28686
2179,7,40,21,4,77407740,3614,92475060,4305,28693
2180,9,40,22,3,77432460,3615,92506260,4306,28702
2181,6,38,25,0,77454960,3615,92536440,4307,28708
2182,3,37,25,0,77475960,3615,92541000,4306,28711
2183,8,39,25,0,77505840,3616,92585940,4307,28719
2184,3,31,25,0,77558580,3617,92731440,4313,28722
2185,4,22,25,0,77596320,3616,93063900,4328,28726
2186,2,0,23,2,77633460,3614,93897900,4366,28728
2187,5,0,23,2,77638440,3613,93897900,4365,28733
2188,6,2,25,0,77648700,3613,93898200,4364,28739
2189,4,0,17,8,77697540,3613,93898860,4363,28743
2190,7,0,23,2,77698200,3613,93898860,4362,28750
2191,10,1,24,1,77711760,3612,93899520,4360,28760
2192,3,0,24,1,77736960,3613,93905220,4359,28763
2193,8,0,21,4,77773380,3612,93905220,4358,28771
2194,14,6,25,0,77782440,3612,93905220,4356,28785
2195,8,10,21,4,77810580,3612,93910140,4354,28793
2196,13,23,21,4,77810580,3612,93910140,4354,28806
2197,8,26,21,4,77856600,3614,93929400,4350,28814
2198,11,32,25,0,77860980,3614,93941880,4349,28825
2199,9,38,23,2,77890620,3614,93948360,4347,28834
2200,15,40,22,3,77919540,3615,93952440,4346,28849
2201,12,39,22,3,77943780,3615,93982260,4347,28861
2202,6,38,25,0,77972040,3616,94032540,4348,28867
2203,6,33,25,0,78002700,3616,94170000,4353,28873
2204,5,29,25,0,78035760,3616,94299900,4358,28878
2205,4,24,25,0,78066660,3616,94497960,4367,28882
2206,7,13,25,0,78097920,3614,94844580,4381,28889
2207,5,9,25,0,78131640,3614,94969500,4386,28894
2208,5,1,25,0,78165240,3613,95162700,4394,28899
2209,5,0,21,4,78187440,3613,95197020,4395,28904
2210,8,0,24,1,78203280,3613,95197020,4393,28912
2211,11,1,25,0,78235020,3613,95197020,4391,28923
2212,1,0,19,6,78258720,3612,95197380,4391,28924
2213,7,0,23,2,78277620,3613,95197380,4389,28931
2214,7,0,21,4,78293820,3612,95197380,4388,28938
2215,6,0,21,4,78310500,3612,95197380,4386,28944
2216,3,0,18,7,78326640,3612,95197380,4386,28947
2217,18,4,25,0,78345480,3611,95198040,4382,28965
2218,5,4,25,0,78365040,3611,95202540,4381,28970
2219,13,10,25,0,78405600,3612,95213340,4380,28983
2220,13,18,25,0,78428160,3612,95223360,4378,28996
2221,10,22,25,0,78466500,3613,95230320,4375,29006
2222,15,31,25,0,78496740,3613,95237040,4373,29021
2223,7,32,25,0,78532740,3614,95246820,4372,29028
2224,8,35,25,0,78564900,3615,95268780,4371,29036
2225,6,34,25,0,78593880,3615,95277360,4371,29042
2226,8,32,25,0,78640140,3615,95352120,4372,29050
2227,8,33,25,0,78659940,3615,95418900,4374,29058
2228,15,40,24,1,78684240,3615,95468400,4374,29073
2229,5,38,24,1,78721980,3616,95514660,4375,29078
2230,6,37,25,0,78753480,3616,95534760,4374,29084
2231,4,27,25,0,78796020,3616,95797320,4386,29088
2232,1,0,25,0,78834120,3613,96646380,4424,29089
2233,7,0,22,3,78844560,3612,96646380,4423,29096
2234,6,0,22,3,78861120,3612,96646380,4422,29102
2235,8,0,23,2,78890160,3612,96646560,4420,29110
2236,5,0,21,4,78916800,3612,96646560,4419,29115
2237,7,1,25,0,78923580,3612,96646980,4418,29122
2238,6,0,24,1,78953760,3612,96647820,4416,29128
2239,12,1,25,0,78985020,3612,96648000,4414,29140
2240,11,4,25,0,79017540,3612,96652080,4412,29151
2241,14,12,24,1,79049220,3612,96657420,4409,29165
2242,9,19,20,5,79084080,3613,96660780,4408,29174
2243,8,26,20,5,79091460,3613,96662160,4408,29182
2244,14,38,21,4,79101120,3613,96669000,4405,29196
2245,12,40,20,5,79127640,3614,96677220,4403,29208
2246,14,40,21,4,79141320,3614,96695580,4404,29222
2247,14,37,23,2,79168080,3614,96751680,4405,29236
2248,17,40,25,0,79175100,3615,96755460,4404,29253
2249,12,37,25,0,79225080,3616,96901260,4410,29265
2250,6,34,25,0,79260360,3616,96961920,4412,29271
2251,10,38,25,0,79285500,3616,96995760,4411,29281
2252,7,39,25,0,79307400,3616,97039200,4412,29288
2253,7,36,25,0,79356480,3617,97090080,4413,29295
2254,5,33,25,0,79385400,3617,97241880,4419,29300
2255,8,34,25,0,79410120,3617,97409820,4425,29308
2256,5,34,23,2,79443900,3617,97416240,4424,29313
2257,7,35,24,1,79475760,3618,97483380,4426,29320
2258,3,28,25,0,79506660,3618,97708920,4435,29323
2259,7,17,25,0,79543740,3616,98297280,4461,29330
2260,4,0,21,4,79578300,3614,98877300,4486,29334
2261,8,0,24,1,79589460,3614,98877300,4485,29342
2262,6,0,22,3,79616520,3614,98877720,4483,29348
2263,8,0,21,4,79648680,3613,98877720,4482,29356
2264,10,0,25,0,79671780,3614,98883840,4480,29366
2265,11,2,23,2,79710780,3614,98888580,4478,29377
2266,13,11,21,4,79727760,3613,98891220,4476,29390
2267,7,15,21,4,79749480,3614,98900940,4474,29397
2268,14,28,21,4,79756140,3614,98904180,4473,29411
2269,10,34,22,3,79777920,3614,98917020,4472,29421
2270,12,39,22,3,79800960,3615,98935560,4469,29433
2271,11,39,24,1,79821360,3615,98989920,4471,29444
2272,10,40,25,0,79843800,3616,99048420,4473,29454
2273,5,38,25,0,79872420,3616,99074220,4473,29459
2274,13,40,25,0,79907280,3617,99093360,4473,29472
2275,2,33,25,0,79938900,3617,99204060,4477,29474
2276,7,29,25,0,79983840,3617,99343080,4482,29481
2277,14,39,21,4,80010420,3617,99412080,4483,29495
2278,6,40,20,5,80031720,3618,99418380,4482,29501
2279,3,40,21,4,80043180,3618,99435960,4483,29504
2280,3,39,20,5,80054040,3618,99442440,4483,29507
2281,12,39,25,0,80077080,3619,99514500,4484,29519
2282,2,33,25,0,80118600,3619,99710940,4493,29521
2283,2,25,25,0,80154720,3619,100079100,4509,29523
2284,6,3,25,0,80191380,3616,100911480,4545,29529
2285,7,0,24,1,80206860,3615,101064240,4551,29536
2286,11,0,23,2,80245200,3615,101065680,4548,29547
2287,7,0,24,1,80264700,3615,101066040,4547,29554
2288,8,0,24,1,80297400,3615,101069100,4545,29562
2289,11,4,25,0,80313000,3615,101070060,4543,29573
2290,1,0,18,7,80359380,3615,101075280,4543,29574
2291,9,0,24,1,80368560,3615,101075280,4541,29583
2292,6,0,24,1,80384940,3615,101075280,4540,29589
2293,8,0,25,0,80414100,3615,101075580,4539,29597
2294,9,5,23,2,80437680,3615,101078640,4537,29606
2295,9,7,25,0,80466420,3615,101089800,4536,29615
2296,9,6,25,0,80509560,3616,101108280,4535,29624
2297,11,8,25,0,80539080,3615,101128020,4533,29635
2298,8,0,25,0,80570100,3614,101168100,4533,29643
2299,11,5,25,0,80591340,3614,101170980,4531,29654
2300,4,1,25,0,80626140,3615,101188440,4531,29658
2301,8,0,25,0,80652480,3614,101188620,4530,29666
2302,5,0,23,2,80682420,3614,101188680,4529,29671
2303,2,0,18,7,80719740,3615,101188680,4528,29673
2304,3,0,19,6,80726700,3615,101188680,4528,29676
2305,3,0,18,7,80740320,3615,101188680,4527,29679
2306,4,0,20,5,80743020,3615,101188680,4526,29683
2307,3,0,18,7,80756700,3615,101188680,4526,29686
2308,10,0,22,3,80773920,3614,101188680,4524,29696
2309,5,0,23,2,80784120,3614,101188680,4523,29701
2310,7,0,23,2,80810460,3614,101188680,4521,29708
2311,8,3,25,0,80827080,3614,101189640,4520,29716
2312,15,12,25,0,80855880,3615,101195340,4517,29731
2313,14,24,21,4,80884860,3615,101197980,4515,29745
2314,11,29,24,1,80915100,3616,101215020,4513,29756
2315,6,32,24,1,80926440,3616,101224860,4512,29762
2316,9,35,25,0,80955900,3617,101249880,4511,29771
2317,12,40,25,0,80995080,3617,101262420,4510,29783
2318,8,40,21,4,81015360,3617,101262420,4510,29791
2319,12,40,25,0,81044760,3618,101320440,4511,29803
2320,9,38,25,0,81085500,3618,101423040,4513,29812
2321,9,37,25,0,81106200,3617,101497980,4515,29821
2322,8,37,25,0,81142980,3618,101504940,4513,29829
2323,5,31,25,0,81174840,3617,101600520,4516,29834
2324,7,9,25,0,81217740,3615,102374040,4550,29841
2325,5,0,22,3,81244860,3613,102613800,4559,29846
2326,6,0,23,2,81257520,3613,102613800,4558,29852
2327,9,0,24,1,81290640,3613,102613800,4556,29861
2328,5,0,22,3,81315180,3613,102613800,4555,29866
2329,7,0,23,2,81340920,3613,102613800,4554,29873
2330,3,0,20,5,81362520,3613,102613800,4553,29876
2331,8,0,23,2,81376140,3613,102613800,4551,29884
2332,6,0,23,2,81385080,3612,102613800,4550,29890
2333,5,0,22,3,81425160,3613,102613800,4549,29895
2334,7,0,22,3,81448980,3613,102613800,4548,29902
2335,6,0,23,2,81469440,3613,102613800,4547,29908
2336,13,7,25,0,81486240,3613,102615900,4544,29921
2337,12,15,21,4,81534000,3614,102621720,4542,29933
2338,12,24,22,3,81546660,3614,102627480,4540,29945
2339,17,39,22,3,81561660,3615,102638820,4538,29962
2340,17,40,21,4,81595860,3616,102650400,4537,29979
2341,10,39,21,4,81618840,3616,102665940,4537,29989
2342,11,40,20,5,81629340,3616,102669060,4537,30000
2343,13,40,21,4,81636300,3616,102681000,4537,30013
2344,11,40,19,6,81657720,3617,102681000,4537,30024
2345,12,39,24,1,81673740,3617,102768960,4539,30036
2346,10,40,23,2,81692700,3618,102797820,4540,30046
2347,8,38,25,0,81713760,3618,102878760,4543,30054
2348,10,39,25,0,81757560,3619,102956280,4545,30064
2349,7,40,25,0,81779400,3619,103033920,4547,30071
2350,8,38,25,0,81819780,3619,103168020,4551,30079
2351,7,36,25,0,81856320,3620,103417080,4561,30086
2352,8,31,25,0,81893640,3619,103592880,4567,30094
2353,4,6,25,0,81931200,3616,104587020,4610,30098
2354,17,7,25,0,81952680,3615,104703840,4612,30115
2355,20,21,25,0,81975540,3615,104707020,4610,30135
2356,24,40,24,1,81998700,3615,104711460,4604,30159
2357,33,40,20,5,82026960,3616,104711460,4604,30192
2358,25,39,20,5,82064100,3617,104734380,4604,30217
2359,33,40,21,4,82064100,3617,104744700,4604,30250
2360,29,38,25,0,82089780,3617,104830980,4606,30279
2361,30,40,25,0,82101960,3617,104834460,4606,30309
2362,40,40,25,0,82147740,3618,104878620,4606,30349
2363,38,40,25,0,82172700,3618,104951520,4608,30387
2364,31,40,25,0,82212180,3618,104998740,4609,30418
2365,32,40,25,0,82243320,3618,105108360,4612,30450
2366,32,38,25,0,82277700,3618,105191640,4613,30482
2367,34,39,25,0,82318260,3619,105222300,4613,30516
2368,35,40,25,0,82335240,3619,105261180,4614,30551
2369,27,40,25,0,82366080,3619,105493860,4623,30578
2370,34,39,25,0,82409040,3619,105603780,4625,30612
2371,29,40,25,0,82434360,3619,105659220,4626,30641
2372,37,40,25,0,82472460,3619,105688980,4626,30678
2373,28,40,22,3,82504620,3619,105723840,4626,30706
2374,41,39,23,2,82525560,3620,105732240,4625,30747
2375,29,40,25,0,82550820,3620,105777660,4625,30776
2376,32,39,25,0,82595280,3619,105893340,4628,30808
2377,28,40,25,0,82624200,3618,106068120,4632,30836
2378,34,40,25,0,82648920,3618,106084620,4631,30870
2379,32,39,25,0,82678860,3618,106097220,4630,30902
2380,27,40,25,0,82713060,3618,106100520,4629,30929
2381,28,40,25,0,82731000,3618,106119000,4628,30957
2382,32,40,25,0,82781700,3619,106176420,4629,30989
2383,25,40,25,0,82820040,3619,106182360,4627,31014
2384,33,40,25,0,82837260,3619,106185600,4626,31047
2385,38,39,25,0,82878000,3619,106219380,4625,31085
2386,38,39,25,0,82916700,3618,106311900,4627,31123
2387,42,40,25,0,82935300,3618,106318200,4625,31165
2388,28,40,25,0,82966200,3618,106385400,4627,31193
2389,29,40,25,0,83003520,3618,106410000,4626,31222
2390,33,40,25,0,83041740,3619,106415880,4625,31255
2391,27,40,25,0,83065200,3619,106433700,4624,31282
2392,36,40,25,0,83089200,3619,106493640,4625,31318
2393,29,39,25,0,83137860,3619,106505880,4623,31347
2394,36,40,25,0,83161920,3619,106535400,4623,31383
2395,30,40,25,0,83198040,3619,106543440,4622,31413
2396,30,40,25,0,83224440,3619,106548720,4621,31443
2397,34,40,25,0,83260800,3619,106613160,4622,31477
2398,24,40,25,0,83300280,3620,106634640,4621,31501
2399,35,40,25,0,83313600,3619,106664040,4621,31536

