Hour,Arrivals,Waiting,Treating,Available Rooms,Total Treatment Time,Average Treatment Time,Total Wait Time,Average Wait Time,Total Arrivals
1,1,0,1,24,0,0,0,0,1
2,5,0,4,21,1320,660,0,0,6
3,5,0,5,20,13380,2230,0,0,11
4,7,0,7,18,30780,2798,0,0,18
5,8,0,10,15,49740,3108,0,0,26
6,2,0,2,23,90420,3477,0,0,28
7,5,0,3,22,103200,3440,0,0,33
8,2,0,3,22,109260,3414,0,0,35
9,7,0,6,19,118560,3293,0,0,42
10,9,0,9,16,138600,3300,0,0,51
11,9,0,10,15,181020,3620,0,0,60
12,10,0,8,17,217620,3510,0,0,70
13,10,0,13,12,241620,3606,0,0,80
14,4,0,8,17,270840,3563,0,0,84
15,7,0,6,19,313080,3683,0,0,91
16,7,0,5,20,334860,3600,0,0,98
17,8,0,7,18,346800,3503,0,0,106
18,9,0,11,14,365100,3510,0,0,115
19,4,0,7,18,403980,3606,0,0,119
20,4,0,3,22,439980,3666,0,0,123
21,8,0,6,19,456300,3650,0,0,131
22,9,0,6,19,480420,3585,0,0,140
23,5,0,6,19,498780,3588,0,0,145
24,0,0,2,23,520380,3639,0,0,145
25,3,0,1,24,536640,3650,0,0,148
26,5,0,3,22,540540,3603,0,0,153
27,7,0,4,21,555240,3559,0,0,160
28,4,0,5,20,564720,3551,0,0,164
29,6,0,5,20,578760,3507,0,0,170
30,13,0,13,12,595560,3503,0,0,183
31,7,0,9,16,634080,3503,0,0,190
32,15,0,14,11,677760,3548,0,0,205
33,5,0,8,17,720240,3565,0,0,210
34,13,0,11,14,754320,3558,0,0,223
35,12,0,11,14,797580,3560,0,0,235
36,5,0,8,17,834180,3595,0,0,240
37,14,0,13,12,858300,3561,0,0,254
38,6,0,7,18,918420,3630,0,0,260
39,10,0,9,16,949500,3637,0,0,270
40,9,0,8,17,973260,3591,0,0,279
41,10,0,12,13,991680,3580,0,0,289
42,9,0,7,18,1045560,3592,0,0,298
43,7,0,8,17,1067640,3594,0,0,305
44,5,0,5,20,1101120,3610,0,0,310
45,3,0,3,22,1126260,3633,0,0,313
46,6,0,7,18,1131540,3626,0,0,319
47,3,0,4,21,1157640,3640,0,0,322
48,5,0,5,20,1176240,3652,0,0,327
49,6,0,5,20,1190640,3630,0,0,333
50,5,0,7,18,1207560,3648,0,0,338
51,9,0,9,16,1233120,3648,0,0,347
52,6,0,7,18,1265280,3656,0,0,353
53,5,0,5,20,1290660,3656,0,0,358
54,5,0,6,19,1312320,3675,0,0,363
55,4,0,5,20,1333200,3682,0,0,367
56,10,0,9,16,1347960,3662,0,0,377
57,10,0,14,11,1370220,3673,0,0,387
58,9,0,9,16,1416720,3660,0,0,396
59,10,0,9,16,1455000,3664,0,0,406
60,17,0,16,9,1492620,3667,0,0,423
61,17,0,17,8,1541400,3643,0,0,440
62,7,0,11,14,1582680,3630,0,0,447
63,8,0,7,18,1643280,3668,0,0,455
64,4,0,6,19,1664460,3674,0,0,459
65,7,0,7,18,1695720,3694,0,0,466
66,11,0,14,11,1705320,3683,0,0,477
67,7,0,7,18,1754760,3678,0,0,484
68,5,0,4,21,1797780,3706,0,0,489
69,5,0,4,21,1814880,3703,0,0,494
70,3,0,4,21,1827120,3706,0,0,497
71,4,0,3,22,1837620,3690,0,0,501
72,7,0,8,17,1843080,3686,0,0,508
73,6,0,5,20,1871640,3677,0,0,514
74,6,0,6,19,1892100,3681,0,0,520
75,3,0,2,23,1915380,3676,0,0,523
76,3,0,3,22,1916760,3664,0,0,526
77,9,0,9,16,1930320,3669,0,0,535
78,7,0,6,19,1961700,3659,0,0,542
79,6,0,8,17,1987980,3681,0,0,548
80,8,0,9,16,2010420,3675,0,0,556
81,5,0,7,18,2033940,3671,0,0,561
82,6,0,5,20,2070180,3683,0,0,567
83,7,0,8,17,2092140,3696,0,0,574
84,6,0,6,19,2122020,3696,0,0,580
85,11,0,8,17,2148300,3684,0,0,591
86,10,0,11,14,2177880,3691,0,0,601
87,15,0,13,12,2201040,3650,0,0,616
88,7,0,11,14,2249220,3675,0,0,623
89,6,0,8,17,2289240,3686,0,0,629
90,12,0,10,15,2324640,3684,0,0,641
91,6,0,5,20,2353740,3666,0,0,647
92,7,0,6,19,2382660,3676,0,0,654
93,6,0,6,19,2407980,3681,0,0,660
94,6,0,3,22,2431560,3667,0,0,666
95,7,0,7,18,2440500,3664,0,0,673
96,7,0,6,19,2461920,3652,0,0,680
97,4,0,5,20,2480760,3653,0,0,684
98,8,0,8,17,2500620,3655,0,0,692
99,3,0,5,20,2521440,3654,0,0,695
100,3,0,5,20,2535300,3658,0,0,698
101,4,0,3,22,2561520,3664,0,0,702
102,6,0,7,18,2569500,3665,0,0,708
103,6,0,8,17,2588100,3665,0,0,714
104,10,0,12,13,2596800,3647,0,0,724
105,8,0,7,18,2646240,3649,0,0,732
106,9,0,9,16,2668740,3645,0,0,741
107,9,0,6,19,2706120,3637,0,0,750
108,9,0,8,17,2738580,3646,0,0,759
109,16,0,14,11,2763840,3631,0,0,775
110,8,0,13,12,2797140,3632,0,0,783
111,4,0,6,19,2859300,3661,0,0,787
112,9,0,8,17,2893080,3671,0,0,796
113,5,0,5,20,2915100,3662,0,0,801
114,3,0,2,23,2948340,3676,0,0,804
115,3,0,3,22,2951520,3671,0,0,807
116,4,0,4,21,2956260,3663,0,0,811
117,8,0,6,19,2983680,3669,0,0,819
118,2,0,4,21,2998980,3670,0,0,821
119,3,0,2,23,3018660,3672,0,0,824
120,3,0,3,22,3024240,3670,0,0,827
121,5,0,4,21,3032820,3662,0,0,832
122,7,0,7,18,3043620,3658,0,0,839
123,2,0,3,22,3072780,3666,0,0,841
124,4,0,2,23,3090120,3665,0,0,845
125,4,0,4,21,3099900,3668,0,0,849
126,5,0,7,18,3101940,3662,0,0,854
127,7,0,5,20,3135780,3663,0,0,861
128,7,0,9,16,3148920,3665,0,0,868
129,12,0,14,11,3164160,3653,0,0,880
130,10,0,10,15,3220020,3659,0,0,890
131,9,0,8,17,3263700,3662,0,0,899
132,5,0,8,17,3283980,3665,0,0,904
133,7,0,8,17,3321360,3678,0,0,911
134,4,0,9,16,3332280,3678,0,0,915
135,9,0,11,14,3375000,3696,0,0,924
136,12,0,9,16,3422640,3692,0,0,936
137,9,0,13,12,3444840,3696,0,0,945
138,9,0,14,11,3485760,3708,0,0,954
139,5,0,8,17,3534360,3716,0,0,959
140,6,0,6,19,3575220,3728,0,0,965
141,1,0,1,24,3598500,3729,0,0,966
142,4,0,4,21,3604080,3730,0,0,970
143,6,0,4,21,3614880,3719,0,0,976
144,4,0,4,21,3631680,3720,0,0,980
145,4,0,4,21,3653040,3727,0,0,984
146,6,0,7,18,3664980,3728,0,0,990
147,8,0,11,14,3678000,3726,0,0,998
148,5,0,7,18,3718440,3733,0,0,1003
149,7,0,7,18,3740580,3729,0,0,1010
150,8,0,5,20,3772320,3723,0,0,1018
151,6,0,5,20,3791580,3720,0,0,1024
152,5,0,5,20,3797940,3708,0,0,1029
153,9,0,6,19,3825060,3706,0,0,1038
154,6,0,7,18,3839700,3702,0,0,1044
155,11,0,9,16,3867420,3697,0,0,1055
156,11,0,10,15,3891120,3684,0,0,1066
157,9,0,9,16,3934680,3691,0,0,1075
158,7,0,8,17,3972540,3698,0,0,1082
159,11,0,8,17,4009800,3695,0,0,1093
160,10,0,8,17,4034280,3684,0,0,1103
161,10,0,9,16,4060920,3678,0,0,1113
162,7,0,8,17,4079880,3668,0,0,1120
163,11,0,8,17,4123800,3672,0,0,1131
164,8,0,10,15,4134420,3662,0,0,1139
165,4,0,9,16,4158300,3666,0,0,1143
166,6,0,5,20,4201020,3672,0,0,1149
167,4,0,3,22,4226460,3675,0,0,1153
168,6,0,6,19,4232340,3670,0,0,1159
169,3,0,4,21,4242360,3663,0,0,1162
170,5,0,5,20,4275780,3679,0,0,1167
171,11,0,8,17,4291320,3667,0,0,1178
172,5,0,9,16,4308300,3669,0,0,1183
173,10,0,10,15,4353840,3680,0,0,1193
174,7,0,13,12,4368000,3679,0,0,1200
175,5,0,8,17,4412820,3686,0,0,1205
176,7,0,6,19,4444560,3685,0,0,1212
177,8,0,6,19,4478700,3689,0,0,1220
178,9,0,8,17,4502580,3687,0,0,1229
179,6,0,8,17,4523760,3686,0,0,1235
180,8,0,7,18,4562700,3691,0,0,1243
181,13,0,10,15,4590720,3684,0,0,1256
182,9,0,8,17,4616280,3672,0,0,1265
183,8,0,7,18,4636320,3662,0,0,1273
184,8,0,7,18,4663140,3660,0,0,1281
185,2,0,1,24,4703760,3669,0,0,1283
186,8,0,5,20,4715160,3666,0,0,1291
187,4,0,4,21,4733580,3666,0,0,1295
188,5,0,7,18,4745640,3670,0,0,1300
189,4,0,4,21,4776120,3673,0,0,1304
190,4,0,5,20,4790040,3676,0,0,1308
191,3,0,4,21,4804080,3675,0,0,1311
192,4,0,4,21,4822380,3678,0,0,1315
193,1,0,2,23,4842000,3684,0,0,1316
194,5,0,5,20,4850340,3685,0,0,1321
195,1,0,3,22,4867680,3690,0,0,1322
196,2,0,3,22,4876020,3691,0,0,1324
197,4,0,1,24,4899660,3692,0,0,1328
198,3,0,3,22,4901940,3691,0,0,1331
199,4,0,5,20,4903200,3686,0,0,1335
200,11,0,7,18,4931700,3683,0,0,1346
201,9,0,9,16,4955040,3681,0,0,1355
202,6,0,9,16,4970340,3676,0,0,1361
203,15,0,14,11,5014980,3682,0,0,1376
204,9,0,11,14,5054340,3678,0,0,1385
205,6,0,10,15,5084220,3681,0,0,1391
206,13,0,12,13,5144640,3695,0,0,1404
207,7,0,8,17,5168700,3684,0,0,1411
208,11,0,10,15,5208600,3688,0,0,1422
209,7,0,10,15,5229900,3685,0,0,1429
210,11,0,14,11,5252100,3683,0,0,1440
211,8,0,11,14,5302800,3690,0,0,1448
212,8,0,9,16,5354400,3700,0,0,1456
213,8,0,7,18,5395380,3703,0,0,1464
214,4,0,4,21,5414880,3698,0,0,1468
215,9,0,8,17,5429160,3695,0,0,1477
216,3,0,4,21,5455080,3695,0,0,1480
217,4,0,2,23,5486100,3701,0,0,1484
218,4,0,5,20,5488680,3701,0,0,1488
219,4,0,5,20,5497140,3696,0,0,1492
220,6,0,6,19,5515620,3696,0,0,1498
221,5,0,6,19,5524500,3690,0,0,1503
222,3,0,3,22,5560380,3699,0,0,1506
223,8,0,5,20,5569020,3690,0,0,1514
224,10,0,11,14,5588940,3693,0,0,1524
225,11,0,13,12,5618640,3691,0,0,1535
226,4,0,5,20,5677800,3701,0,0,1539
227,5,0,5,20,5693640,3699,0,0,1544
228,13,0,8,17,5720400,3692,0,0,1557
229,8,0,6,19,5750220,3688,0,0,1565
230,5,0,8,17,5765700,3691,0,0,1570
231,9,0,10,15,5793960,3692,0,0,1579
232,7,0,8,17,5833500,3696,0,0,1586
233,10,0,11,14,5866200,3701,0,0,1596
234,4,0,6,19,5902260,3702,0,0,1600
235,7,0,8,17,5925720,3705,0,0,1607
236,7,0,9,16,5950200,3707,0,0,1614
237,8,0,9,16,5972820,3702,0,0,1622
238,7,0,8,17,6009540,3707,0,0,1629
239,7,0,4,21,6046920,3705,0,0,1636
240,3,0,2,23,6066420,3705,0,0,1639
241,7,0,5,20,6072900,3700,0,0,1646
242,3,0,4,21,6088320,3701,0,0,1649
243,5,0,5,20,6102540,3700,0,0,1654
244,2,0,3,22,6120480,3702,0,0,1656
245,6,0,5,20,6131640,3700,0,0,1662
246,10,0,9,16,6156240,3701,0,0,1672
247,12,0,9,16,6190860,3696,0,0,1684
248,5,0,5,20,6229440,3699,0,0,1689
249,9,0,7,18,6250620,3696,0,0,1698
250,6,0,7,18,6267540,3693,0,0,1704
251,16,0,13,12,6297300,3689,0,0,1720
252,7,0,14,11,6318720,3688,0,0,1727
253,2,0,5,20,6389580,3706,0,0,1729
254,7,0,5,20,6421740,3709,0,0,1736
255,7,0,7,18,6442920,3711,0,0,1743
256,9,0,6,19,6474300,3708,0,0,1752
257,16,0,15,10,6492240,3703,0,0,1768
258,7,0,10,15,6541560,3706,0,0,1775
259,5,0,7,18,6576120,3709,0,0,1780
260,6,0,7,18,6592920,3705,0,0,1786
261,7,0,5,20,6632280,3709,0,0,1793
262,4,0,4,21,6650220,3708,0,0,1797
263,3,0,3,22,6667020,3710,0,0,1800
264,2,0,2,23,6675540,3708,0,0,1802
265,5,0,5,20,6678420,3706,0,0,1807
266,7,0,6,19,6697080,3704,0,0,1814
267,4,0,5,20,6709560,3700,0,0,1818
268,4,0,4,21,6731100,3702,0,0,1822
269,13,0,6,19,6758400,3695,0,0,1835
270,7,0,9,16,6767700,3692,0,0,1842
271,6,0,9,16,6794640,3694,0,0,1848
272,5,0,4,21,6837180,3697,0,0,1853
273,10,0,9,16,6852900,3696,0,0,1863
274,5,0,5,20,6889140,3697,0,0,1868
275,3,0,4,21,6901500,3696,0,0,1871
276,9,0,7,18,6915540,3692,0,0,1880
277,14,0,12,13,6941280,3688,0,0,1894
278,16,0,15,10,6981300,3684,0,0,1910
279,9,0,13,12,7003200,3674,0,0,1919
280,9,0,9,16,7063800,3680,0,0,1928
281,7,0,9,16,7091340,3681,0,0,1935
282,13,0,13,12,7134180,3686,0,0,1948
283,7,0,9,16,7167240,3683,0,0,1955
284,8,0,10,15,7202640,3687,0,0,1963
285,8,0,8,17,7236960,3686,0,0,1971
286,6,0,8,17,7262100,3688,0,0,1977
287,5,0,6,19,7301580,3695,0,0,1982
288,3,0,3,22,7326780,3696,0,0,1985
289,6,0,3,22,7340880,3692,0,0,1991
290,3,0,5,20,7348680,3694,0,0,1994
291,8,0,5,20,7382940,3697,0,0,2002
292,8,0,6,19,7400340,3692,0,0,2010
293,5,0,5,20,7421820,3692,0,0,2015
294,5,0,6,19,7428360,3688,0,0,2020
295,7,0,7,18,7457520,3691,0,0,2027
296,8,0,11,14,7477320,3694,0,0,2035
297,11,0,8,17,7524720,3692,0,0,2046
298,8,0,8,17,7554600,3692,0,0,2054
299,6,0,8,17,7583400,3695,0,0,2060
300,13,0,8,17,7626240,3693,0,0,2073
301,12,0,13,12,7650360,3692,0,0,2085
302,15,0,13,12,7696020,3687,0,0,2100
303,6,0,6,19,7740120,3685,0,0,2106
304,8,0,8,17,7762980,3686,0,0,2114
305,9,0,8,17,7787820,3682,0,0,2123
306,12,0,11,14,7814340,3679,0,0,2135
307,3,0,6,19,7851000,3682,0,0,2138
308,14,0,8,17,7884360,3677,0,0,2152
309,7,0,7,18,7924080,3682,0,0,2159
310,8,0,9,16,7940880,3679,0,0,2167
311,8,0,9,16,7966980,3678,0,0,2175
312,4,0,8,17,7994940,3682,0,0,2179
313,7,0,9,16,8032080,3689,0,0,2186
314,6,0,5,20,8061240,3685,0,0,2192
315,4,0,4,21,8084820,3688,0,0,2196
316,4,0,2,23,8110140,3689,0,0,2200
317,3,0,3,22,8118540,3690,0,0,2203
318,5,0,2,23,8137800,3688,0,0,2208
319,5,0,5,20,8148960,3690,0,0,2213
320,7,0,5,20,8164140,3685,0,0,2220
321,9,0,9,16,8177340,3683,0,0,2229
322,5,0,8,17,8200080,3683,0,0,2234
323,10,0,8,17,8245620,3687,0,0,2244
324,10,0,5,20,8266620,3675,0,0,2254
325,6,0,7,18,8282520,3676,0,0,2260
326,7,0,8,17,8298420,3673,0,0,2267
327,8,0,9,16,8333520,3677,0,0,2275
328,9,0,9,16,8364000,3676,0,0,2284
329,9,0,9,16,8406840,3680,0,0,2293
330,9,0,11,14,8438400,3683,0,0,2302
331,5,0,7,18,8466780,3681,0,0,2307
332,6,0,7,18,8497200,3684,0,0,2313
333,3,0,7,18,8504520,3683,0,0,2316
334,4,0,2,23,8546820,3687,0,0,2320
335,3,0,3,22,8555760,3687,0,0,2323
336,7,0,6,19,8560860,3683,0,0,2330
337,8,0,5,20,8586420,3680,0,0,2338
338,1,0,2,23,8598000,3679,0,0,2339
339,4,0,5,20,8600220,3678,0,0,2343
340,8,0,8,17,8626140,3681,0,0,2351
341,6,0,10,15,8638320,3680,0,0,2357
342,7,0,8,17,8685660,3686,0,0,2364
343,18,0,17,8,8711760,3683,0,0,2382
344,14,0,15,10,8763780,3680,0,0,2396
345,11,0,12,13,8822040,3683,0,0,2407
346,12,0,5,20,8875560,3676,0,0,2419
347,14,0,14,11,8889900,3675,0,0,2433
348,13,0,14,11,8927460,3670,0,0,2446
349,11,0,13,12,8968980,3669,0,0,2457
350,16,0,13,12,9030420,3670,0,0,2473
351,11,0,13,12,9070800,3670,0,0,2484
352,5,0,9,16,9108600,3672,0,0,2489
353,6,0,6,19,9161220,3680,0,0,2495
354,4,0,4,21,9179280,3679,0,0,2499
355,6,0,7,18,9184560,3676,0,0,2505
356,11,0,10,15,9214080,3676,0,0,2516
357,2,0,3,22,9251940,3678,0,0,2518
358,5,0,4,21,9273240,3681,0,0,2523
359,3,0,5,20,9281460,3681,0,0,2526
360,6,0,8,17,9298140,3683,0,0,2532
361,2,0,3,22,9318240,3681,0,0,2534
362,1,0,1,24,9339180,3685,0,0,2535
363,3,0,2,23,9340380,3683,0,0,2538
364,6,0,5,20,9348600,3682,0,0,2544
365,5,0,4,21,9361560,3678,0,0,2549
366,8,0,9,16,9369480,3677,0,0,2557
367,7,0,8,17,9399180,3677,0,0,2564
368,10,0,10,15,9420900,3674,0,0,2574
369,5,0,7,18,9456840,3676,0,0,2579
370,7,0,3,22,9492240,3674,0,0,2586
371,8,0,8,17,9509580,3677,0,0,2594
372,9,0,9,16,9535920,3676,0,0,2603
373,2,0,2,23,9572100,3677,0,0,2605
374,5,0,4,21,9583500,3677,0,0,2610
375,11,0,6,19,9593880,3668,0,0,2621
376,12,0,12,13,9611700,3667,0,0,2633
377,9,0,9,16,9642300,3662,0,0,2642
378,7,0,8,17,9677040,3664,0,0,2649
379,6,0,6,19,9712680,3666,0,0,2655
380,4,0,5,20,9731280,3666,0,0,2659
381,1,0,4,21,9747780,3670,0,0,2660
382,4,0,4,21,9769020,3672,0,0,2664
383,9,0,6,19,9780120,3667,0,0,2673
384,3,0,4,21,9790920,3664,0,0,2676
385,1,0,5,20,9790920,3664,0,0,2677
386,7,0,6,19,9817980,3666,0,0,2684
387,5,0,8,17,9828480,3665,0,0,2689
388,8,0,7,18,9853680,3663,0,0,2697
389,3,0,4,21,9883380,3665,0,0,2700
390,8,0,6,19,9906120,3666,0,0,2708
391,8,0,9,16,9921000,3664,0,0,2716
392,6,0,9,16,9942480,3664,0,0,2722
393,6,0,9,16,9964680,3664,0,0,2728
394,8,0,6,19,10022340,3671,0,0,2736
395,6,0,4,21,10043160,3668,0,0,2742
396,10,0,9,16,10058580,3666,0,0,2752
397,11,0,11,14,10077720,3661,0,0,2763
398,10,0,6,19,10135320,3662,0,0,2773
399,6,0,3,22,10155960,3658,0,0,2779
400,8,0,7,18,10165500,3656,0,0,2787
401,6,0,8,17,10185780,3657,0,0,2793
402,6,0,7,18,10207440,3655,0,0,2799
403,6,0,9,16,10234020,3660,0,0,2805
404,9,0,10,15,10267140,3661,0,0,2814
405,10,0,9,16,10316400,3664,0,0,2824
406,3,0,7,18,10333200,3664,0,0,2827
407,1,0,1,24,10375440,3670,0,0,2828
408,2,0,3,22,10375440,3670,0,0,2830
409,4,0,2,23,10392000,3669,0,0,2834
410,3,0,3,22,10402380,3670,0,0,2837
411,4,0,5,20,10404300,3668,0,0,2841
412,12,0,10,15,10427100,3667,0,0,2853
413,4,0,5,20,10455540,3666,0,0,2857
414,9,0,5,20,10486500,3665,0,0,2866
415,7,0,6,19,10504140,3663,0,0,2873
416,2,0,5,20,10519860,3665,0,0,2875
417,7,0,9,16,10539060,3668,0,0,2882
418,5,0,6,19,10561740,3665,0,0,2887
419,9,0,8,17,10591740,3667,0,0,2896
420,8,0,5,20,10628460,3666,0,0,2904
421,4,0,6,19,10640400,3666,0,0,2908
422,5,0,6,19,10668300,3669,0,0,2913
423,5,0,2,23,10692060,3666,0,0,2918
424,11,0,10,15,10697940,3664,0,0,2929
425,13,0,13,12,10717560,3659,0,0,2942
426,6,0,9,16,10764120,3662,0,0,2948
427,6,0,5,20,10797360,3661,0,0,2954
428,8,0,9,16,10809960,3660,0,0,2962
429,11,0,8,17,10846260,3658,0,0,2973
430,7,0,7,18,10878720,3659,0,0,2980
431,4,0,5,20,10901820,3659,0,0,2984
432,4,0,3,22,10920840,3658,0,0,2988
433,6,0,8,17,10930260,3660,0,0,2994
434,5,0,5,20,10964160,3662,0,0,2999
435,6,0,7,18,10981020,3662,0,0,3005
436,3,0,4,21,11006580,3663,0,0,3008
437,6,0,7,18,11014980,3663,0,0,3014
438,11,0,13,12,11047440,3667,0,0,3025
439,9,0,13,12,11075520,3666,0,0,3034
440,8,0,14,11,11111460,3669,0,0,3042
441,12,0,14,11,11170980,3674,0,0,3054
442,4,0,9,16,11210100,3676,0,0,3058
443,7,0,5,20,11265840,3681,0,0,3065
444,6,0,9,16,11278380,3683,0,0,3071
445,5,0,9,16,11293380,3682,0,0,3076
446,7,0,8,17,11333880,3685,0,0,3083
447,9,0,6,19,11373720,3685,0,0,3092
448,8,0,9,16,11388000,3684,0,0,3100
449,10,0,10,15,11415840,3682,0,0,3110
450,7,0,9,16,11443500,3681,0,0,3117
451,14,0,12,13,11488320,3683,0,0,3131
452,4,0,5,20,11527080,3682,0,0,3135
453,4,0,3,22,11552520,3683,0,0,3139
454,6,0,8,17,11554380,3683,0,0,3145
455,4,0,9,16,11566200,3683,0,0,3149
456,3,0,6,19,11599620,3687,0,0,3152
457,5,0,6,19,11626680,3689,0,0,3157
458,6,0,7,18,11646300,3690,0,0,3163
459,4,0,2,23,11675880,3689,0,0,3167
460,3,0,2,23,11686500,3688,0,0,3170
461,5,0,4,21,11694300,3687,0,0,3175
462,1,0,1,24,11704500,3686,0,0,3176
463,12,0,9,16,11709540,3683,0,0,3188
464,8,0,9,16,11740860,3683,0,0,3196
465,10,0,9,16,11775720,3683,0,0,3206
466,6,0,7,18,11812860,3685,0,0,3212
467,7,0,7,18,11841420,3686,0,0,3219
468,9,0,7,18,11872680,3686,0,0,3228
469,10,0,8,17,11901900,3684,0,0,3238
470,8,0,9,16,11912220,3680,0,0,3246
471,12,0,7,18,11964180,3680,0,0,3258
472,5,0,6,19,11987700,3680,0,0,3263
473,9,0,7,18,12012960,3679,0,0,3272
474,8,0,9,16,12036240,3679,0,0,3280
475,9,0,14,11,12054840,3680,0,0,3289
476,7,0,8,17,12111000,3683,0,0,3296
477,4,0,4,21,12135360,3681,0,0,3300
478,9,0,7,18,12151200,3679,0,0,3309
479,6,0,5,20,12176580,3678,0,0,3315
480,10,0,5,20,12210360,3677,0,0,3325
481,5,0,8,17,12212580,3676,0,0,3330
482,4,0,7,18,12225840,3674,0,0,3334
483,4,0,5,20,12274380,3682,0,0,3338
484,1,0,3,22,12291300,3684,0,0,3339
485,3,0,5,20,12294840,3684,0,0,3342
486,6,0,6,19,12322920,3687,0,0,3348
487,7,0,8,17,12335460,3685,0,0,3355
488,8,0,11,14,12349800,3684,0,0,3363
489,7,0,6,19,12392520,3683,0,0,3370
490,9,0,8,17,12418620,3683,0,0,3379
491,10,0,10,15,12433620,3679,0,0,3389
492,3,0,4,21,12470940,3680,0,0,3392
493,10,0,8,17,12496860,3682,0,0,3402
494,7,0,8,17,12518820,3680,0,0,3409
495,6,0,5,20,12557040,3682,0,0,3415
496,6,0,5,20,12573660,3680,0,0,3421
497,6,0,5,20,12596100,3680,0,0,3427
498,6,0,5,20,12616920,3680,0,0,3433
499,5,0,6,19,12626280,3678,0,0,3438
500,5,0,7,18,12647820,3680,0,0,3443
501,6,0,8,17,12667140,3681,0,0,3449
502,3,0,3,22,12705240,3683,0,0,3452
503,3,0,4,21,12716820,3684,0,0,3455
504,4,0,5,20,12725940,3684,0,0,3459
505,6,0,4,21,12746760,3682,0,0,3465
506,10,0,10,15,12751200,3680,0,0,3475
507,4,0,5,20,12784680,3680,0,0,3479
508,4,0,3,22,12812340,3681,0,0,3483
509,5,0,4,21,12827280,3681,0,0,3488
510,2,0,2,23,12840780,3681,0,0,3490
511,9,0,7,18,12850380,3679,0,0,3499
512,8,0,4,21,12879660,3676,0,0,3507
513,7,0,5,20,12897300,3675,0,0,3514
514,8,0,8,17,12906360,3672,0,0,3522
515,6,0,3,22,12939480,3670,0,0,3528
516,6,0,6,19,12948660,3670,0,0,3534
517,8,0,8,17,12966180,3668,0,0,3542
518,9,0,8,17,12999060,3668,0,0,3551
519,4,0,3,22,13036800,3670,0,0,3555
520,11,0,10,15,13041120,3667,0,0,3566
521,7,0,8,17,13079100,3668,0,0,3573
522,4,0,4,21,13107240,3668,0,0,3577
523,12,0,8,17,13128600,3666,0,0,3589
524,4,0,8,17,13139520,3665,0,0,3593
525,5,0,3,22,13178340,3665,0,0,3598
526,4,0,5,20,13183800,3665,0,0,3602
527,2,0,1,24,13205460,3665,0,0,3604
528,7,0,6,19,13212540,3665,0,0,3611
529,2,0,5,20,13222260,3664,0,0,3613
530,6,0,4,21,13243920,3663,0,0,3619
531,4,0,3,22,13262580,3663,0,0,3623
532,4,0,2,23,13275840,3662,0,0,3627
533,3,0,4,21,13284300,3663,0,0,3630
534,11,0,9,16,13296900,3661,0,0,3641
535,14,0,11,14,13335840,3659,0,0,3655
536,7,0,12,13,13354740,3658,0,0,3662
537,7,0,9,16,13408800,3663,0,0,3669
538,4,0,8,17,13434060,3665,0,0,3673
539,11,0,8,17,13485060,3668,0,0,3684
540,8,0,8,17,13505640,3666,0,0,3692
541,8,0,12,13,13528800,3668,0,0,3700
542,6,0,8,17,13575120,3670,0,0,3706
543,4,0,2,23,13617240,3672,0,0,3710
544,8,0,5,20,13623540,3669,0,0,3718
545,6,0,8,17,13632240,3668,0,0,3724
546,5,0,5,20,13664580,3669,0,0,3729
547,4,0,4,21,13679400,3668,0,0,3733
548,3,0,3,22,13693080,3668,0,0,3736
549,7,0,8,17,13699320,3667,0,0,3743
550,4,0,5,20,13717860,3665,0,0,3747
551,3,0,6,19,13729140,3666,0,0,3750
552,3,0,4,21,13754760,3668,0,0,3753
553,3,0,3,22,13771080,3669,0,0,3756
554,4,0,4,21,13781940,3669,0,0,3760
555,5,0,4,21,13797000,3668,0,0,3765
556,6,0,6,19,13810860,3668,0,0,3771
557,7,0,4,21,13840920,3667,0,0,3778
558,9,0,8,17,13856460,3666,0,0,3787
559,8,0,9,16,13870440,3663,0,0,3795
560,10,0,12,13,13899360,3664,0,0,3805
561,3,0,7,18,13928100,3664,0,0,3808
562,10,0,6,19,13966260,3663,0,0,3818
563,13,0,8,17,13992840,3660,0,0,3831
564,5,0,8,17,14007300,3659,0,0,3836
565,11,0,10,15,14037900,3658,0,0,3847
566,7,0,8,17,14064240,3656,0,0,3854
567,10,0,8,17,14101260,3656,0,0,3864
568,7,0,7,18,14135220,3658,0,0,3871
569,9,0,5,20,14164200,3655,0,0,3880
570,6,0,8,17,14177700,3655,0,0,3886
571,12,0,12,13,14197920,3653,0,0,3898
572,5,0,5,20,14251920,3656,0,0,3903
573,9,0,6,19,14280180,3655,0,0,3912
574,6,0,7,18,14290440,3653,0,0,3918
575,8,0,7,18,14322240,3654,0,0,3926
576,3,0,5,20,14340960,3654,0,0,3929
577,2,0,2,23,14372040,3657,0,0,3931
578,2,0,3,22,14383980,3660,0,0,3933
579,5,0,7,18,14391780,3661,0,0,3938
580,4,0,7,18,14405700,3660,0,0,3942
581,3,0,6,19,14433720,3664,0,0,3945
582,3,0,3,22,14469300,3667,0,0,3948
583,11,0,7,18,14489880,3666,0,0,3959
584,9,0,9,16,14513640,3665,0,0,3968
585,6,0,12,13,14523360,3665,0,0,3974
586,10,0,10,15,14559780,3663,0,0,3984
587,2,0,6,19,14602680,3669,0,0,3986
588,9,0,7,18,14635200,3669,0,0,3995
589,7,0,9,16,14653380,3669,0,0,4002
590,6,0,7,18,14692440,3672,0,0,4008
591,3,0,6,19,14713800,3673,0,0,4011
592,8,0,10,15,14740080,3676,0,0,4019
593,10,0,12,13,14777400,3678,0,0,4029
594,6,0,7,18,14810280,3676,0,0,4035
595,7,0,9,16,14830200,3677,0,0,4042
596,10,0,11,14,14860500,3677,0,0,4052
597,3,0,8,17,14891520,3679,0,0,4055
598,6,0,5,20,14932680,3681,0,0,4061
599,4,0,5,20,14946420,3681,0,0,4065
600,6,0,3,22,14973000,3680,0,0,4071
601,6,0,4,21,14980500,3678,0,0,4077
602,3,0,3,22,14989860,3676,0,0,4080
603,5,0,2,23,15001800,3674,0,0,4085
604,3,0,2,23,15007500,3672,0,0,4088
605,1,0,1,24,15014100,3672,0,0,4089
606,7,0,4,21,15019080,3670,0,0,4096
607,6,0,7,18,15026160,3669,0,0,4102
608,12,0,11,14,15053880,3668,0,0,4114
609,8,0,7,18,15094140,3668,0,0,4122
610,7,0,9,16,15112680,3668,0,0,4129
611,5,0,5,20,15145380,3668,0,0,4134
612,7,0,5,20,15170100,3667,0,0,4141
613,2,0,3,22,15191220,3669,0,0,4143
614,9,0,8,17,15202980,3668,0,0,4152
615,5,0,7,18,15220680,3667,0,0,4157
616,9,0,9,16,15250920,3668,0,0,4166
617,8,0,9,16,15290700,3671,0,0,4174
618,10,0,10,15,15314520,3669,0,0,4184
619,8,0,7,18,15354120,3668,0,0,4192
620,7,0,5,20,15394680,3670,0,0,4199
621,4,0,5,20,15404580,3669,0,0,4203
622,1,0,3,22,15420180,3670,0,0,4204
623,5,0,4,21,15434880,3670,0,0,4209
624,7,0,5,20,15447360,3668,0,0,4216
625,4,0,4,21,15465240,3668,0,0,4220
626,8,0,5,20,15486660,3667,0,0,4228
627,3,0,1,24,15510000,3666,0,0,4231
628,5,0,4,21,15511560,3665,0,0,4236
629,14,0,10,15,15528000,3662,0,0,4250
630,8,0,10,15,15552360,3661,0,0,4258
631,3,0,7,18,15571560,3660,0,0,4261
632,7,0,9,16,15605220,3664,0,0,4268
633,5,0,7,18,15645600,3667,0,0,4273
634,9,0,9,16,15658140,3664,0,0,4282
635,8,0,8,17,15689640,3664,0,0,4290
636,7,0,11,14,15715920,3666,0,0,4297
637,12,0,13,12,15747960,3665,0,0,4309
638,13,0,10,15,15801840,3664,0,0,4322
639,12,0,13,12,15831780,3663,0,0,4334
640,9,0,10,15,15879960,3664,0,0,4343
641,7,0,9,16,15930240,3669,0,0,4350
642,7,0,7,18,15958380,3668,0,0,4357
643,7,0,9,16,15992340,3672,0,0,4364
644,5,0,8,17,16022400,3674,0,0,4369
645,11,0,9,16,16069800,3676,0,0,4380
646,6,0,6,19,16098840,3675,0,0,4386
647,2,0,3,22,16121820,3676,0,0,4388
648,4,0,4,21,16131900,3676,0,0,4392
649,4,0,3,22,16149960,3676,0,0,4396
650,8,0,5,20,16163820,3674,0,0,4404
651,5,0,6,19,16175040,3673,0,0,4409
652,9,0,9,16,16198440,3673,0,0,4418
653,5,0,4,21,16226580,3672,0,0,4423
654,8,0,7,18,16232520,3669,0,0,4431
655,3,0,2,23,16271160,3671,0,0,4434
656,7,0,5,20,16282440,3670,0,0,4441
657,6,0,6,19,16299300,3670,0,0,4447
658,4,0,4,21,16313460,3668,0,0,4451
659,11,0,10,15,16334820,3669,0,0,4462
660,8,0,8,17,16357500,3665,0,0,4470
661,8,0,9,16,16380840,3665,0,0,4478
662,8,0,8,17,16426740,3668,0,0,4486
663,6,0,8,17,16444140,3667,0,0,4492
664,9,0,10,15,16479360,3669,0,0,4501
665,11,0,11,14,16504020,3666,0,0,4512
666,12,0,13,12,16539660,3666,0,0,4524
667,5,0,8,17,16572300,3665,0,0,4529
668,4,0,7,18,16606260,3669,0,0,4533
669,4,0,4,21,16636800,3670,0,0,4537
670,5,0,5,20,16654260,3670,0,0,4542
671,7,0,8,17,16665300,3669,0,0,4549
672,4,0,7,18,16682040,3669,0,0,4553
673,7,0,9,16,16690740,3667,0,0,4560
674,8,0,15,10,16694520,3666,0,0,4568
675,7,0,14,11,16721400,3666,0,0,4575
676,6,0,10,15,16756320,3665,0,0,4581
677,4,0,12,13,16764600,3665,0,0,4585
678,9,0,14,11,16796100,3667,0,0,4594
679,7,0,14,11,16813260,3665,0,0,4601
680,6,0,13,12,16832820,3664,0,0,4607
681,6,0,11,14,16865280,3664,0,0,4613
682,5,0,9,16,16884600,3663,0,0,4618
683,4,0,8,17,16898100,3662,0,0,4622
684,7,0,12,13,16905960,3661,0,0,4629
685,7,0,11,14,16927680,3660,0,0,4636
686,9,0,12,13,16944360,3657,0,0,4645
687,9,0,13,12,16964580,3655,0,0,4654
688,6,0,12,13,16983060,3653,0,0,4660
689,9,0,14,11,17001600,3652,0,0,4669
690,9,0,15,10,17028240,3651,0,0,4678
691,7,0,14,11,17057400,3651,0,0,4685
692,2,0,12,13,17071380,3651,0,0,4687
693,8,0,10,15,17107140,3651,0,0,4695
694,4,0,8,17,17126400,3650,0,0,4699
695,5,0,11,14,17132880,3650,0,0,4704
696,4,0,8,17,17157060,3650,0,0,4708
697,1,0,7,18,17160900,3649,0,0,4709
698,5,0,9,16,17170140,3649,0,0,4714
699,2,0,9,16,17178960,3649,0,0,4716
700,9,0,11,14,17192400,3647,0,0,4725
701,4,0,9,16,17218620,3648,0,0,4729
702,11,0,12,13,17233440,3644,0,0,4740
703,3,0,10,15,17255880,3645,0,0,4743
704,13,0,16,9,17267580,3642,0,0,4756
705,7,0,15,10,17285520,3640,0,0,4763
706,9,0,17,8,17305380,3639,0,0,4772
707,12,0,17,8,17362260,3642,0,0,4784
708,8,0,13,12,17400360,3641,0,0,4792
709,12,0,18,7,17430960,3642,0,0,4804
710,10,0,17,8,17461440,3640,0,0,4814
711,1,0,10,15,17495700,3641,0,0,4815
712,4,0,7,18,17527440,3642,0,0,4819
713,8,0,9,16,17538540,3640,0,0,4827
714,10,0,14,11,17541960,3637,0,0,4837
715,12,0,15,10,17574960,3635,0,0,4849
716,7,0,13,12,17611500,3636,0,0,4856
717,4,0,11,14,17635860,3637,0,0,4860
718,4,0,11,14,17654880,3637,0,0,4864
719,10,0,13,12,17673960,3635,0,0,4874
720,3,0,11,14,17691900,3635,0,0,4877
721,5,0,12,13,17710980,3636,0,0,4882
722,5,0,13,12,17726640,3636,0,0,4887
723,4,0,10,15,17751000,3636,0,0,4891
724,4,0,11,14,17767140,3637,0,0,4895
725,4,0,9,16,17789160,3637,0,0,4899
726,6,0,11,14,17799000,3636,0,0,4905
727,6,0,12,13,17807820,3634,0,0,4911
728,9,0,14,11,17831580,3634,0,0,4920
729,8,0,14,11,17854620,3633,0,0,4928
730,10,0,14,11,17900100,3635,0,0,4938
731,7,0,14,11,17930580,3636,0,0,4945
732,10,0,14,11,17956380,3634,0,0,4955
733,11,0,18,7,17975220,3632,0,0,4966
734,8,0,14,11,18027120,3634,0,0,4974
735,15,0,17,8,18061080,3632,0,0,4989
736,6,0,16,9,18089580,3633,0,0,4995
737,9,0,15,10,18127920,3633,0,0,5004
738,9,0,14,11,18165960,3633,0,0,5013
739,7,0,16,9,18179700,3633,0,0,5020
740,5,0,15,10,18207480,3634,0,0,5025
741,6,0,14,11,18238740,3635,0,0,5031
742,6,0,10,15,18273360,3635,0,0,5037
743,4,0,10,15,18286260,3634,0,0,5041
744,9,0,13,12,18292560,3631,0,0,5050
745,5,0,13,12,18305340,3630,0,0,5055
746,6,0,10,15,18342000,3631,0,0,5061
747,7,0,12,13,18356880,3630,0,0,5068
748,2,0,10,15,18368760,3630,0,0,5070
749,7,0,12,13,18389280,3630,0,0,5077
750,4,0,13,12,18398280,3630,0,0,5081
751,7,0,14,11,18418860,3630,0,0,5088
752,6,0,12,13,18456120,3631,0,0,5094
753,5,0,11,14,18481920,3632,0,0,5099
754,8,0,14,11,18497760,3631,0,0,5107
755,8,0,16,9,18516420,3631,0,0,5115
756,9,0,13,12,18563760,3632,0,0,5124
757,6,0,14,11,18579300,3631,0,0,5130
758,6,0,13,12,18611040,3632,0,0,5136
759,17,0,20,5,18639120,3631,0,0,5153
760,4,0,12,13,18682800,3631,0,0,5157
761,10,0,16,9,18705000,3631,0,0,5167
762,10,0,15,10,18736320,3629,0,0,5177
763,8,0,16,9,18768780,3631,0,0,5185
764,9,0,18,7,18796080,3631,0,0,5194
765,5,0,14,11,18844440,3634,0,0,5199
766,8,0,13,12,18885900,3636,0,0,5207
767,4,0,12,13,18898620,3635,0,0,5211
768,4,0,12,13,18930720,3638,0,0,5215
769,5,0,15,10,18935580,3637,0,0,5220
770,8,0,14,11,18977460,3639,0,0,5228
771,2,0,12,13,19006800,3642,0,0,5230
772,6,0,11,14,19028040,3641,0,0,5236
773,8,0,10,15,19055760,3640,0,0,5244
774,5,0,11,14,19074720,3641,0,0,5249
775,8,0,11,14,19094400,3639,0,0,5257
776,8,2,15,10,19101180,3639,0,0,5265
777,7,6,14,11,19126620,3641,3660,0,5272
778,8,0,14,11,19176720,3641,23340,4,5280
779,7,0,17,8,19196160,3642,23340,4,5287
780,11,0,21,4,19232760,3644,23340,4,5298
781,7,0,17,8,19275900,3645,23340,4,5305
782,6,0,12,13,19313340,3644,23340,4,5311
783,9,0,16,9,19330800,3644,23340,4,5320
784,11,0,20,5,19371240,3647,23340,4,5331
785,5,0,17,8,19396920,3646,23340,4,5336
786,6,0,11,14,19449540,3648,23340,4,5342
787,3,0,10,15,19466100,3648,23340,4,5345
788,2,0,8,17,19481640,3648,23340,4,5347
789,7,0,11,14,19492980,3648,23340,4,5354
790,6,0,11,14,19514640,3648,23340,4,5360
791,3,0,10,15,19522620,3647,23340,4,5363
792,6,0,12,13,19537860,3647,23340,4,5369
793,5,0,9,16,19560360,3645,23340,4,5374
794,4,0,12,13,19562820,3645,23340,4,5378
795,2,0,10,15,19581300,3646,23340,4,5380
796,4,0,9,16,19607880,3647,23340,4,5384
797,2,0,9,16,19615860,3648,23340,4,5386
798,6,0,13,12,19624440,3648,23340,4,5392
799,6,0,13,12,19646640,3648,23340,4,5398
800,8,0,14,11,19664160,3646,23340,4,5406
801,12,0,13,12,19701780,3645,23340,4,5418
802,11,0,16,9,19721460,3643,23340,4,5429
803,6,0,15,10,19741380,3642,23340,4,5435
804,10,0,15,10,19775580,3641,23340,4,5445
805,3,0,9,16,19809360,3642,23340,4,5448
806,9,0,13,12,19831080,3642,23340,4,5457
807,7,0,13,12,19844760,3640,23340,4,5464
808,14,0,22,3,19856160,3639,23340,4,5478
809,6,0,12,13,19915860,3639,23340,4,5484
810,7,0,14,11,19933500,3639,23340,4,5491
811,6,0,15,10,19960080,3641,23340,4,5497
812,5,0,12,13,19997760,3642,23340,4,5502
813,6,0,12,13,20017200,3642,23340,4,5508
814,4,0,12,13,20034300,3642,23340,4,5512
815,2,0,8,17,20055540,3642,23340,4,5514
816,2,0,9,16,20059920,3642,23340,4,5516
817,1,0,7,18,20071380,3642,23340,4,5517
818,5,0,9,16,20073660,3641,23340,4,5522
819,4,0,9,16,20078820,3639,23340,4,5526
820,6,0,12,13,20089020,3639,23340,4,5532
821,6,0,11,14,20108700,3638,23340,4,5538
822,4,0,10,15,20125980,3638,23340,4,5542
823,6,0,12,13,20154000,3640,23340,4,5548
824,7,0,11,14,20167800,3637,23340,4,5555
825,10,0,17,8,20180760,3637,23340,4,5565
826,10,0,16,9,20216040,3636,23340,4,5575
827,9,0,17,8,20245560,3636,23340,4,5584
828,6,0,11,14,20295840,3637,23340,4,5590
829,9,0,15,10,20310240,3637,23340,4,5599
830,3,0,10,15,20338440,3637,23340,4,5602
831,10,0,14,11,20351820,3635,23340,4,5612
832,9,0,16,9,20369280,3634,23340,4,5621
833,5,0,11,14,20425500,3637,23340,4,5626
834,7,0,11,14,20452320,3637,23340,4,5633
835,8,0,16,9,20468040,3638,23340,4,5641
836,5,0,11,14,20503200,3638,23340,4,5646
837,10,0,15,10,20517900,3637,23340,4,5656
838,6,0,13,12,20548080,3637,23340,4,5662
839,7,0,12,13,20574960,3637,23340,4,5669
840,8,0,13,12,20590980,3635,23340,4,5677
841,3,0,8,17,20633760,3637,23340,4,5680
842,4,0,11,14,20640600,3638,23340,4,5684
843,3,0,10,15,20656860,3638,23340,4,5687
844,5,0,11,14,20667660,3638,23340,4,5692
845,6,0,11,14,20690700,3638,23340,4,5698
846,6,0,12,13,20708820,3638,23340,4,5704
847,7,0,17,8,20711460,3637,23340,4,5711
848,7,0,12,13,20761740,3638,23340,4,5718
849,8,0,11,14,20789940,3637,23340,4,5726
850,5,0,13,12,20800860,3637,23340,4,5731
851,6,0,14,11,20835780,3640,23340,4,5737
852,10,0,14,11,20862600,3639,23340,4,5747
853,7,0,12,13,20896740,3639,23340,4,5754
854,8,0,14,11,20919600,3639,23340,4,5762
855,8,0,15,10,20947860,3639,23340,4,5770
856,9,0,18,7,20963460,3638,23340,4,5779
857,6,0,12,13,21015300,3640,23340,4,5785
858,11,0,18,7,21032640,3640,23340,4,5796
859,8,0,13,12,21097560,3643,23340,4,5804
860,6,0,11,14,21134820,3644,23340,4,5810
861,3,0,12,13,21140640,3644,23340,4,5813
862,6,0,10,15,21170940,3644,23340,4,5819
863,6,0,9,16,21183780,3642,23340,4,5825
864,5,0,10,15,21192540,3641,23340,4,5830
865,9,0,14,11,21201960,3639,23340,3,5839
866,5,0,12,13,21238740,3641,23340,3,5844
867,5,0,13,12,21250800,3641,23340,3,5849
868,5,0,11,14,21278160,3641,23340,3,5854
869,1,0,7,18,21310020,3643,23340,3,5855
870,6,0,10,15,21312780,3642,23340,3,5861
871,4,0,12,13,21321420,3642,23340,3,5865
872,4,0,12,13,21344640,3644,23340,3,5869
873,12,0,16,9,21369300,3643,23340,3,5881
874,13,0,19,6,21395580,3641,23340,3,5894
875,6,0,14,11,21439740,3642,23340,3,5900
876,8,0,13,12,21470520,3642,23340,3,5908
877,6,0,10,15,21496320,3640,23340,3,5914
878,9,0,15,10,21501360,3639,23340,3,5923
879,4,0,11,14,21544020,3641,23340,3,5927
880,5,0,12,13,21552600,3640,23340,3,5932
881,6,0,13,12,21573900,3641,23340,3,5938
882,6,0,15,10,21590580,3641,23340,3,5944
883,7,0,14,11,21628500,3643,23340,3,5951
884,9,0,14,11,21656280,3642,23340,3,5960
885,9,0,15,10,21691200,3643,23340,3,5969
886,5,0,13,12,21721080,3643,23340,3,5974
887,4,0,14,11,21741360,3645,23340,3,5978
888,5,0,10,15,21793740,3648,23340,3,5983
889,5,0,10,15,21808380,3648,23340,3,5988
890,3,0,11,14,21813240,3647,23340,3,5991
891,3,0,8,17,21842820,3648,23340,3,5994
892,1,0,8,17,21845400,3648,23340,3,5995
893,5,0,8,17,21853380,3647,23340,3,6000
894,1,0,8,17,21854760,3646,23340,3,6001
895,10,0,15,10,21865200,3646,23340,3,6011
896,8,0,13,12,21889320,3644,23340,3,6019
897,5,0,10,15,21913860,3643,23340,3,6024
898,3,0,10,15,21941880,3646,23340,3,6027
899,6,0,13,12,21948120,3645,23340,3,6033
900,12,0,18,7,21964980,3644,23340,3,6045
901,5,0,13,12,22020480,3647,23340,3,6050
902,5,0,11,14,22049400,3648,23340,3,6055
903,5,0,12,13,22065780,3648,23340,3,6060
904,11,0,19,6,22085520,3649,23340,3,6071
905,5,0,13,12,22122720,3648,23340,3,6076
906,8,0,17,8,22136640,3648,23340,3,6084
907,3,0,12,13,22184580,3651,23340,3,6087
908,5,0,13,12,22204260,3652,23340,3,6092
909,10,0,13,12,22242660,3652,23340,3,6102
910,5,0,12,13,22264920,3652,23340,3,6107
911,5,0,10,15,22287720,3652,23340,3,6112
912,6,0,9,16,22309980,3651,23340,3,6118
913,5,0,10,15,22319220,3651,23340,3,6123
914,5,0,13,12,22328160,3651,23340,3,6128
915,4,0,12,13,22353840,3652,23340,3,6132
916,3,0,9,16,22377420,3652,23340,3,6135
917,9,0,11,14,22395060,3651,23340,3,6144
918,5,0,12,13,22407840,3651,23340,3,6149
919,10,0,17,8,22433040,3652,23340,3,6159
920,5,0,14,11,22456980,3651,23340,3,6164
921,5,0,12,13,22485540,3652,23340,3,6169
922,8,0,12,13,22510680,3651,23340,3,6177
923,8,0,14,11,22530120,3650,23340,3,6185
924,10,0,15,10,22555500,3649,23340,3,6195
925,14,0,22,3,22581000,3649,23340,3,6209
926,11,0,22,3,22623120,3650,23340,3,6220
927,10,0,15,10,22678440,3648,23340,3,6230
928,12,0,15,10,22717980,3648,23340,3,6242
929,7,0,18,7,22735620,3648,23340,3,6249
930,9,0,17,8,22782600,3650,23340,3,6258
931,5,0,13,12,22823580,3651,23340,3,6263
932,2,0,11,14,22844340,3652,23340,3,6265
933,4,0,9,16,22876500,3654,23340,3,6269
934,5,0,12,13,22886400,3654,23340,3,6274
935,1,0,9,16,22903320,3655,23340,3,6275
936,4,0,11,14,22918740,3656,23340,3,6279
937,4,0,8,17,22944060,3656,23340,3,6283
938,2,0,8,17,22953480,3656,23340,3,6285
939,5,0,11,14,22957500,3656,23340,3,6290
940,5,0,9,16,22981800,3656,23340,3,6295
941,7,0,10,15,22998480,3655,23340,3,6302
942,5,0,11,14,23016240,3655,23340,3,6307
943,10,0,14,11,23035380,3654,23340,3,6317
944,4,0,14,11,23049420,3654,23340,3,6321
945,14,0,14,11,23094060,3653,23340,3,6335
946,10,0,13,12,23119440,3651,23340,3,6345
947,10,0,15,10,23149440,3651,23340,3,6355
948,4,0,12,13,23173800,3651,23340,3,6359
949,11,0,16,9,23199060,3651,23340,3,6370
950,9,1,20,5,23205900,3649,23340,3,6379
951,11,0,17,8,23276940,3652,23580,3,6390
952,12,0,17,8,23316000,3651,23580,3,6402
953,9,0,15,10,23350980,3650,23580,3,6411
954,9,0,13,12,23391540,3650,23580,3,6420
955,10,0,15,10,23417520,3650,23580,3,6430
956,7,0,13,12,23443320,3649,23580,3,6437
957,8,0,13,12,23477220,3650,23580,3,6445
958,5,0,13,12,23496600,3650,23580,3,6450
959,4,0,8,17,23536380,3651,23580,3,6454
960,1,0,7,18,23542920,3651,23580,3,6455
961,4,0,9,16,23549460,3651,23580,3,6459
962,5,0,12,13,23551440,3650,23580,3,6464
963,3,0,9,16,23571840,3650,23580,3,6467
964,4,0,10,15,23582340,3649,23580,3,6471
965,8,0,11,14,23601120,3648,23580,3,6479
966,10,0,17,8,23619480,3649,23580,3,6489
967,6,0,10,15,23672640,3650,23580,3,6495
968,2,0,7,18,23688420,3649,23580,3,6497
969,6,0,11,14,23693580,3649,23580,3,6503
970,4,0,11,14,23705460,3649,23580,3,6507
971,9,0,15,10,23725080,3649,23580,3,6516
972,7,0,12,13,23753940,3648,23580,3,6523
973,10,0,13,12,23785080,3648,23580,3,6533
974,15,0,22,3,23798520,3646,23580,3,6548
975,10,0,16,9,23860080,3647,23580,3,6558
976,6,0,12,13,23897880,3647,23580,3,6564
977,9,0,13,12,23927640,3647,23580,3,6573
978,8,0,15,10,23936400,3645,23580,3,6581
979,4,0,11,14,23968980,3646,23580,3,6585
980,5,0,12,13,23987760,3646,23580,3,6590
981,9,0,10,15,24018720,3645,23580,3,6599
982,4,0,11,14,24026040,3644,23580,3,6603
983,1,0,8,17,24043320,3645,23580,3,6604
984,3,0,10,15,24057000,3646,23580,3,6607
985,3,0,11,14,24067980,3647,23580,3,6610
986,2,0,9,16,24083040,3647,23580,3,6612
987,8,0,13,12,24100320,3647,23580,3,6620
988,5,0,12,13,24121860,3647,23580,3,6625
989,6,0,9,16,24147180,3646,23580,3,6631
990,6,0,12,13,24159480,3646,23580,3,6637
991,4,0,9,16,24176280,3645,23580,3,6641
992,5,0,11,14,24181140,3644,23580,3,6646
993,11,0,14,11,24205620,3643,23580,3,6657
994,9,0,14,11,24236100,3643,23580,3,6666
995,11,0,16,9,24271860,3643,23580,3,6677
996,8,0,21,4,24278700,3643,23580,3,6685
997,11,0,20,5,24337080,3645,23580,3,6696
998,8,0,16,9,24389460,3646,23580,3,6704
999,8,0,14,11,24436320,3648,23580,3,6712
1000,5,0,13,12,24463740,3649,23580,3,6717
1001,6,0,12,13,24499920,3650,23580,3,6723
1002,15,0,21,4,24515160,3649,23580,3,6738
1003,7,0,15,10,24565740,3650,23760,3,6745
1004,7,0,14,11,24602220,3651,23760,3,6752
1005,5,0,13,12,24633660,3652,23760,3,6757
1006,5,0,10,15,24658740,3652,23760,3,6762
1007,8,0,15,10,24668460,3651,23760,3,6770
1008,4,0,11,14,24700980,3652,23760,3,6774
1009,2,0,10,15,24718860,3653,23760,3,6776
1010,6,0,12,13,24740040,3654,23760,3,6782
1011,2,0,10,15,24753720,3654,23760,3,6784
1012,7,0,12,13,24771180,3654,23760,3,6791
1013,5,0,15,10,24779640,3654,23760,3,6796
1014,7,0,18,7,24804900,3655,23760,3,6803
1015,3,0,8,17,24864060,3657,23760,3,6806
1016,5,0,9,16,24874860,3656,23760,3,6811
1017,7,0,10,15,24888000,3655,23760,3,6818
1018,12,0,14,11,24903840,3653,23760,3,6830
1019,5,0,11,14,24928380,3653,23760,3,6835
1020,7,0,12,13,24951420,3653,23760,3,6842
1021,7,0,11,14,24968640,3651,23760,3,6849
1022,2,0,9,16,24989220,3652,23760,3,6851
1023,13,0,18,7,25002780,3652,23760,3,6864
1024,10,0,17,8,25037760,3651,23760,3,6874
1025,9,0,18,7,25080660,3653,23760,3,6883
1026,2,0,9,16,25124100,3653,23760,3,6885
1027,8,0,9,16,25140000,3651,23760,3,6893
1028,4,0,10,15,25152480,3652,23760,3,6897
1029,4,0,13,12,25154700,3651,23760,3,6901
1030,6,0,11,14,25184100,3651,23760,3,6907
1031,5,0,13,12,25199760,3652,23760,3,6912
1032,5,0,14,11,25218120,3653,23760,3,6917
1033,3,0,12,13,25238940,3653,23760,3,6920
1034,2,0,9,16,25271700,3655,23760,3,6922
1035,6,0,12,13,25279920,3655,23760,3,6928
1036,3,0,8,17,25304280,3655,23760,3,6931
1037,8,0,11,14,25311480,3653,23760,3,6939
1038,8,0,12,13,25326120,3651,23760,3,6947
1039,6,0,15,10,25339860,3652,23760,3,6953
1040,4,0,12,13,25371660,3653,23760,3,6957
1041,6,0,12,13,25406220,3655,23760,3,6963
1042,8,0,14,11,25415100,3653,23760,3,6971
1043,12,0,19,6,25442580,3653,23760,3,6983
1044,14,0,20,5,25475280,3651,23760,3,6997
1045,11,0,19,6,25521240,3651,24000,3,7008
1046,11,0,20,5,25552740,3650,24000,3,7019
1047,7,0,12,13,25635420,3654,24000,3,7026
1048,8,0,14,11,25644660,3653,24000,3,7034
1049,7,0,12,13,25683240,3653,24000,3,7041
1050,8,0,14,11,25701240,3653,24000,3,7049
1051,5,0,11,14,25727220,3652,24000,3,7054
1052,9,0,15,10,25751220,3653,24000,3,7063
1053,9,0,17,8,25779360,3654,24000,3,7072
1054,2,0,9,16,25824960,3655,24000,3,7074
1055,4,0,9,16,25842000,3655,24000,3,7078
1056,3,0,10,15,25846740,3655,24000,3,7081
1057,7,0,13,12,25863360,3655,24000,3,7088
1058,4,0,13,12,25874340,3655,24000,3,7092
1059,4,0,10,15,25899660,3655,24000,3,7096
1060,6,0,11,14,25913400,3654,24000,3,7102
1061,4,0,11,14,25925280,3654,24000,3,7106
1062,7,0,13,12,25940280,3653,24000,3,7113
1063,9,0,16,9,25959720,3653,24000,3,7122
1064,7,0,17,8,25967940,3651,24000,3,7129
1065,5,0,12,13,26023860,3654,24000,3,7134
1066,11,0,14,11,26042220,3651,24000,3,7145
1067,10,0,16,9,26069460,3651,24000,3,7155
1068,11,0,15,10,26118060,3652,24000,3,7166
1069,12,0,18,7,26143680,3651,24000,3,7178
1070,8,0,16,9,26173260,3650,24000,3,7186
1071,11,0,14,11,26222040,3650,24000,3,7197
1072,7,0,12,13,26252760,3650,24000,3,7204
1073,1,0,10,15,26265420,3650,24000,3,7205
1074,8,0,12,13,26289180,3650,24000,3,7213
1075,6,0,14,11,26297400,3649,24000,3,7219
1076,5,0,11,14,26335800,3651,24000,3,7224
1077,3,0,11,14,26352540,3651,24000,3,7227
1078,6,0,12,13,26372040,3652,24000,3,7233
1079,6,0,8,17,26395200,3650,24000,3,7239
1080,2,0,9,16,26402880,3650,24000,3,7241
1081,1,0,6,19,26415480,3650,24000,3,7242
1082,3,0,9,16,26415480,3650,24000,3,7245
1083,1,0,7,18,26421840,3649,24000,3,7246
1084,4,0,9,16,26425740,3649,24000,3,7250
1085,5,0,9,16,26438700,3648,24000,3,7255
1086,5,0,11,14,26447340,3648,24000,3,7260
1087,7,0,14,11,26456940,3647,24000,3,7267
1088,8,0,13,12,26491680,3647,24000,3,7275
1089,6,0,13,12,26510520,3647,24000,3,7281
1090,7,0,14,11,26531880,3647,24000,3,7288
1091,8,0,15,10,26568420,3649,24000,3,7296
1092,10,0,15,10,26597220,3647,24000,3,7306
1093,12,0,18,7,26644500,3649,24000,3,7318
1094,10,0,17,8,26679480,3649,24000,3,7328
1095,10,0,17,8,26719800,3649,24000,3,7338
1096,8,0,18,7,26760240,3651,24000,3,7346
1097,9,0,16,9,26806440,3652,24000,3,7355
1098,9,0,14,11,26842440,3652,24000,3,7364
1099,11,0,17,8,26869020,3651,24000,3,7375
1100,6,0,12,13,26909040,3651,24000,3,7381
1101,5,0,12,13,26936040,3652,24000,3,7386
1102,3,0,11,14,26948340,3652,24000,3,7389
1103,9,0,16,9,26965560,3652,24000,3,7398
1104,4,0,13,12,27004560,3654,24000,3,7402
1105,3,0,10,15,27028800,3655,24000,3,7405
1106,6,0,11,14,27053400,3655,24000,3,7411
1107,3,0,10,15,27066720,3655,24000,3,7414
1108,7,0,10,15,27089940,3655,24000,3,7421
1109,2,0,9,16,27101520,3655,24000,3,7423
1110,6,0,11,14,27116520,3655,24000,3,7429
1111,9,0,13,12,27133800,3654,24000,3,7438
1112,6,0,11,14,27161400,3654,24000,3,7444
1113,5,0,12,13,27173280,3653,24000,3,7449
1114,6,0,12,13,27205260,3655,24000,3,7455
1115,10,0,12,13,27221940,3652,24000,3,7465
1116,11,0,17,8,27231720,3650,24000,3,7476
1117,11,0,17,8,27267300,3650,24000,3,7487
1118,6,0,11,14,27314760,3650,24000,3,7493
1119,9,0,11,14,27337680,3649,24000,3,7502
1120,13,0,13,12,27358200,3646,24000,3,7515
1121,6,0,9,16,27383700,3645,24000,3,7521
1122,9,0,15,10,27391620,3644,24000,3,7530
1123,8,0,16,9,27415020,3644,24000,3,7538
1124,8,0,16,9,27447780,3645,24000,3,7546
1125,8,0,12,13,27496860,3645,24000,3,7554
1126,5,0,10,15,27521520,3645,24000,3,7559
1127,4,0,10,15,27543420,3646,24000,3,7563
1128,3,0,10,15,27548100,3645,24000,3,7566
1129,3,0,9,16,27560640,3645,24000,3,7569
1130,7,0,10,15,27577740,3644,24000,3,7576
1131,10,0,17,8,27582720,3644,24000,3,7586
1132,1,0,11,14,27607200,3644,24000,3,7587
1133,3,0,9,16,27642180,3646,24000,3,7590
1134,6,0,11,14,27652080,3645,24000,3,7596
1135,1,0,8,17,27667140,3645,24000,3,7597
1136,10,0,14,11,27683640,3645,24000,3,7607
1137,9,0,12,13,27708780,3643,24000,3,7616
1138,6,0,13,12,27721260,3643,24000,3,7622
1139,16,0,18,7,27755460,3642,24000,3,7638
1140,6,0,14,11,27785160,3641,24000,3,7644
1141,13,0,18,7,27817980,3641,24000,3,7657
1142,7,0,13,12,27850380,3640,24000,3,7664
1143,10,0,15,10,27873360,3639,24000,3,7674
1144,11,0,12,13,27920340,3638,24000,3,7685
1145,10,0,16,9,27945840,3639,24000,3,7695
1146,3,0,10,15,27978180,3639,24000,3,7698
1147,2,0,9,16,27994560,3639,24000,3,7700
1148,4,0,10,15,28013040,3640,24000,3,7704
1149,7,0,11,14,28029960,3640,24000,3,7711
1150,3,0,9,16,28046460,3640,24000,3,7714
1151,7,0,14,11,28053660,3640,24000,3,7721
1152,3,0,15,10,28064160,3640,24000,3,7724
1153,4,0,12,13,28098000,3641,24000,3,7728
1154,3,0,11,14,28126260,3643,24000,3,7731
1155,5,0,11,14,28154460,3644,24000,3,7736
1156,2,0,11,14,28162080,3644,24000,3,7738
1157,8,0,12,13,28194960,3645,24000,3,7746
1158,6,0,9,16,28215180,3643,24000,3,7752
1159,5,0,11,14,28217700,3642,24000,3,7757
1160,4,0,10,15,28235040,3642,24000,3,7761
1161,13,0,19,6,28245720,3642,24000,3,7774
1162,9,0,18,7,28282140,3642,24000,3,7783
1163,9,0,13,12,28323720,3641,24000,3,7792
1164,5,0,12,13,28351740,3641,24000,3,7797
1165,10,0,16,9,28376760,3642,24000,3,7807
1166,10,0,15,10,28415520,3642,24000,3,7817
1167,5,0,12,13,28435200,3640,24000,3,7822
1168,11,0,16,9,28460940,3640,24000,3,7833
1169,4,0,11,14,28484160,3639,24000,3,7837
1170,11,0,15,10,28513980,3640,24000,3,7848
1171,8,0,11,14,28547940,3638,24000,3,7856
1172,5,0,10,15,28563540,3638,24000,3,7861
1173,6,0,12,13,28581240,3638,24000,3,7867
1174,4,0,11,14,28601880,3638,24000,3,7871
1175,6,0,10,15,28618020,3637,24000,3,7877
1176,4,0,10,15,28628700,3637,24000,3,7881
1177,5,0,8,17,28647660,3636,24000,3,7886
1178,1,0,7,18,28650720,3635,24000,3,7887
1179,3,0,10,15,28650720,3635,24000,3,7890
1180,5,0,10,15,28664520,3635,24000,3,7895
1181,5,0,10,15,28673760,3634,24000,3,7900
1182,7,0,13,12,28680720,3633,24000,3,7907
1183,6,0,11,14,28716240,3634,24000,3,7913
1184,7,0,13,12,28731300,3633,24000,3,7920
1185,9,0,16,9,28752600,3633,24000,3,7929
1186,9,0,14,11,28787520,3632,24000,3,7938
1187,8,0,13,12,28818840,3632,24000,3,7946
1188,15,0,17,8,28838400,3630,24000,3,7961
1189,8,0,14,11,28873440,3629,24000,3,7969
1190,10,0,13,12,28906380,3628,24000,3,7979
1191,7,0,14,11,28929480,3628,24000,3,7986
1192,11,0,13,12,28962000,3627,24000,3,7997
1193,4,0,11,14,28990980,3628,24000,2,8001
1194,5,0,10,15,29009160,3627,24000,2,8006
1195,5,0,10,15,29022120,3627,24000,2,8011
1196,5,0,13,12,29026380,3626,24000,2,8016
1197,2,0,10,15,29042280,3626,24000,2,8018
1198,4,0,8,17,29071200,3627,24000,2,8022
1199,7,0,12,13,29075580,3626,24000,2,8029
1200,6,0,10,15,29094000,3625,24000,2,8035
1201,6,0,13,12,29111160,3626,24000,2,8041
1202,7,0,9,16,29136960,3624,24000,2,8048
1203,5,0,10,15,29147160,3623,24000,2,8053
1204,5,0,9,16,29156880,3622,24000,2,8058
1205,4,0,9,16,29163420,3621,24000,2,8062
1206,3,0,10,15,29172900,3621,24000,2,8065
1207,10,0,15,10,29186100,3621,24000,2,8075
1208,8,0,16,9,29210820,3621,24000,2,8083
1209,11,0,16,9,29254980,3621,24000,2,8094
1210,11,0,20,5,29281140,3621,24000,2,8105
1211,7,0,15,10,29331480,3622,24000,2,8112
1212,8,0,14,11,29379780,3624,24000,2,8120
1213,11,0,17,8,29402460,3623,24000,2,8131
1214,10,0,19,6,29428020,3623,24000,2,8141
1215,7,0,19,6,29478660,3626,24000,2,8148
1216,12,0,14,11,29542500,3626,24000,2,8160
1217,18,0,17,8,29578860,3624,24000,2,8178
1218,9,0,12,13,29607840,3621,24000,2,8187
1219,4,0,13,12,29618340,3621,24000,2,8191
1220,8,0,12,13,29655780,3622,24000,2,8199
1221,7,0,15,10,29676420,3623,24000,2,8206
1222,3,0,10,15,29711280,3623,24000,2,8209
1223,4,0,13,12,29712240,3623,24000,2,8213
1224,3,0,10,15,29742720,3624,24000,2,8216
1225,6,0,10,15,29762520,3624,24000,2,8222
1226,3,0,10,15,29770560,3623,24000,2,8225
1227,7,0,12,13,29790900,3624,24000,2,8232
1228,6,0,13,12,29798940,3622,24000,2,8238
1229,4,0,8,17,29830260,3622,24000,2,8242
1230,2,0,7,18,29841960,3622,24000,2,8244
1231,5,0,9,16,29848680,3622,24000,2,8249
1232,8,0,10,15,29865600,3621,24000,2,8257
1233,5,0,11,14,29874360,3620,24000,2,8262
1234,13,0,18,7,29885280,3619,24000,2,8275
1235,2,0,13,12,29913780,3619,24000,2,8277
1236,8,0,12,13,29952720,3620,24000,2,8285
1237,11,0,18,7,29980740,3621,24000,2,8296
1238,6,0,14,11,30006060,3620,24000,2,8302
1239,8,0,14,11,30050640,3622,24000,2,8310
1240,7,0,13,12,30070800,3621,24000,2,8317
1241,5,0,11,14,30093660,3620,24000,2,8322
1242,6,0,12,13,30111660,3620,24000,2,8328
1243,8,0,14,11,30125940,3620,24000,2,8336
1244,6,0,14,11,30146640,3619,24000,2,8342
1245,8,0,14,11,30174840,3619,24000,2,8350
1246,3,0,8,17,30201240,3619,24000,2,8353
1247,4,0,10,15,30204060,3618,24000,2,8357
1248,8,0,13,12,30217380,3617,24000,2,8365
1249,4,0,11,14,30244980,3618,24000,2,8369
1250,2,0,11,14,30253860,3618,24000,2,8371
1251,6,0,12,13,30271500,3618,24000,2,8377
1252,4,0,13,12,30294180,3620,24000,2,8381
1253,6,0,16,9,30315480,3621,24000,2,8387
1254,9,0,17,8,30346620,3621,24000,2,8396
1255,9,0,15,10,30391680,3622,24000,2,8405
1256,9,0,17,8,30415260,3622,24000,2,8414
1257,9,0,11,14,30461220,3621,24000,2,8423
1258,10,0,15,10,30475080,3620,24000,2,8433
1259,12,0,19,6,30501360,3619,24000,2,8445
1260,9,0,14,11,30550200,3619,24000,2,8454
1261,7,0,17,8,30564480,3619,24000,2,8461
1262,9,0,15,10,30615240,3620,24000,2,8470
1263,4,0,13,12,30646260,3622,24000,2,8474
1264,10,0,15,10,30687600,3623,24000,2,8484
1265,5,0,10,15,30724860,3623,24000,2,8489
1266,7,0,12,13,30737040,3622,24000,2,8496
1267,6,0,13,12,30753660,3622,24000,2,8502
1268,1,0,8,17,30770280,3622,24000,2,8503
1269,6,0,8,17,30792120,3622,24000,2,8509
1270,7,0,11,14,30799440,3621,24000,2,8516
1271,3,0,11,14,30808320,3621,24000,2,8519
1272,4,0,10,15,30828120,3621,24000,2,8523
1273,2,0,7,18,30853920,3622,24000,2,8525
1274,5,0,12,13,30853920,3622,24000,2,8530
1275,4,0,9,16,30874200,3621,24000,2,8534
1276,2,0,9,16,30885480,3622,24000,2,8536
1277,6,0,10,15,30897300,3621,24000,2,8542
1278,10,0,16,9,30907080,3620,24000,2,8552
1279,6,0,12,13,30940740,3620,24000,2,8558
1280,7,0,14,11,30959880,3620,24000,2,8565
1281,10,0,14,11,30993300,3620,24000,2,8575
1282,2,0,10,15,31015260,3620,24000,2,8577
1283,6,0,10,15,31034460,3620,24000,2,8583
1284,11,0,14,11,31063080,3620,24000,2,8594
1285,19,0,21,4,31086720,3618,24000,2,8613
1286,8,0,17,8,31127040,3617,24000,2,8621
1287,4,0,16,9,31157640,3619,24000,2,8625
1288,8,0,11,14,31224120,3621,24000,2,8633
1289,4,0,10,15,31247040,3622,24000,2,8637
1290,9,0,13,12,31271760,3622,24000,2,8646
1291,7,0,16,9,31279200,3621,24000,2,8653
1292,8,0,17,8,31313220,3622,24000,2,8661
1293,7,0,14,11,31356000,3623,24000,2,8668
1294,4,0,10,15,31405380,3625,24000,2,8672
1295,7,0,12,13,31422420,3625,24000,2,8679
1296,5,0,9,16,31452840,3625,24000,2,8684
1297,5,0,11,14,31463460,3625,24000,2,8689
1298,8,0,14,11,31485480,3626,24000,2,8697
1299,6,0,14,11,31514640,3626,24000,2,8703
1300,5,0,10,15,31550820,3627,24000,2,8708
1301,3,0,10,15,31563120,3627,24000,2,8711
1302,9,0,16,9,31573440,3627,24000,2,8720
1303,10,0,18,7,31602420,3627,24000,2,8730
1304,10,0,17,8,31646820,3627,24000,2,8740
1305,7,0,17,8,31684800,3629,24000,2,8747
1306,4,0,13,12,31729200,3631,24000,2,8751
1307,14,0,16,9,31762740,3630,24000,2,8765
1308,13,0,16,9,31798560,3629,24000,2,8778
1309,6,0,14,11,31827300,3629,24000,2,8784
1310,4,0,10,15,31852020,3628,24000,2,8788
1311,3,0,8,17,31866660,3628,24000,2,8791
1312,14,0,16,9,31882680,3627,24000,2,8805
1313,7,0,15,10,31908600,3627,24000,2,8812
1314,8,0,15,10,31939440,3627,24000,2,8820
1315,5,0,15,10,31960020,3627,24000,2,8825
1316,5,0,12,13,32004360,3629,24000,2,8830
1317,11,0,14,11,32030880,3628,24000,2,8841
1318,1,0,8,17,32057100,3628,24000,2,8842
1319,5,0,10,15,32071200,3629,24000,2,8847
1320,5,0,9,16,32083140,3628,24000,2,8852
1321,5,0,10,15,32090520,3627,24000,2,8857
1322,6,0,11,14,32109840,3627,24000,2,8863
1323,6,0,10,15,32130900,3626,24000,2,8869
1324,2,0,8,17,32149560,3627,24000,2,8871
1325,7,0,11,14,32160300,3626,24000,2,8878
1326,12,0,15,10,32179860,3625,24000,2,8890
1327,4,0,12,13,32203320,3625,24000,2,8894
1328,6,0,12,13,32230320,3626,24000,2,8900
1329,10,0,16,9,32246700,3625,24000,2,8910
1330,7,0,15,10,32287620,3627,24000,2,8917
1331,11,0,15,10,32334600,3627,24000,2,8928
1332,9,0,15,10,32360640,3627,24000,2,8937
1333,11,0,16,9,32384820,3625,24000,2,8948
1334,8,0,18,7,32417280,3626,24000,2,8956
1335,11,0,16,9,32455500,3625,24000,2,8967
1336,4,0,11,14,32499840,3627,24000,2,8971
1337,6,0,12,13,32529360,3628,24000,2,8977
1338,7,0,13,12,32546760,3627,24000,2,8984
1339,10,0,16,9,32567340,3627,24000,2,8994
1340,7,0,17,8,32591160,3627,24000,2,9001
1341,12,0,20,5,32624460,3627,24000,2,9013
1342,5,0,13,12,32666640,3627,24000,2,9018
1343,5,0,11,14,32700240,3628,24000,2,9023
1344,1,0,7,18,32715720,3628,24000,2,9024
1345,4,0,10,15,32717460,3628,24000,2,9028
1346,8,0,14,11,32727420,3627,24000,2,9036
1347,8,0,16,9,32748540,3627,24000,2,9044
1348,7,0,13,12,32789580,3627,24000,2,9051
1349,4,0,9,16,32810940,3627,24000,2,9055
1350,4,0,9,16,32834580,3628,24000,2,9059
1351,10,0,12,13,32847900,3626,24000,2,9069
1352,11,0,13,12,32868840,3625,24000,2,9080
1353,7,0,15,10,32886120,3625,24000,2,9087
1354,12,0,17,8,32918100,3624,24000,2,9099
1355,4,0,12,13,32949180,3624,24000,2,9103
1356,7,0,12,13,32975100,3624,24000,2,9110
1357,13,0,16,9,32999700,3623,24000,2,9123
1358,13,0,20,5,33028620,3623,24000,2,9136
1359,8,0,14,11,33078300,3623,24000,2,9144
1360,9,0,16,9,33097920,3622,24000,2,9153
1361,8,0,13,12,33136440,3622,24000,2,9161
1362,6,0,12,13,33161100,3622,24000,2,9167
1363,5,0,10,15,33189300,3622,24000,2,9172
1364,10,0,16,9,33209040,3623,24000,2,9182
1365,10,0,17,8,33232560,3622,24000,2,9192
1366,1,0,10,15,33267840,3622,24000,2,9193
1367,4,0,11,14,33286020,3623,24000,2,9197
1368,7,0,12,13,33309240,3623,24000,2,9204
1369,6,0,13,12,33322560,3623,24000,2,9210
1370,6,0,12,13,33354900,3623,24000,2,9216
1371,6,0,10,15,33376560,3623,24000,2,9222
1372,6,0,12,13,33391800,3623,24000,2,9228
1373,3,0,12,13,33399900,3622,24000,2,9231
1374,6,0,10,15,33429720,3623,24000,2,9237
1375,6,0,12,13,33438120,3622,24000,2,9243
1376,7,0,14,11,33458760,3622,24000,2,9250
1377,5,0,12,13,33482520,3622,24000,2,9255
1378,3,0,11,14,33498120,3622,24000,2,9258
1379,7,0,11,14,33515220,3621,24000,2,9265
1380,6,0,11,14,33545580,3622,24000,2,9271
1381,7,0,12,13,33561960,3622,24000,2,9278
1382,7,0,16,9,33569400,3621,24000,2,9285
1383,3,0,13,12,33600720,3622,24000,2,9288
1384,13,0,17,8,33628380,3622,24000,2,9301
1385,8,0,14,11,33672660,3622,24000,2,9309
1386,4,0,12,13,33692220,3622,24000,2,9313
1387,14,0,18,7,33710160,3621,24000,2,9327
1388,4,0,16,9,33726240,3620,24000,2,9331
1389,6,0,13,12,33782820,3623,24000,2,9337
1390,7,0,16,9,33797400,3623,24000,2,9344
1391,3,0,11,14,33832440,3623,24000,2,9347
1392,3,0,9,16,33857460,3624,24000,2,9350
1393,5,0,11,14,33872580,3625,24000,2,9355
1394,7,0,16,9,33885300,3625,24000,2,9362
1395,4,0,13,12,33914520,3626,24000,2,9366
1396,3,0,10,15,33952560,3627,24000,2,9369
1397,4,0,12,13,33963300,3628,24000,2,9373
1398,3,0,9,16,33984720,3628,24000,2,9376
1399,9,0,15,10,33989940,3627,24000,2,9385
1400,9,0,11,14,34034100,3627,24000,2,9394
1401,13,0,14,11,34053960,3625,24000,2,9407
1402,6,0,11,14,34085160,3625,24000,2,9413
1403,9,0,12,13,34104660,3624,24000,2,9422
1404,8,0,12,13,34140780,3625,24000,2,9430
1405,10,0,18,7,34156320,3625,24000,2,9440
1406,12,5,18,7,34182540,3625,24780,2,9452
1407,10,2,23,2,34219980,3626,41280,4,9462
1408,6,0,14,11,34280160,3625,49560,5,9468
1409,7,0,12,13,34334040,3628,49560,5,9475
1410,4,0,12,13,34344900,3627,49560,5,9479
1411,7,0,10,15,34369080,3626,49560,5,9486
1412,11,0,14,11,34389180,3626,49560,5,9497
1413,10,0,16,9,34408440,3625,49560,5,9507
1414,7,0,14,11,34436160,3624,49560,5,9514
1415,4,0,11,14,34470060,3625,49560,5,9518
1416,5,0,10,15,34490640,3625,49560,5,9523
1417,2,0,10,15,34497660,3625,49560,5,9525
1418,4,0,9,16,34515420,3625,49560,5,9529
1419,7,0,13,12,34521720,3625,49560,5,9536
1420,6,0,11,14,34547460,3624,49560,5,9542
1421,5,0,12,13,34559040,3624,49560,5,9547
1422,7,0,12,13,34586460,3624,49560,5,9554
1423,5,0,11,14,34601820,3623,49560,5,9559
1424,5,0,8,17,34634580,3624,49560,5,9564
1425,6,0,9,16,34648380,3623,49560,5,9570
1426,7,0,12,13,34659720,3623,49560,5,9577
1427,13,0,14,11,34689000,3622,49560,5,9590
1428,13,0,20,5,34709880,3622,49560,5,9603
1429,11,0,23,2,34743480,3622,49560,5,9614
1430,13,0,22,3,34797900,3622,49920,5,9627
1431,8,0,15,10,34872720,3625,49920,5,9635
1432,8,0,16,9,34899720,3625,49920,5,9643
1433,5,0,12,13,34938240,3625,49920,5,9648
1434,7,0,13,12,34956720,3625,49920,5,9655
1435,8,0,17,8,34969920,3625,49920,5,9663
1436,5,0,14,11,35006400,3626,49920,5,9668
1437,7,0,12,13,35046660,3626,49920,5,9675
1438,2,0,13,12,35050860,3626,49920,5,9677
1439,5,0,11,14,35087340,3628,49920,5,9682
1440,4,0,9,16,35102160,3627,49920,5,9686
1441,7,0,13,12,35104680,3626,49920,5,9693
1442,5,0,10,15,35130960,3626,49920,5,9698
1443,6,0,12,13,35150460,3626,49920,5,9704
1444,3,0,9,16,35166720,3626,49920,5,9707
1445,5,0,12,13,35173200,3626,49920,5,9712
1446,6,0,15,10,35186760,3626,49920,5,9718
1447,6,0,14,11,35214240,3626,49920,5,9724
1448,6,0,13,12,35253360,3628,49920,5,9730
1449,9,0,17,8,35269620,3627,49920,5,9739
1450,6,0,15,10,35310180,3629,49920,5,9745
1451,10,0,19,6,35334000,3629,49920,5,9755
1452,16,0,20,5,35382420,3628,49920,5,9771
1453,9,0,18,7,35426340,3629,49920,5,9780
1454,14,0,21,4,35471760,3629,49920,5,9794
1455,7,0,15,10,35528160,3630,49920,5,9801
1456,8,0,11,14,35576280,3630,49920,5,9809
1457,12,0,16,9,35584320,3629,49920,5,9821
1458,3,0,8,17,35618700,3628,49920,5,9824
1459,7,0,12,13,35624760,3628,49920,5,9831
1460,5,0,11,14,35646420,3628,49920,5,9836
1461,9,0,13,12,35667240,3627,49920,5,9845
1462,6,0,10,15,35697420,3627,49920,5,9851
1463,1,0,8,17,35706240,3627,49920,5,9852
1464,2,0,8,17,35714520,3627,49920,5,9854
1465,3,0,9,16,35720100,3627,49920,5,9857
1466,3,0,11,14,35722920,3627,49920,5,9860
1467,6,0,11,14,35746800,3627,49920,5,9866
1468,6,0,15,10,35753100,3627,49920,5,9872
1469,5,0,11,14,35783040,3626,49920,5,9877
1470,4,0,8,17,35808480,3626,49920,5,9881
1471,6,0,14,11,35808480,3626,49920,5,9887
1472,8,0,14,11,35830740,3626,49920,5,9895
1473,5,0,11,14,35859540,3626,49920,5,9900
1474,10,0,16,9,35877180,3626,49920,5,9910
1475,10,0,13,12,35919360,3625,49920,5,9920
1476,8,0,14,11,35944620,3625,49920,5,9928
1477,7,0,16,9,35964060,3625,49920,5,9935
1478,11,0,19,6,35998620,3626,49920,5,9946
1479,10,0,17,8,36037740,3625,49920,5,9956
1480,8,0,13,12,36101040,3627,49920,5,9964
1481,8,0,12,13,36123120,3626,49920,5,9972
1482,8,0,14,11,36141720,3626,49920,5,9980
1483,6,0,13,12,36167400,3626,49920,4,9986
1484,7,0,13,12,36201660,3627,49920,4,9993
1485,3,0,10,15,36223140,3627,49920,4,9996
1486,5,0,11,14,36235800,3627,49920,4,10001
1487,3,0,10,15,36247740,3626,49920,4,10004
1488,8,0,15,10,36263940,3627,49920,4,10012
1489,3,0,13,12,36290280,3628,49920,4,10015
1490,6,0,14,11,36313920,3628,49920,4,10021
1491,5,0,16,9,36327660,3629,49920,4,10026
1492,7,0,12,13,36374940,3629,49920,4,10033
1493,10,0,14,11,36405600,3630,49920,4,10043
1494,3,0,9,16,36432360,3629,49920,4,10046
1495,5,0,10,15,36452820,3630,49920,4,10051
1496,4,0,13,12,36454800,3630,49920,4,10055
1497,4,0,14,11,36471900,3630,49920,4,10059
1498,7,0,12,13,36504120,3630,49920,4,10066
1499,8,0,12,13,36534780,3630,49920,4,10074
1500,8,0,11,14,36562800,3630,49920,4,10082
1501,7,0,13,12,36580200,3630,49920,4,10089
1502,5,0,11,14,36601680,3630,49920,4,10094
1503,12,0,17,8,36612240,3628,49920,4,10106
1504,8,0,16,9,36643080,3628,49920,4,10114
1505,11,0,15,10,36690000,3629,49920,4,10125
1506,8,0,14,11,36720000,3628,49920,4,10133
1507,11,0,16,9,36757140,3629,49920,4,10144
1508,9,0,17,8,36773520,3628,49920,4,10153
1509,8,0,14,11,36817320,3628,49920,4,10161
1510,2,0,8,17,36863100,3630,49920,4,10163
1511,7,0,13,12,36870900,3630,49920,4,10170
1512,2,0,11,14,36891360,3630,49920,4,10172
1513,4,0,11,14,36919560,3632,49920,4,10176
1514,6,0,10,15,36938160,3631,49920,4,10182
1515,5,0,11,14,36956940,3631,49920,4,10187
1516,6,0,11,14,36971580,3631,49920,4,10193
1517,3,0,10,15,36992940,3631,49920,4,10196
1518,7,0,10,15,37013040,3631,49920,4,10203
1519,8,0,13,12,37027260,3630,49920,4,10211
1520,6,0,11,14,37043100,3629,49920,4,10217
1521,13,0,14,11,37073160,3628,49920,4,10230
1522,3,0,12,13,37101960,3629,49920,4,10233
1523,9,0,15,10,37130340,3630,49920,4,10242
1524,5,0,13,12,37150440,3630,49920,4,10247
1525,11,0,15,10,37182420,3630,49920,4,10258
1526,5,0,12,13,37209180,3629,49920,4,10263
1527,6,0,12,13,37238880,3630,49920,4,10269
1528,12,0,20,5,37252440,3630,49920,4,10281
1529,9,0,13,12,37301940,3629,49920,4,10290
1530,3,0,12,13,37328340,3630,49920,4,10293
1531,6,0,13,12,37360020,3632,49920,4,10299
1532,7,0,14,11,37387140,3632,49920,4,10306
1533,3,0,12,13,37411620,3633,49920,4,10309
1534,9,0,14,11,37437840,3633,49920,4,10318
1535,7,0,13,12,37469280,3633,49920,4,10325
1536,4,0,11,14,37488720,3633,49920,4,10329
1537,6,0,12,13,37512120,3633,49920,4,10335
1538,3,0,12,13,37531560,3634,49920,4,10338
1539,5,0,13,12,37551960,3635,49920,4,10343
1540,6,0,13,12,37583820,3636,49920,4,10349
1541,5,0,12,13,37603980,3636,49920,4,10354
1542,15,0,18,7,37634400,3635,49920,4,10369
1543,8,0,18,7,37655580,3635,49920,4,10377
1544,11,0,21,4,37675440,3634,49920,4,10388
1545,10,0,17,8,37752720,3636,49920,4,10398
1546,13,0,19,6,37795140,3636,49920,4,10411
1547,6,0,16,9,37840140,3638,49920,4,10417
1548,15,0,19,6,37886400,3638,49920,4,10432
1549,6,0,14,11,37924200,3638,49920,4,10438
1550,10,0,16,9,37958340,3638,49920,4,10448
1551,10,0,20,5,37976040,3638,49920,4,10458
1552,8,0,17,8,38047500,3641,49920,4,10466
1553,11,0,17,8,38092860,3641,49920,4,10477
1554,11,0,19,6,38121120,3641,49920,4,10488
1555,4,0,12,13,38176440,3642,49920,4,10492
1556,6,0,11,14,38206860,3643,49920,4,10498
1557,7,0,11,14,38224020,3642,49920,4,10505
1558,5,0,13,12,38237340,3642,49920,4,10510
1559,3,0,11,14,38256360,3642,49920,4,10513
1560,5,0,10,15,38287200,3643,49920,4,10518
1561,5,0,10,15,38301540,3643,49920,4,10523
1562,3,0,7,18,38318460,3642,49920,4,10526
1563,8,0,12,13,38322120,3642,49920,4,10534
1564,4,0,9,16,38351220,3642,49920,4,10538
1565,7,0,12,13,38360400,3641,49920,4,10545
1566,6,0,11,14,38379840,3641,49920,4,10551
1567,4,0,11,14,38390340,3640,49920,4,10555
1568,7,0,13,12,38412720,3641,49920,4,10562
1569,4,0,13,12,38431620,3641,49920,4,10566
1570,6,0,13,12,38454960,3641,49920,4,10572
1571,9,0,15,10,38484180,3642,49920,4,10581
1572,7,0,14,11,38509560,3641,49920,4,10588
1573,9,0,13,12,38534460,3640,49920,4,10597
1574,9,0,16,9,38559600,3641,49920,4,10606
1575,11,0,16,9,38591400,3640,49920,4,10617
1576,6,0,15,10,38615880,3640,49920,4,10623
1577,13,0,17,8,38651280,3639,49920,4,10636
1578,3,0,10,15,38693160,3640,49920,4,10639
1579,5,0,10,15,38711700,3640,49920,4,10644
1580,5,0,10,15,38727540,3640,49920,4,10649
1581,4,0,10,15,38737380,3639,49920,4,10653
1582,9,0,13,12,38759580,3639,49920,4,10662
1583,2,0,11,14,38776380,3639,49920,4,10664
1584,1,0,7,18,38802480,3640,49920,4,10665
1585,2,0,8,17,38803440,3640,49920,4,10667
1586,4,0,9,16,38808720,3639,49920,4,10671
1587,2,0,9,16,38814000,3639,49920,4,10673
1588,8,0,9,16,38836500,3639,49920,4,10681
1589,3,0,10,15,38839800,3638,49920,4,10684
1590,2,0,9,16,38851800,3638,49920,4,10686
1591,11,0,17,8,38860860,3638,49920,4,10697
1592,10,0,17,8,38892420,3638,49920,4,10707
1593,6,0,15,10,38922600,3638,49920,4,10713
1594,11,0,14,11,38962500,3637,49920,4,10724
1595,12,0,16,9,38994540,3637,49920,4,10736
1596,7,0,15,10,39013320,3636,49920,4,10743
1597,10,0,13,12,39055980,3636,49920,4,10753
1598,6,0,11,14,39079620,3635,49920,4,10759
1599,12,0,16,9,39110280,3636,49920,4,10771
1600,12,0,21,4,39133380,3636,49920,4,10783
1601,10,0,18,7,39178500,3636,49920,4,10793
1602,6,0,12,13,39232320,3637,49920,4,10799
1603,7,0,13,12,39249780,3636,49920,4,10806
1604,4,0,10,15,39282480,3637,49920,4,10810
1605,7,0,13,12,39302880,3637,49920,4,10817
1606,3,0,14,11,39309720,3637,49920,4,10820
1607,8,0,12,13,39352080,3638,49920,4,10828
1608,3,0,11,14,39367140,3638,49920,4,10831
1609,4,0,11,14,39381000,3638,49920,4,10835
1610,6,0,12,13,39400500,3638,49920,4,10841
1611,9,0,13,12,39420480,3637,49920,4,10850
1612,6,0,15,10,39427200,3636,49920,4,10856
1613,10,0,12,13,39475860,3636,49920,4,10866
1614,6,0,14,11,39491400,3637,49920,4,10872
1615,8,0,16,9,39513660,3637,49920,4,10880
1616,6,0,11,14,39551580,3636,49920,4,10886
1617,6,0,15,10,39558480,3636,49920,4,10892
1618,11,0,16,9,39600300,3637,49920,4,10903
1619,11,0,17,8,39631500,3636,49920,4,10914
1620,8,0,16,9,39667200,3637,49920,4,10922
1621,10,0,14,11,39699840,3636,49920,4,10932
1622,9,0,16,9,39726240,3636,49920,4,10941
1623,5,0,10,15,39772740,3636,49920,4,10946
1624,9,0,14,11,39783900,3636,49920,4,10955
1625,6,0,11,14,39818820,3636,49920,4,10961
1626,8,0,12,13,39842280,3636,49920,4,10969
1627,10,0,17,8,39865560,3636,49920,4,10979
1628,8,0,18,7,39895080,3637,49920,4,10987
1629,10,0,16,9,39947700,3637,49920,4,10997
1630,8,0,14,11,39993720,3638,49920,4,11005
1631,6,0,11,14,40021380,3638,49920,4,11011
1632,2,0,7,18,40050840,3639,49920,4,11013
1633,1,0,7,18,40056180,3639,49920,4,11014
1634,2,0,6,19,40060320,3638,49920,4,11016
1635,3,0,9,16,40060320,3638,49920,4,11019
1636,8,0,14,11,40068360,3638,49920,4,11027
1637,3,0,13,12,40083720,3638,49920,4,11030
1638,9,0,15,10,40116240,3638,49920,4,11039
1639,12,0,17,8,40139700,3637,49920,4,11051
1640,4,0,13,12,40175640,3638,49920,4,11055
1641,7,0,13,12,40208220,3639,49920,4,11062
1642,9,0,13,12,40228500,3637,49920,4,11071
1643,7,0,13,12,40255080,3638,49920,4,11078
1644,13,0,19,6,40280160,3638,49920,4,11091
1645,13,0,16,9,40332720,3637,49920,4,11104
1646,4,0,13,12,40358940,3637,49920,4,11108
1647,6,0,10,15,40396860,3638,49920,4,11114
1648,11,0,16,9,40404240,3637,49920,4,11125
1649,7,0,14,11,40434480,3636,49920,4,11132
1650,8,0,15,10,40463340,3637,49920,4,11140
1651,8,0,14,11,40491660,3636,49920,4,11148
1652,5,0,10,15,40529280,3637,49920,4,11153
1653,6,0,11,14,40548720,3637,49920,4,11159
1654,3,0,12,13,40558620,3637,49920,4,11162
1655,1,0,9,16,40582860,3638,49920,4,11163
1656,3,0,9,16,40599360,3638,49920,4,11166
1657,2,0,9,16,40603560,3638,49920,4,11168
1658,3,0,8,17,40629780,3639,49920,4,11171
1659,5,0,10,15,40634160,3639,49920,4,11176
1660,6,0,12,13,40646940,3638,49920,4,11182
1661,6,0,12,13,40664640,3638,49920,4,11188
1662,12,0,15,10,40691580,3638,49920,4,11200
1663,7,0,13,12,40714320,3637,49920,4,11207
1664,5,0,8,17,40741320,3636,49920,4,11212
1665,10,0,13,12,40755720,3635,49920,4,11222
1666,9,0,14,11,40773540,3634,49920,4,11231
1667,5,0,10,15,40796460,3634,49920,4,11236
1668,6,0,11,14,40812660,3633,49920,4,11242
1669,8,0,11,14,40834680,3633,49920,4,11250
1670,9,0,16,9,40845780,3632,49920,4,11259
1671,7,0,16,9,40870980,3632,49920,4,11266
1672,8,0,14,11,40909920,3633,49920,4,11274
1673,15,0,19,6,40943280,3632,49920,4,11289
1674,6,0,15,10,40979820,3632,49920,4,11295
1675,11,0,12,13,41031840,3633,49920,4,11306
1676,5,0,10,15,41049120,3632,49920,4,11311
1677,3,0,10,15,41067960,3633,49920,4,11314
1678,6,0,13,12,41076000,3632,49920,4,11320
1679,5,0,12,13,41097300,3632,49920,4,11325
1680,5,0,9,16,41123820,3632,49920,4,11330
1681,10,0,11,14,41141640,3631,49920,4,11340
1682,3,0,10,15,41151240,3631,49920,4,11343
1683,5,0,9,16,41166840,3630,49920,4,11348
1684,2,0,8,17,41176080,3630,49920,4,11350
1685,4,0,10,15,41180280,3630,49920,4,11354
1686,7,0,11,14,41192940,3629,49920,4,11361
1687,7,0,11,14,41216160,3629,49920,4,11368
1688,7,0,10,15,41235000,3628,49920,4,11375
1689,15,0,20,5,41244420,3627,49920,4,11390
1690,4,0,10,15,41293560,3627,49920,4,11394
1691,9,0,15,10,41302140,3626,49920,4,11403
1692,4,0,12,13,41333640,3627,49920,4,11407
1693,10,0,17,8,41356140,3627,49920,4,11417
1694,8,0,14,11,41395920,3627,49920,4,11425
1695,7,0,17,8,41412240,3627,49920,4,11432
1696,7,0,14,11,41453340,3628,49920,4,11439
1697,8,0,13,12,41490120,3628,49920,4,11447
1698,10,0,18,7,41507160,3628,49920,4,11457
1699,7,0,14,11,41548620,3628,49920,4,11464
1700,6,0,14,11,41568360,3628,49920,4,11470
1701,5,0,12,13,41597820,3628,49920,4,11475
1702,8,0,14,11,41627460,3629,49920,4,11483
1703,8,0,11,14,41666880,3629,49920,4,11491
1704,7,0,14,11,41681100,3629,49920,4,11498
1705,4,0,12,13,41700900,3629,49920,4,11502
1706,4,0,10,15,41726700,3629,49920,4,11506
1707,1,0,10,15,41731800,3629,49920,4,11507
1708,5,0,10,15,41750640,3629,49920,4,11512
1709,5,0,11,14,41755080,3628,49920,4,11517
1710,6,0,12,13,41772780,3628,49920,4,11523
1711,7,0,11,14,41794620,3628,49920,4,11530
1712,8,0,15,10,41803680,3627,49920,4,11538
1713,5,0,13,12,41824560,3627,49920,4,11543
1714,7,0,18,7,41830440,3627,49920,4,11550
1715,12,0,19,6,41884200,3628,49920,4,11562
1716,7,0,16,9,41920800,3628,49920,4,11569
1717,16,0,21,4,41964180,3628,49920,4,11585
1718,7,0,15,10,42008940,3628,49920,4,11592
1719,7,0,14,11,42055860,3630,49920,4,11599
1720,7,0,14,11,42087180,3630,49920,4,11606
1721,7,0,16,9,42108900,3631,49920,4,11613
1722,3,0,11,14,42147120,3631,49920,4,11616
1723,4,0,10,15,42175020,3632,49920,4,11620
1724,5,0,11,14,42193920,3633,49920,4,11625
1725,5,0,11,14,42212160,3633,49920,4,11630
1726,3,0,9,16,42232680,3633,49920,4,11633
1727,5,0,9,16,42242760,3632,49920,4,11638
1728,2,0,9,16,42249660,3632,49920,4,11640
1729,2,0,8,17,42263400,3632,49920,4,11642
1730,6,0,9,16,42274200,3632,49920,4,11648
1731,5,0,10,15,42282540,3631,49920,4,11653
1732,5,0,11,14,42294720,3631,49920,4,11658
1733,8,0,11,14,42317160,3630,49920,4,11666
1734,9,0,15,10,42325080,3629,49920,4,11675
1735,11,0,18,7,42350340,3629,49920,4,11686
1736,6,0,16,9,42379500,3629,49920,4,11692
1737,11,0,14,11,42434640,3630,49920,4,11703
1738,8,0,13,12,42459600,3629,49920,4,11711
1739,6,0,12,13,42479700,3629,49920,4,11717
1740,16,0,20,5,42506700,3629,49920,4,11733
1741,4,0,15,10,42533760,3628,49920,4,11737
1742,12,0,16,9,42577920,3628,49920,4,11749
1743,5,0,14,11,42600180,3628,49920,4,11754
1744,3,0,11,14,42641640,3630,49920,4,11757
1745,9,0,12,13,42672840,3630,49920,4,11766
1746,8,0,12,13,42688500,3629,49920,4,11774
1747,8,0,15,10,42703080,3629,49920,4,11782
1748,3,0,11,14,42725820,3628,49920,4,11785
1749,5,0,8,17,42763320,3629,49920,4,11790
1750,5,0,11,14,42765360,3629,49920,4,11795
1751,4,0,7,18,42787800,3628,49920,4,11799
1752,3,0,8,17,42793320,3628,49920,4,11802
1753,3,0,9,16,42796440,3628,49920,4,11805
1754,1,0,8,17,42809280,3628,49920,4,11806
1755,3,0,10,15,42810000,3628,49920,4,11809
1756,5,0,11,14,42828360,3628,49920,4,11814
1757,5,0,12,13,42850140,3629,49920,4,11819
1758,2,0,10,15,42871140,3629,49920,4,11821
1759,6,0,11,14,42892680,3630,49920,4,11827
1760,6,0,10,15,42909900,3629,49920,4,11833
1761,11,0,17,8,42921780,3629,49920,4,11844
1762,9,0,19,6,42944760,3628,49920,4,11853
1763,12,0,17,8,42994140,3628,49920,4,11865
1764,10,0,15,10,43040940,3629,49920,4,11875
1765,5,0,11,14,43076100,3629,49920,4,11880
1766,9,0,17,8,43086180,3629,49920,4,11889
1767,8,0,16,9,43120920,3629,49920,4,11897
1768,6,0,13,12,43154220,3629,49920,4,11903
1769,12,0,19,6,43180320,3629,49920,4,11915
1770,9,0,18,7,43216020,3629,49920,4,11924
1771,9,0,14,11,43267260,3630,49920,4,11933
1772,8,0,13,12,43291860,3629,49920,4,11941
1773,4,0,11,14,43329720,3630,49920,4,11945
1774,6,0,12,13,43343580,3630,49920,4,11951
1775,1,0,10,15,43354980,3630,49920,4,11952
1776,8,0,10,15,43382940,3630,49920,4,11960
1777,4,0,11,14,43400820,3630,49920,4,11964
1778,4,0,9,16,43421520,3630,49920,4,11968
1779,1,0,8,17,43429740,3630,49920,4,11969
1780,4,0,8,17,43445940,3631,49920,4,11973
1781,10,0,14,11,43455900,3630,49920,4,11983
1782,2,0,9,16,43480080,3630,49920,4,11985
1783,15,0,15,10,43498680,3629,49920,4,12000
1784,10,0,15,10,43522260,3628,49920,4,12010
1785,8,0,12,13,43558200,3628,49920,4,12018
1786,5,0,10,15,43589460,3628,49920,4,12023
1787,4,0,9,16,43599840,3627,49920,4,12027
1788,9,0,12,13,43615500,3627,49920,4,12036
1789,9,0,14,11,43636500,3627,49920,4,12045
1790,12,0,16,9,43668960,3626,49920,4,12057
1791,12,0,17,8,43689180,3625,49920,4,12069
1792,4,0,12,13,43729500,3625,49920,4,12073
1793,6,0,11,14,43761960,3626,49920,4,12079
1794,5,0,11,14,43780800,3626,49920,4,12084
1795,6,0,11,14,43792740,3625,49920,4,12090
1796,6,0,13,12,43812900,3625,49920,4,12096
1797,5,0,11,14,43837560,3625,49920,4,12101
1798,3,0,12,13,43845960,3626,49920,4,12104
1799,6,0,14,11,43870500,3626,49920,4,12110
1800,5,0,9,16,43912560,3627,49920,4,12115
1801,7,0,14,11,43917960,3627,49920,4,12122
1802,4,0,12,13,43943820,3627,49920,4,12126
1803,7,0,14,11,43959300,3627,49920,4,12133
1804,7,0,15,10,43981680,3627,49920,4,12140
1805,7,0,14,11,44011440,3627,49920,4,12147
1806,6,0,11,14,44043360,3627,49920,4,12153
1807,7,0,10,15,44067840,3626,49920,4,12160
1808,8,0,11,14,44090040,3626,49920,4,12168
1809,5,0,10,15,44103960,3626,49920,4,12173
1810,11,0,12,13,44122500,3624,49920,4,12184
1811,5,0,13,12,44131380,3624,49920,4,12189
1812,12,0,14,11,44168520,3624,49920,4,12201
1813,8,0,18,7,44177280,3623,49920,4,12209
1814,14,0,19,6,44235960,3624,49920,4,12223
1815,5,0,14,11,44262600,3623,49920,4,12228
1816,7,0,12,13,44308020,3624,49920,4,12235
1817,14,0,17,8,44332380,3624,49920,4,12249
1818,7,0,15,10,44359020,3623,49920,4,12256
1819,7,0,11,14,44399880,3623,49920,4,12263
1820,7,0,13,12,44418960,3623,49920,4,12270
1821,6,0,12,13,44439720,3623,49920,4,12276
1822,8,0,10,15,44465700,3622,49920,4,12284
1823,3,0,10,15,44479620,3623,49920,4,12287
1824,10,0,13,12,44502120,3622,49920,4,12297
1825,4,0,13,12,44523480,3623,49920,4,12301
1826,1,0,9,16,44543700,3623,49920,4,12302
1827,4,0,12,13,44553780,3624,49920,4,12306
1828,2,0,8,17,44578380,3624,49920,4,12308
1829,6,0,10,15,44585460,3623,49920,4,12314
1830,3,0,8,17,44595780,3623,49920,4,12317
1831,7,0,13,12,44608260,3623,49920,4,12324
1832,10,0,19,6,44625300,3623,49920,4,12334
1833,6,0,13,12,44665920,3623,49920,4,12340
1834,7,0,14,11,44690880,3623,49920,4,12347
1835,7,0,13,12,44715000,3623,49920,4,12354
1836,9,0,12,13,44751180,3623,49920,4,12363
1837,11,0,13,12,44782260,3622,49920,4,12374
1838,10,0,16,9,44798640,3622,49920,4,12384
1839,8,0,16,9,44826720,3622,49920,4,12392
1840,5,0,11,14,44871720,3622,49920,4,12397
1841,9,0,12,13,44897700,3622,49920,4,12406
1842,7,0,13,12,44915400,3622,49920,4,12413
1843,2,0,9,16,44940900,3622,49920,4,12415
1844,7,0,13,12,44956200,3622,49920,4,12422
1845,5,0,11,14,44969280,3621,49920,4,12427
1846,7,0,12,13,44988660,3621,49920,4,12434
1847,3,0,12,13,45010740,3622,49920,4,12437
1848,4,0,14,11,45025080,3623,49920,4,12441
1849,3,0,11,14,45057540,3624,49920,4,12444
1850,4,0,11,14,45071880,3624,49920,4,12448
1851,3,0,7,18,45087840,3623,49920,4,12451
1852,4,0,10,15,45090600,3623,49920,4,12455
1853,7,0,12,13,45114240,3623,49920,4,12462
1854,6,0,12,13,45128520,3623,49920,4,12468
1855,4,0,10,15,45144540,3622,49920,4,12472
1856,1,0,8,17,45168960,3623,49920,4,12473
1857,6,0,11,14,45179340,3623,49920,4,12479
1858,12,0,15,10,45195660,3622,49920,3,12491
1859,8,0,12,13,45224340,3621,49920,3,12499
1860,1,0,10,15,45237420,3621,49920,3,12500
1861,11,0,14,11,45267720,3622,49920,3,12511
1862,13,0,17,8,45293700,3621,49920,3,12524
1863,7,0,12,13,45331980,3621,49920,3,12531
1864,10,0,14,11,45357840,3620,49920,3,12541
1865,14,0,17,8,45379920,3619,49920,3,12555
1866,12,0,19,6,45407880,3618,49920,3,12567
1867,12,0,21,4,45446520,3618,49920,3,12579
1868,3,0,12,13,45491460,3619,49920,3,12582
1869,4,0,12,13,45505740,3619,49920,3,12586
1870,3,0,13,12,45518160,3619,49920,3,12589
1871,5,0,9,16,45555840,3619,49920,3,12594
1872,3,0,9,16,45568440,3619,49920,3,12597
1873,1,0,8,17,45576360,3620,49920,3,12598
1874,9,0,12,13,45589380,3619,49920,3,12607
1875,6,0,13,12,45606240,3619,49920,3,12613
1876,7,0,16,9,45615300,3619,49920,3,12620
1877,8,0,19,6,45650280,3620,49920,3,12628
1878,5,0,17,8,45676980,3620,49920,3,12633
1879,5,0,13,12,45737160,3622,49980,3,12638
1880,7,0,12,13,45777960,3623,49980,3,12645
1881,6,0,14,11,45787500,3623,49980,3,12651
1882,5,0,14,11,45815760,3624,49980,3,12656
1883,6,0,11,14,45846240,3623,49980,3,12662
1884,6,0,12,13,45870780,3624,49980,3,12668
1885,13,0,14,11,45904980,3623,49980,3,12681
1886,16,0,17,8,45936720,3622,49980,3,12697
1887,13,0,21,4,45966360,3622,49980,3,12710
1888,6,0,12,13,46031460,3623,49980,3,12716
1889,10,0,15,10,46052040,3623,49980,3,12726
1890,7,0,13,12,46082040,3622,49980,3,12733
1891,7,0,14,11,46106280,3622,49980,3,12740
1892,5,0,15,10,46125360,3623,49980,3,12745
1893,5,0,13,12,46165320,3624,49980,3,12750
1894,10,0,13,12,46205520,3624,49980,3,12760
1895,9,0,16,9,46223940,3624,49980,3,12769
1896,4,0,13,12,46246740,3624,49980,3,12773
1897,4,0,9,16,46292460,3625,49980,3,12777
1898,7,0,13,12,46300740,3625,49980,3,12784
1899,9,0,12,13,46334700,3625,49980,3,12793
1900,9,0,13,12,46360680,3625,49980,3,12802
1901,1,0,10,15,46376100,3625,49980,3,12803
1902,8,0,12,13,46396800,3625,49980,3,12811
1903,8,0,13,12,46418220,3624,49980,3,12819
1904,4,0,10,15,46447920,3625,49980,3,12823
1905,9,0,15,10,46458120,3624,49980,3,12832
1906,7,0,12,13,46493820,3624,49980,3,12839
1907,7,0,15,10,46506600,3624,49980,3,12846
1908,8,0,13,12,46541280,3624,49980,3,12854
1909,9,0,15,10,46560360,3623,49980,3,12863
1910,6,0,11,14,46610400,3625,49980,3,12869
1911,4,0,13,12,46619100,3625,49980,3,12873
1912,6,0,12,13,46647540,3625,49980,3,12879
1913,7,0,11,14,46662600,3624,49980,3,12886
1914,8,0,12,13,46694760,3624,49980,3,12894
1915,6,0,10,15,46718880,3624,49980,3,12900
1916,5,0,12,13,46722000,3623,49980,3,12905
1917,7,0,15,10,46745400,3624,49980,3,12912
1918,4,0,10,15,46779000,3624,49980,3,12916
1919,3,0,8,17,46803900,3625,49980,3,12919
1920,3,0,7,18,46814280,3624,49980,3,12922
1921,5,0,9,16,46822620,3624,49980,3,12927
1922,5,0,10,15,46835460,3624,49980,3,12932
1923,2,0,8,17,46845720,3624,49980,3,12934
1924,6,0,10,15,46856280,3623,49980,3,12940
1925,10,0,14,11,46867440,3623,49980,3,12950
1926,2,0,11,14,46884360,3622,49980,3,12952
1927,5,0,11,14,46913700,3623,49980,3,12957
1928,10,0,13,12,46928220,3622,49980,3,12967
1929,12,0,18,7,46944240,3621,49980,3,12979
1930,11,0,18,7,46976100,3621,49980,3,12990
1931,7,0,14,11,47017860,3621,49980,3,12997
1932,4,0,10,15,47068380,3623,49980,3,13001
1933,10,0,15,10,47083680,3622,49980,3,13011
1934,10,0,15,10,47114400,3622,49980,3,13021
1935,11,0,18,7,47143380,3622,49980,3,13032
1936,7,0,12,13,47194680,3622,49980,3,13039
1937,7,0,13,12,47221200,3623,49980,3,13046
1938,9,0,13,12,47237160,3621,49980,3,13055
1939,5,0,14,11,47248980,3621,49980,3,13060
1940,12,0,15,10,47288460,3621,49980,3,13072
1941,8,0,13,12,47320200,3621,49980,3,13080
1942,4,0,13,12,47347020,3622,49980,3,13084
1943,3,0,10,15,47365440,3622,49980,3,13087
1944,9,0,14,11,47384760,3622,49980,3,13096
1945,0,0,8,17,47412480,3622,49980,3,13096
1946,5,0,10,15,47427420,3622,49980,3,13101
1947,6,0,12,13,47433840,3622,49980,3,13107
1948,8,0,11,14,47454900,3621,49980,3,13115
1949,7,0,12,13,47485560,3622,49980,3,13122
1950,4,0,11,14,47497980,3621,49980,3,13126
1951,6,0,12,13,47514000,3621,49980,3,13132
1952,9,0,15,10,47527140,3620,49980,3,13141
1953,7,0,13,12,47569680,3621,49980,3,13148
1954,6,0,13,12,47596920,3622,49980,3,13154
1955,6,0,11,14,47622780,3621,49980,3,13160
1956,12,0,17,8,47641680,3621,49980,3,13172
1957,5,0,14,11,47670720,3621,49980,3,13177
1958,13,0,16,9,47710080,3621,49980,3,13190
1959,12,0,17,8,47746500,3621,49980,3,13202
1960,6,0,16,9,47767620,3620,49980,3,13208
1961,10,0,18,7,47813280,3622,49980,3,13218
1962,8,0,14,11,47856360,3622,49980,3,13226
1963,10,0,13,12,47903760,3622,49980,3,13236
1964,3,0,8,17,47926860,3622,49980,3,13239
1965,6,0,12,13,47932920,3622,49980,3,13245
1966,5,0,11,14,47964900,3623,49980,3,13250
1967,2,0,10,15,47981580,3623,49980,3,13252
1968,4,0,7,18,48010140,3623,49980,3,13256
1969,3,0,7,18,48014640,3623,49980,3,13259
1970,5,0,9,16,48018600,3622,49980,3,13264
1971,2,0,9,16,48023640,3622,49980,3,13266
1972,1,0,9,16,48024480,3622,49980,3,13267
1973,10,0,16,9,48039600,3622,49980,3,13277
1974,7,0,14,11,48067500,3622,49980,3,13284
1975,10,0,13,12,48093000,3621,49980,3,13294
1976,11,0,15,10,48130260,3621,49980,3,13305
1977,8,0,14,11,48155820,3621,49980,3,13313
1978,6,0,12,13,48189000,3621,49980,3,13319
1979,9,0,14,11,48211680,3621,49980,3,13328
1980,6,0,9,16,48246660,3620,49980,3,13334
1981,10,0,16,9,48249480,3620,49980,3,13344
1982,10,0,15,10,48282360,3619,49980,3,13354
1983,9,0,17,8,48306780,3619,49980,3,13363
1984,7,0,14,11,48345540,3619,49980,3,13370
1985,9,0,16,9,48365700,3619,49980,3,13379
1986,8,0,13,12,48399600,3618,49980,3,13387
1987,11,0,17,8,48427620,3619,49980,3,13398
1988,7,0,17,8,48451920,3619,49980,3,13405
1989,2,0,14,11,48477960,3619,49980,3,13407
1990,5,0,10,15,48527760,3620,49980,3,13412
1991,4,0,10,15,48546300,3621,49980,3,13416
1992,10,0,16,9,48559920,3621,49980,3,13426
1993,4,0,9,16,48599280,3621,49980,3,13430
1994,3,0,7,18,48611520,3620,49980,3,13433
1995,10,0,12,13,48619860,3619,49980,3,13443
1996,4,0,14,11,48623040,3619,49980,3,13447
1997,4,0,10,15,48659520,3620,49980,3,13451
1998,6,0,13,12,48677640,3620,49980,3,13457
1999,4,0,10,15,48699300,3620,49980,3,13461
2000,3,0,10,15,48706140,3620,49980,3,13464
2001,3,0,8,17,48728700,3620,49980,3,13467
2002,3,0,8,17,48740280,3620,49980,3,13470
2003,10,0,15,10,48742800,3619,49980,3,13480
2004,10,0,16,9,48768960,3619,49980,3,13490
2005,6,0,18,7,48782760,3619,49980,3,13496
2006,3,0,9,16,48845700,3620,49980,3,13499
2007,7,0,11,14,48865800,3621,49980,3,13506
2008,8,0,15,10,48873000,3620,49980,3,13514
2009,9,0,13,12,48901320,3619,49980,3,13523
2010,10,0,14,11,48930120,3619,49980,3,13533
2011,2,0,11,14,48955020,3619,49980,3,13535
2012,5,0,9,16,48988980,3620,49980,3,13540
2013,8,0,14,11,48999480,3620,49980,3,13548
2014,5,0,11,14,49016160,3619,49980,3,13553
2015,10,0,14,11,49036920,3619,49980,3,13563
2016,5,0,12,13,49053960,3618,49980,3,13568
2017,9,0,19,6,49055760,3618,49980,3,13577
2018,2,0,16,9,49074240,3618,49980,3,13579
2019,8,0,20,5,49096020,3618,49980,3,13587
2020,6,0,23,2,49109400,3618,49980,3,13593
2021,4,0,17,8,49159800,3620,49980,3,13597
2022,6,0,18,7,49182720,3620,49980,3,13603
2023,5,0,17,8,49207440,3620,49980,3,13608
2024,10,0,16,9,49233360,3619,49980,3,13618
2025,7,0,19,6,49249200,3619,49980,3,13625
2026,11,0,21,4,49278060,3619,49980,3,13636
2027,6,0,18,7,49319220,3620,49980,3,13642
2028,10,0,20,5,49347300,3619,49980,3,13652
2029,11,0,21,4,49378500,3619,50100,3,13663
2030,5,0,16,9,49421280,3620,50100,3,13668
2031,5,0,17,8,49438860,3620,50100,3,13673
2032,6,0,19,6,49447200,3619,50100,3,13679
2033,10,0,21,4,49481040,3620,50100,3,13689
2034,8,0,19,6,49514100,3619,50100,3,13697
2035,6,0,21,4,49529460,3620,50100,3,13703
2036,9,0,17,8,49585380,3620,50520,3,13712
2037,3,0,16,9,49600800,3620,50520,3,13715
2038,5,0,16,9,49627140,3621,50520,3,13720
2039,5,0,16,9,49635060,3620,50520,3,13725
2040,6,0,16,9,49656960,3620,50520,3,13731
2041,6,0,16,9,49682580,3620,50520,3,13737
2042,2,0,14,11,49698600,3621,50520,3,13739
2043,3,0,14,11,49711020,3621,50520,3,13742
2044,3,0,15,10,49717980,3621,50520,3,13745
2045,3,0,15,10,49731660,3621,50520,3,13748
2046,8,0,17,8,49747740,3620,50520,3,13756
2047,6,0,19,6,49761120,3620,50520,3,13762
2048,3,0,17,8,49788300,3621,50520,3,13765
2049,9,0,18,7,49820280,3621,50520,3,13774
2050,14,0,25,0,49838100,3621,50520,3,13788
2051,7,0,22,3,49869420,3620,50520,3,13795
2052,8,0,23,2,49903320,3621,50520,3,13803
2053,11,0,23,2,49954920,3622,50520,3,13814
2054,5,0,22,3,49971180,3621,50520,3,13819
2055,4,0,16,9,50028540,3623,50520,3,13823
2056,11,0,18,7,50054340,3622,50520,3,13834
2057,12,0,22,3,50066580,3621,50520,3,13846
2058,7,0,17,8,50104260,3621,50520,3,13853
2059,8,0,19,6,50126700,3621,50520,3,13861
2060,4,0,14,11,50158860,3621,50520,3,13865
2061,10,0,18,7,50175120,3620,50520,3,13875
2062,6,0,19,6,50188260,3620,50520,3,13881
2063,3,0,13,12,50226780,3620,50520,3,13884
2064,5,0,15,10,50240880,3621,50520,3,13889
2065,8,0,20,5,50249280,3621,50520,3,13897
2066,2,0,15,10,50274600,3621,50520,3,13899
2067,4,0,14,11,50307180,3622,50520,3,13903
2068,7,0,16,9,50312940,3621,50520,3,13910
2069,6,0,18,7,50329260,3621,50520,3,13916
2070,4,0,15,10,50361360,3621,50520,3,13920
2071,6,0,17,8,50379720,3622,50520,3,13926
2072,3,0,16,9,50393520,3622,50520,3,13929
2073,11,0,19,6,50419320,3621,50520,3,13940
2074,10,0,20,5,50442840,3621,50520,3,13950
2075,18,1,25,0,50484540,3621,53700,3,13968
2076,6,0,20,5,50521800,3620,55860,3,13974
2077,6,0,16,9,50558280,3620,55860,3,13980
2078,12,0,19,6,50586660,3620,55860,3,13992
2079,6,0,20,5,50605440,3620,55860,3,13998
2080,5,0,19,6,50633520,3620,55860,3,14003
2081,7,0,22,3,50648820,3620,55860,3,14010
2082,7,0,19,6,50696280,3621,55860,3,14017
2083,6,0,20,5,50720040,3622,55860,3,14023
2084,8,0,20,5,50756580,3622,55860,3,14031
2085,9,0,20,5,50789760,3622,55860,3,14040
2086,2,0,15,10,50822940,3623,55860,3,14042
2087,8,0,16,9,50850120,3623,55860,3,14050
2088,3,0,16,9,50863920,3623,55860,3,14053
2089,3,0,16,9,50881020,3624,55860,3,14056
2090,2,0,14,11,50899260,3624,55860,3,14058
2091,7,0,18,7,50909580,3624,55860,3,14065
2092,4,0,14,11,50933220,3623,55860,3,14069
2093,6,0,17,8,50937960,3623,55860,3,14075
2094,8,0,21,4,50951280,3623,55860,3,14083
2095,5,0,17,8,50975700,3622,55860,3,14088
2096,13,0,22,3,51006540,3622,55860,3,14101
2097,8,0,21,4,51043620,3623,55860,3,14109
2098,7,0,16,9,51082440,3622,55860,3,14116
2099,9,0,20,5,51100500,3622,55860,3,14125
2100,12,0,24,1,51121140,3622,55860,3,14137
2101,9,0,20,5,51184620,3623,55980,3,14146
2102,8,0,22,3,51208440,3623,55980,3,14154
2103,9,0,23,2,51248820,3624,56220,3,14163
2104,4,0,18,7,51293940,3625,56220,3,14167
2105,4,0,15,10,51332460,3626,56220,3,14171
2106,9,0,18,7,51351600,3626,56220,3,14180
2107,6,0,15,10,51376020,3625,56220,3,14186
2108,7,0,17,8,51393480,3625,56220,3,14193
2109,7,0,19,6,51407280,3625,56220,3,14200
2110,4,0,17,8,51439740,3625,56220,3,14204
2111,5,0,15,10,51471420,3626,56220,3,14209
2112,5,0,16,9,51487980,3626,56220,3,14214
2113,1,0,13,12,51506880,3626,56220,3,14215
2114,3,0,13,12,51517500,3626,56220,3,14218
2115,3,0,14,11,51524160,3626,56220,3,14221
2116,8,0,18,7,51535380,3626,56220,3,14229
2117,6,0,15,10,51552840,3625,56220,3,14235
2118,8,0,20,5,51564540,3625,56220,3,14243
2119,10,0,21,4,51590940,3624,56220,3,14253
2120,9,0,19,6,51628080,3624,56220,3,14262
2121,14,0,24,1,51653160,3624,56220,3,14276
2122,10,0,24,1,51695580,3624,56700,3,14286
2123,9,0,22,3,51739800,3625,56700,3,14295
2124,13,0,22,3,51783180,3624,56700,3,14308
2125,5,0,20,5,51803520,3624,56700,3,14313
2126,10,0,18,7,51858780,3625,56940,3,14323
2127,6,0,18,7,51882660,3625,56940,3,14329
2128,6,0,19,6,51912000,3626,56940,3,14335
2129,10,0,23,2,51941940,3626,56940,3,14345
2130,11,0,24,1,51978060,3626,57120,3,14356
2131,6,0,20,5,52014480,3626,57120,3,14362
2132,8,0,17,8,52049100,3626,57120,3,14370
2133,4,0,16,9,52072380,3626,57120,3,14374
2134,5,0,15,10,52099260,3627,57120,3,14379
2135,7,0,18,7,52111500,3626,57120,3,14386
2136,3,0,17,8,52128180,3627,57120,3,14389
2137,6,0,20,5,52147980,3627,57120,3,14395
2138,2,0,17,8,52166160,3627,57120,3,14397
2139,5,0,16,9,52197540,3628,57120,3,14402
2140,5,0,16,9,52216680,3628,57120,3,14407
2141,7,0,19,6,52235880,3628,57120,3,14414
2142,6,0,18,7,52264680,3628,57120,3,14420
2143,5,0,15,10,52293060,3628,57120,3,14425
2144,4,0,15,10,52313520,3629,57120,3,14429
2145,12,0,21,4,52333920,3629,57120,3,14441
2146,3,0,21,4,52351860,3629,57900,4,14444
2147,8,0,21,4,52394040,3630,57900,4,14452
2148,11,0,18,7,52433760,3629,57900,4,14463
2149,8,0,16,9,52469700,3629,57900,4,14471
2150,14,3,25,0,52478100,3629,57900,3,14485
2151,10,7,25,0,52505220,3630,63660,4,14495
2152,13,8,25,0,52572900,3631,75480,5,14508
2153,2,0,15,10,52639320,3631,95280,6,14510
2154,5,0,17,8,52656900,3632,95280,6,14515
2155,6,0,17,8,52679760,3632,95280,6,14521
2156,2,0,13,12,52709400,3632,95280,6,14523
2157,6,0,17,8,52714080,3632,95280,6,14529
2158,4,0,17,8,52725420,3632,95280,6,14533
2159,4,0,16,9,52750560,3632,95280,6,14537
2160,5,0,17,8,52778100,3633,95280,6,14542
2161,2,0,14,11,52800300,3633,95280,6,14544
2162,3,0,14,11,52816440,3634,95280,6,14547
2163,3,0,12,13,52832640,3634,95280,6,14550
2164,6,0,16,9,52841700,3634,95280,6,14556
2165,6,0,17,8,52853880,3633,95280,6,14562
2166,1,0,13,12,52874220,3633,95280,6,14563
2167,5,0,14,11,52883700,3633,95280,6,14568
2168,9,0,17,8,52906980,3633,95280,6,14577
2169,8,0,19,6,52918020,3632,95280,6,14585
2170,0,0,13,12,52954500,3633,95280,6,14585
2171,5,0,16,9,52963980,3634,95280,6,14590
2172,11,0,21,4,52970580,3633,95280,6,14601
2173,11,0,22,3,53011440,3633,95280,6,14612
2174,9,0,23,2,53040480,3633,95580,6,14621
2175,5,0,18,7,53099700,3634,95580,6,14626
2176,16,2,25,0,53115660,3634,95580,6,14642
2177,9,1,25,0,53162580,3635,101940,6,14651
2178,2,0,15,10,53216640,3635,104520,7,14653
2179,11,0,19,6,53250840,3636,104520,7,14664
2180,7,0,20,5,53267580,3635,104520,7,14671
2181,7,0,19,6,53306400,3636,104520,7,14678
2182,8,0,19,6,53340900,3636,104520,7,14686
2183,3,0,17,8,53361120,3636,104520,7,14689
2184,5,0,15,10,53392860,3637,104520,7,14694
2185,5,0,17,8,53403240,3637,104520,7,14699
2186,7,0,16,9,53432760,3637,104520,7,14706
2187,9,0,17,8,53447160,3636,104520,7,14715
2188,8,0,21,4,53467440,3636,104520,7,14723
2189,3,0,15,10,53502060,3636,104520,7,14726
2190,8,0,15,10,53518260,3635,104520,7,14734
2191,7,0,18,7,53534040,3636,104520,7,14741
2192,2,0,18,7,53539740,3635,104520,7,14743
2193,9,0,16,9,53582760,3636,104520,7,14752
2194,7,0,18,7,53598960,3636,104520,7,14759
2195,10,0,19,6,53620620,3635,104520,7,14769
2196,8,0,21,4,53639280,3635,104520,7,14777
2197,8,0,20,5,53668440,3634,104520,7,14785
2198,4,0,17,8,53711760,3636,104520,7,14789
2199,8,0,19,6,53734080,3636,104520,7,14797
2200,8,0,18,7,53765700,3636,104520,7,14805
2201,6,0,14,11,53792220,3635,104520,7,14811
2202,9,0,19,6,53808240,3635,104520,7,14820
2203,4,0,14,11,53827380,3634,104520,7,14824
2204,4,0,13,12,53846520,3634,104520,7,14828
2205,4,0,16,9,53847060,3634,104520,7,14832
2206,4,0,15,10,53868420,3634,104520,7,14836
2207,5,0,16,9,53880720,3634,104520,7,14841
2208,5,0,16,9,53898780,3634,104520,7,14846
2209,6,0,16,9,53915820,3634,104520,7,14852
2210,2,0,17,8,53922180,3634,104520,7,14854
2211,5,0,16,9,53948880,3634,104520,7,14859
2212,7,0,15,10,53978700,3634,104520,7,14866
2213,3,0,13,12,53991060,3634,104520,7,14869
2214,8,0,17,8,54003420,3634,104520,7,14877
2215,8,0,21,4,54009960,3633,104520,7,14885
2216,6,0,22,3,54039780,3634,104520,7,14891
2217,7,0,19,6,54091200,3635,104520,7,14898
2218,4,0,18,7,54115740,3635,104520,7,14902
2219,7,0,19,6,54145380,3636,104520,7,14909
2220,7,0,22,3,54157860,3636,104520,7,14916
2221,9,0,17,8,54216600,3636,104520,7,14925
2222,9,0,18,7,54230340,3635,104520,6,14934
2223,5,0,15,10,54266160,3636,104520,6,14939
2224,13,0,22,3,54273180,3635,104520,6,14952
2225,9,0,21,4,54314340,3635,104520,6,14961
2226,7,0,19,6,54354360,3635,104520,6,14968
2227,6,0,20,5,54378960,3636,104520,6,14974
2228,6,0,19,6,54413880,3637,104520,6,14980
2229,6,0,18,7,54448740,3637,104520,6,14986
2230,6,0,18,7,54469620,3637,104520,6,14992
2231,8,0,20,5,54491520,3637,104520,6,15000
2232,5,0,15,10,54529560,3637,104520,6,15005
2233,4,0,13,12,54552300,3637,104520,6,15009
2234,9,0,17,8,54556860,3636,104520,6,15018
2235,3,0,16,9,54566460,3636,104520,6,15021
2236,4,0,14,11,54587400,3636,104520,6,15025
2237,4,0,17,8,54589920,3636,104520,6,15029
2238,5,0,13,12,54622320,3636,104520,6,15034
2239,8,0,18,7,54624720,3635,104520,6,15042
2240,11,0,18,7,54652080,3634,104520,6,15053
2241,10,0,20,5,54672600,3634,104520,6,15063
2242,12,0,23,2,54700800,3634,104520,6,15075
2243,8,0,20,5,54739980,3634,104520,6,15083
2244,6,0,17,8,54783420,3634,104520,6,15089
2245,16,2,25,0,54798060,3634,105660,6,15105
2246,10,2,24,1,54845460,3634,116340,7,15115
2247,10,0,23,2,54900540,3635,123420,8,15125
2248,8,0,20,5,54936720,3635,123420,8,15133
2249,6,0,17,8,54971340,3635,123420,8,15139
2250,7,0,17,8,55000740,3635,123420,8,15146
2251,12,0,22,3,55026540,3635,123420,8,15158
2252,4,0,15,10,55065540,3635,123420,8,15162
2253,3,0,14,11,55077720,3635,123420,8,15165
2254,8,0,19,6,55088400,3635,123420,8,15173
2255,7,0,20,5,55106640,3635,123420,8,15180
2256,1,0,13,12,55141020,3635,123420,8,15181
2257,8,0,16,9,55161060,3635,123420,8,15189
2258,3,0,15,10,55170960,3635,123420,8,15192
2259,8,0,19,6,55177680,3634,123420,8,15200
2260,4,0,17,8,55207440,3635,123420,8,15204
2261,4,0,17,8,55215780,3634,123420,8,15208
2262,7,0,16,9,55246440,3634,123420,8,15215
2263,19,4,25,0,55259040,3634,125220,8,15234
2264,10,5,25,0,55301040,3634,135780,8,15244
2265,6,0,19,6,55349640,3634,146760,9,15250
2266,16,0,25,0,55392000,3634,147120,9,15266
2267,11,0,23,2,55426500,3633,147120,9,15277
2268,9,5,18,7,55463820,3633,148260,9,15286
2269,8,5,21,4,55502340,3635,158700,10,15294
2270,4,0,16,9,55543680,3634,185640,12,15298
2271,6,0,17,8,55567680,3634,185640,12,15304
2272,6,0,18,7,55582320,3634,185640,12,15310
2273,6,0,18,7,55599360,3634,185640,12,15316
2274,7,0,20,5,55629300,3635,185640,12,15323
2275,11,0,22,3,55660200,3635,185640,12,15334
2276,6,0,19,6,55693860,3635,185640,12,15340
2277,7,0,17,8,55741740,3636,185640,12,15347
2278,6,0,17,8,55759800,3635,185640,12,15353
2279,7,0,17,8,55785660,3635,185640,12,15360
2281,2,0,13,12,55808220,3635,185640,12,15362
2280,0,0,13,12,55808220,3635,185640,12,15362
2282,3,0,12,13,55820040,3635,185640,12,15365
2283,3,0,13,12,55826640,3635,185640,12,15368
2284,5,0,17,8,55827600,3635,185640,12,15373
2285,8,0,17,8,55852260,3635,185640,12,15381
2286,3,0,18,7,55862520,3635,185640,12,15384
2287,7,0,18,7,55891800,3635,185640,12,15391
2288,4,0,13,12,55919460,3635,185640,12,15395
2289,7,0,16,9,55927920,3634,185640,12,15402
2290,8,0,16,9,55946340,3634,185640,12,15410
2291,7,0,18,7,55957800,3633,185640,12,15417
2292,6,0,21,4,55976040,3634,185640,12,15423
2293,7,0,16,9,56026380,3634,185640,12,15430
2294,9,0,19,6,56039100,3634,185640,12,15439
2295,11,0,20,5,56067900,3633,185640,12,15450
2296,10,0,20,5,56111640,3634,185640,12,15460
2297,9,0,17,8,56145000,3633,185640,12,15469
2298,9,0,21,4,56168340,3633,185640,11,15478
2299,5,0,16,9,56194380,3633,185640,11,15483
2300,5,0,14,11,56222940,3633,185640,11,15488
2301,3,0,11,14,56244780,3633,185640,11,15491
2302,3,0,13,12,56245560,3633,185640,11,15494
2303,1,0,12,13,56249520,3632,185640,11,15495
2304,8,0,18,7,56250900,3632,185640,11,15503
2305,3,0,13,12,56278020,3632,185640,11,15506
2306,1,0,11,14,56285400,3632,185640,11,15507
2307,6,0,14,11,56287920,3631,185640,11,15513
2308,1,0,14,11,56290680,3631,185640,11,15514
2309,5,0,18,7,56296440,3631,185640,11,15519
2310,8,0,18,7,56321760,3631,185640,11,15527
2311,8,0,22,3,56340840,3631,185640,11,15535
2312,8,0,20,5,56376600,3631,185640,11,15543
2313,8,0,18,7,56402820,3631,185640,11,15551
2314,8,0,18,7,56432580,3631,185640,11,15559
2315,8,0,17,8,56466000,3631,185640,11,15567
2316,10,0,19,6,56480040,3630,185640,11,15577
2317,8,0,21,4,56497920,3630,185640,11,15585
2318,10,0,19,6,56538240,3629,185640,11,15595
2319,3,0,17,8,56556900,3629,185640,11,15598
2320,12,0,25,0,56581800,3630,185640,11,15610
2321,16,5,25,0,56632080,3631,189960,12,15626
2322,11,0,19,6,56686800,3629,204660,13,15637
2323,9,0,18,7,56721900,3629,204660,13,15646
2324,7,0,20,5,56737260,3629,204660,13,15653
2325,7,0,20,5,56775600,3630,204660,13,15660
2326,2,0,13,12,56812020,3630,204660,13,15662
2327,5,0,13,12,56826240,3630,204660,13,15667
2328,4,0,13,12,56832720,3629,204660,13,15671
2329,6,0,16,9,56840460,3629,204660,13,15677
2330,3,0,14,11,56852400,3629,204660,13,15680
2331,6,0,17,8,56864880,3629,204660,13,15686
2332,4,0,17,8,56874360,3628,204660,13,15690
2333,6,0,17,8,56892840,3628,204660,13,15696
2334,5,0,18,7,56913060,3628,204660,13,15701
2335,7,1,21,4,56922840,3628,204840,13,15708
2336,8,0,23,2,56956860,3629,210300,13,15716
2337,9,0,21,4,57003120,3629,210300,13,15725
2338,9,0,23,2,57032220,3630,210300,13,15734
2339,8,0,22,3,57066780,3630,210300,13,15742
2340,7,0,18,7,57116880,3630,210540,13,15749
2341,6,0,16,9,57152760,3631,210540,13,15755
2342,5,0,19,6,57160200,3631,210540,13,15760
2343,3,0,15,10,57195000,3631,210540,13,15763
2344,8,0,21,4,57203220,3631,210540,13,15771
2345,11,0,25,0,57230940,3632,210600,13,15782
2346,10,0,24,1,57280560,3632,210600,13,15792
2347,5,0,16,9,57333360,3633,210600,13,15797
2348,5,0,16,9,57346680,3632,210600,13,15802
2349,4,0,17,8,57368580,3633,210600,13,15806
2350,1,0,12,13,57393420,3633,210600,13,15807
2351,4,0,14,11,57402540,3633,210600,13,15811
2352,2,0,15,10,57403260,3633,210600,13,15813
2353,4,0,15,10,57421920,3633,210600,13,15817
2354,3,0,13,12,57442260,3633,210600,13,15820
2355,5,0,14,11,57452580,3633,210600,13,15825
2356,8,0,19,6,57455880,3633,210600,13,15833
2357,11,0,18,7,57490320,3632,210600,13,15844
2358,10,0,19,6,57510300,3631,210600,13,15854
2359,5,0,18,7,57536160,3632,210600,13,15859
2360,5,0,14,11,57569460,3632,210600,13,15864
2361,9,0,18,7,57585060,3631,210600,13,15873
2362,10,0,22,3,57596040,3631,210600,13,15883
2363,7,0,22,3,57621600,3631,210600,13,15890
2364,7,0,17,8,57678180,3632,210600,13,15897
2365,13,0,24,1,57685200,3631,210600,13,15910
2366,14,0,23,2,57727320,3630,210600,13,15924
2367,9,0,22,3,57768660,3630,210600,13,15933
2368,4,0,16,9,57806400,3630,210600,13,15937
2369,15,0,23,2,57835320,3630,210600,13,15952
2370,8,0,22,3,57866340,3630,210600,13,15960
2371,8,0,23,2,57890580,3630,210600,13,15968
2372,5,0,20,5,57936720,3631,210600,13,15973
2373,8,0,20,5,57972300,3632,210600,13,15981
2374,6,0,17,8,58013580,3632,210600,13,15987
2375,3,0,17,8,58023300,3632,210600,13,15990
2376,5,0,19,6,58039800,3632,210600,13,15995
2377,4,0,16,9,58079100,3633,210600,13,15999
2378,9,0,15,10,58118400,3633,210600,13,16008
2379,4,0,15,10,58128900,3633,210600,13,16012
2380,9,0,18,7,58144260,3633,210600,13,16021
2381,6,0,16,9,58174200,3633,210600,13,16027
2382,7,0,19,6,58189020,3633,210600,13,16034
2383,3,0,17,8,58211880,3633,210600,13,16037
2384,12,0,21,4,58237380,3633,210600,13,16049
2385,9,0,17,8,58271940,3632,210600,13,16058
2386,5,0,16,9,58300860,3633,210600,13,16063
2387,7,0,20,5,58303560,3632,210600,13,16070
2388,17,4,23,2,58340040,3632,211020,13,16087
2389,13,8,25,0,58374000,3633,217620,13,16100
2390,4,0,18,7,58440240,3632,244080,15,16104
2391,11,0,21,4,58476300,3633,244080,15,16115
2392,6,0,14,11,58510260,3632,244080,15,16121
2393,8,0,19,6,58520700,3632,244080,15,16129
2394,7,0,17,8,58550280,3632,244080,15,16136
2395,9,0,21,4,58569720,3632,244080,15,16145
2396,5,0,16,9,58605720,3632,244080,15,16150
2397,4,0,15,10,58617180,3632,244080,15,16154
2398,8,0,18,7,58637400,3632,244080,15,16162
2399,4,0,17,8,58655160,3632,244080,15,16166
2400,5,0,18,7,58668720,3632,244080,15,16171
2401,8,0,17,8,58706940,3632,244080,15,16179
2402,3,0,15,10,58722900,3632,244080,15,16182
2403,8,0,15,10,58749180,3632,244080,15,16190
2404,5,0,17,8,58757760,3631,244080,15,16195
2405,5,0,17,8,58774200,3631,244080,15,16200
2406,4,0,15,10,58796760,3631,244080,15,16204
2407,8,0,21,4,58804320,3631,244080,15,16212
2408,8,0,19,6,58836600,3631,244080,15,16220
2409,6,0,18,7,58860000,3631,244080,15,16226
2410,9,0,17,8,58905660,3632,244080,15,16235
2411,14,0,19,6,58935120,3631,244080,15,16249
2412,8,0,17,8,58963980,3630,244080,15,16257
2413,7,0,17,8,58989840,3630,244080,15,16264
2414,9,0,22,3,58998900,3630,244080,14,16273
2415,13,0,21,4,59031360,3629,244080,14,16286
2416,7,0,18,7,59079180,3630,244080,14,16293
2417,8,0,18,7,59112120,3630,244080,14,16301
2418,3,0,15,10,59135160,3630,244080,14,16304
2419,4,0,16,9,59149320,3630,244080,14,16308
2420,8,0,17,8,59179740,3630,244080,14,16316
2421,8,0,18,7,59199180,3630,244080,14,16324
2422,8,0,17,8,59225700,3630,244080,14,16332
2423,6,0,17,8,59250840,3630,244080,14,16338
2424,7,0,18,7,59275740,3630,244080,14,16345
2425,3,0,17,8,59299560,3631,244080,14,16348
2426,2,0,12,13,59332080,3631,244080,14,16350
2427,3,0,13,12,59340720,3631,244080,14,16353
2428,6,0,16,9,59343180,3631,244080,14,16359
2429,7,0,18,7,59364060,3631,244080,14,16366
2430,3,0,17,8,59377080,3631,244080,14,16369
2431,4,0,16,9,59403660,3631,244080,14,16373
2432,6,0,16,9,59427600,3631,244080,14,16379
2433,4,0,17,8,59438700,3631,244080,14,16383
2434,5,0,16,9,59463480,3632,244080,14,16388
2435,11,0,23,2,59476740,3631,244080,14,16399
2436,10,0,22,3,59509680,3631,244200,14,16409
2437,5,0,16,9,59565480,3632,244200,14,16414
2438,15,0,21,4,59587380,3631,244200,14,16429
2439,15,3,25,0,59617440,3631,249780,15,16444
2440,8,0,20,5,59676960,3631,258960,15,16452
2441,8,0,18,7,59714880,3631,258960,15,16460
2442,7,0,17,8,59743680,3631,258960,15,16467
2443,5,0,17,8,59765280,3632,258960,15,16472
2444,4,0,16,9,59785260,3632,258960,15,16476
2445,2,0,15,10,59801340,3632,258960,15,16478
2446,4,0,14,11,59819640,3632,258960,15,16482
2447,6,0,18,7,59826900,3632,258960,15,16488
2448,8,0,18,7,59848740,3632,258960,15,16496
2449,7,0,15,10,59872920,3631,258960,15,16503
2450,4,0,15,10,59879640,3630,258960,15,16507
2451,4,0,16,9,59886000,3630,258960,15,16511
2452,2,0,14,11,59912340,3631,258960,15,16513
2453,7,0,14,11,59928480,3630,258960,15,16520
2454,4,0,14,11,59941440,3630,258960,15,16524
2455,6,0,15,10,59947680,3629,258960,15,16530
2456,9,0,20,5,59963640,3629,258960,15,16539
2457,6,0,20,5,59977800,3629,258960,15,16545
2458,8,0,20,5,60022440,3630,258960,15,16553
2459,3,0,15,10,60058080,3630,258960,15,16556
2460,10,0,14,11,60086520,3630,258960,15,16566
2461,8,0,15,10,60103020,3629,258960,15,16574
2462,9,0,15,10,60123360,3628,258960,15,16583
2463,3,0,12,13,60142440,3628,258960,15,16586
2464,7,0,17,8,60144840,3628,258960,15,16593
2465,7,0,18,7,60164340,3628,258960,15,16600
2466,5,0,15,10,60193980,3628,258960,15,16605
2467,4,0,17,8,60199800,3628,258960,15,16609
2468,4,0,13,12,60232560,3628,258960,15,16613
2469,4,0,13,12,60247740,3628,258960,15,16617
2470,7,0,18,7,60250320,3628,258960,15,16624
2471,3,0,13,12,60287700,3628,258960,15,16627
2472,3,0,13,12,60300420,3628,258960,15,16630
2473,7,0,16,9,60307800,3628,258960,15,16637
2474,2,0,13,12,60327180,3628,258960,15,16639
2475,3,0,14,11,60328260,3628,258960,15,16642
2476,6,0,18,7,60339720,3628,258960,15,16648
2477,4,0,19,6,60355020,3628,258960,15,16652
2478,6,0,17,8,60388380,3628,258960,15,16658
2479,8,0,19,6,60416340,3629,258960,15,16666
2480,7,0,19,6,60432120,3628,258960,15,16673
2481,12,0,20,5,60460920,3628,258960,15,16685
2482,5,0,18,7,60497820,3628,258960,15,16690
2483,8,0,20,5,60524700,3629,258960,15,16698
2484,6,0,17,8,60562440,3629,258960,15,16704
2485,8,0,18,7,60588000,3629,258960,15,16712
2486,8,0,20,5,60604800,3629,258960,15,16720
2487,10,0,21,4,60630720,3628,258960,15,16730
2488,6,0,21,4,60658560,3628,258960,15,16736
2489,10,0,18,7,60722460,3629,258960,15,16746
2490,8,0,18,7,60741000,3629,258960,15,16754
2491,13,0,22,3,60762360,3628,258960,15,16767
2492,10,0,20,5,60798180,3628,258960,15,16777
2493,8,0,19,6,60834360,3628,258960,15,16785
2494,9,0,19,6,60864540,3628,258960,15,16794
2495,8,0,20,5,60890160,3628,258960,15,16802
2496,7,0,18,7,60928620,3628,258960,15,16809
2497,2,0,16,9,60944760,3628,258960,15,16811
2498,5,0,15,10,60968820,3628,258960,15,16816
2499,8,0,19,6,60978840,3628,258960,15,16824
2500,6,0,17,8,61019100,3629,258960,15,16830
2501,9,0,21,4,61038180,3629,258960,15,16839
2502,3,0,16,9,61071060,3629,258960,15,16842
2503,4,0,16,9,61091340,3629,258960,15,16846
2504,7,0,19,6,61110480,3630,258960,15,16853
2505,13,0,24,1,61137600,3630,258960,15,16866
2506,9,0,21,4,61183500,3630,262200,15,16875
2507,6,0,19,6,61223340,3630,262200,15,16881
2508,8,0,21,4,61244640,3630,262200,15,16889
2509,13,0,24,1,61288740,3631,262980,15,16902
2510,15,0,22,3,61334280,3630,264300,15,16917
2511,3,0,17,8,61371540,3630,264300,15,16920
2512,10,0,19,6,61398420,3630,264300,15,16930
2513,4,0,17,8,61430280,3631,264300,15,16934
2514,8,0,17,8,61462440,3631,264300,15,16942
2515,9,0,21,4,61473420,3631,264300,15,16951
2516,5,0,16,9,61508520,3630,264300,15,16956
2517,5,0,15,10,61523280,3630,264300,15,16961
2518,12,0,21,4,61545240,3630,264300,15,16973
2519,1,0,16,9,61567560,3630,264300,15,16974
2520,3,0,14,11,61589220,3630,264300,15,16977
2521,4,0,16,9,61607460,3631,264300,15,16981
2522,3,0,13,12,61626780,3631,264300,15,16984
2523,5,0,16,9,61633140,3631,264300,15,16989
2524,5,0,16,9,61647840,3631,264300,15,16994
2525,1,0,14,11,61665600,3631,264300,15,16995
2526,7,0,17,8,61687020,3631,264300,15,17002
2527,9,0,17,8,61711980,3631,264300,15,17011
2528,5,0,18,7,61732440,3631,264300,15,17016
2529,9,0,18,7,61748940,3630,264300,15,17025
2530,7,0,19,6,61777860,3631,264300,15,17032
2531,5,0,20,5,61799760,3631,264600,15,17037
2532,9,5,20,5,61820700,3632,265080,15,17046
2533,13,6,25,0,61871880,3633,279420,16,17059
2534,7,7,25,0,61891680,3633,287100,16,17066
2535,8,0,23,2,61948500,3633,339480,19,17074
2536,5,0,15,10,62009400,3633,339480,19,17079
2537,13,0,19,6,62029740,3633,339480,19,17092
2538,4,0,19,6,62037660,3632,339480,19,17096
2539,9,0,19,6,62072460,3632,339480,19,17105
2540,3,0,15,10,62106600,3633,339480,19,17108
2541,5,0,18,7,62116620,3633,339480,19,17113
2542,5,0,16,9,62138400,3633,339480,19,17118
2543,3,0,14,11,62150160,3633,339480,19,17121
2544,4,0,15,10,62160120,3632,339480,19,17125
2545,7,0,16,9,62176620,3632,339480,19,17132
2546,1,0,16,9,62182740,3632,339480,19,17133
2547,5,0,17,8,62202420,3633,339480,19,17138
2548,2,0,15,10,62226420,3633,339480,19,17140
2549,2,0,14,11,62242560,3633,339480,19,17142
2550,7,0,19,6,62251380,3634,339480,19,17149
2551,11,0,25,0,62261760,3633,340020,19,17160
2552,6,0,16,9,62317800,3633,340500,19,17166
2553,5,0,16,9,62345880,3634,340500,19,17171
2554,7,0,19,6,62352660,3633,340500,19,17178
2555,9,0,21,4,62376060,3633,340500,19,17187
2556,3,0,13,12,62418600,3633,340500,19,17190
2557,5,0,13,12,62429100,3633,340500,19,17195
2558,5,0,15,10,62433000,3632,340500,19,17200
2559,3,0,14,11,62444820,3632,340500,19,17203
2560,6,0,14,11,62453880,3632,340500,19,17209
2561,8,0,20,5,62459280,3631,340500,19,17217
2562,9,0,16,9,62492160,3631,340500,19,17226
2563,5,0,14,11,62508540,3630,340500,19,17231
2564,7,0,16,9,62523060,3630,340500,19,17238
2565,7,0,18,7,62541780,3630,340500,19,17245
2566,5,0,17,8,62567580,3630,340500,19,17250
2567,3,0,17,8,62576040,3630,340500,19,17253
2568,10,0,17,8,62609400,3630,340500,19,17263
2569,3,0,14,11,62637360,3630,340500,19,17266
2570,3,0,13,12,62651760,3630,340500,19,17269
2571,2,0,12,13,62657520,3630,340500,19,17271
2572,5,0,16,9,62660940,3630,340500,19,17276
2573,6,0,19,6,62668320,3630,340500,19,17282
2574,7,0,19,6,62694480,3630,340500,19,17289
2575,8,0,18,7,62725560,3630,340500,19,17297
2576,8,0,19,6,62751540,3630,340500,19,17305
2577,6,0,19,6,62780700,3630,340500,19,17311
2578,7,0,18,7,62802600,3630,340500,19,17318
2579,6,0,18,7,62823300,3630,340500,19,17324
2580,7,0,15,10,62850600,3629,340500,19,17331
2581,9,0,19,6,62867100,3629,340500,19,17340
2582,8,0,20,5,62889660,3629,340500,19,17348
2583,11,0,19,6,62929560,3629,340500,19,17359
2584,9,0,21,4,62949660,3628,340500,19,17368
2585,5,0,20,5,62979000,3629,340500,19,17373
2586,17,1,24,1,63014460,3628,340860,19,17390
2587,8,0,21,4,63062460,3629,341760,19,17398
2588,8,0,20,5,63098700,3629,341760,19,17406
2589,6,0,21,4,63132600,3630,341760,19,17412
2590,2,0,16,9,63163800,3630,341760,19,17414
2591,6,0,17,8,63180720,3630,341760,19,17420
2592,3,0,13,12,63219960,3631,341760,19,17423
2593,8,0,17,8,63232920,3631,341760,19,17431
2594,6,0,20,5,63242640,3631,341760,19,17437
2595,4,0,17,8,63274800,3631,341760,19,17441
2596,6,0,15,10,63304260,3631,341760,19,17447
2597,2,0,14,11,63323160,3631,341760,19,17449
2598,5,0,15,10,63329280,3631,341760,19,17454
2599,13,0,20,5,63353700,3631,341760,19,17467
2600,4,0,17,8,63373860,3630,341760,19,17471
2601,9,0,18,7,63406380,3631,341760,19,17480
2602,12,0,22,3,63429240,3630,341760,19,17492
2603,5,0,19,6,63467100,3631,341760,19,17497
2604,4,0,16,9,63495720,3631,341760,19,17501
2605,9,0,20,5,63517920,3631,341760,19,17510
2606,10,0,25,0,63528600,3631,341760,19,17520
2607,7,0,19,6,63588540,3631,341760,19,17527
2608,5,0,17,8,63619620,3632,341760,19,17532
2609,6,0,21,4,63632400,3632,341760,19,17538
2610,10,0,20,5,63673740,3632,341760,19,17548
2611,5,0,21,4,63693540,3632,341760,19,17553
2612,8,0,19,6,63733980,3633,341760,19,17561
2613,7,0,18,7,63773940,3633,341760,19,17568
2614,3,0,13,12,63801420,3633,341760,19,17571
2615,1,0,11,14,63814200,3633,341760,19,17572
2616,6,0,15,10,63816840,3633,341760,19,17578
2617,3,0,14,11,63827400,3633,341760,19,17581
2618,3,0,14,11,63841680,3633,341760,19,17584
2619,5,0,14,11,63856860,3633,341760,19,17589
2620,9,0,20,5,63866640,3633,341760,19,17598
2621,8,0,23,2,63875520,3632,341760,19,17606
2622,9,0,23,2,63912540,3633,341760,19,17615
2623,13,0,25,0,63964140,3633,341760,19,17628
2624,6,0,20,5,64003920,3633,341760,19,17634
2625,3,0,13,12,64060500,3634,341760,19,17637
2626,14,0,23,2,64067220,3634,341760,19,17651
2627,5,0,20,5,64097280,3634,341760,19,17656
2628,10,0,21,4,64122000,3634,341760,19,17666
2629,9,0,20,5,64168140,3634,341760,19,17675
2630,14,1,25,0,64197780,3634,342960,19,17689
2631,8,0,20,5,64249200,3634,344100,19,17697
2632,1,0,15,10,64276080,3634,344100,19,17698
2633,5,0,15,10,64296840,3635,344100,19,17703
2634,9,0,20,5,64302120,3634,344100,19,17712
2635,8,0,18,7,64337580,3634,344100,19,17720
2636,4,0,17,8,64357080,3634,344100,19,17724
2637,6,0,19,6,64371360,3634,344100,19,17730
2638,5,0,16,9,64405020,3634,344100,19,17735
2639,4,0,16,9,64420080,3634,344100,19,17739
2640,5,0,16,9,64440840,3634,344100,19,17744
2642,2,0,14,11,64458900,3635,344100,19,17746
2641,0,0,14,11,64458900,3635,344100,19,17746
2643,8,0,18,7,64469760,3634,344100,19,17754
2644,5,0,15,10,64500780,3635,344100,19,17759
2645,6,0,15,10,64517880,3634,344100,19,17765
2646,8,0,16,9,64536060,3634,344100,19,17773
2647,6,0,18,7,64545960,3634,344100,19,17779
2648,5,0,18,7,64562880,3634,344100,19,17784
2649,4,0,17,8,64574040,3633,344100,19,17788
2650,10,0,23,2,64607640,3634,344100,19,17798
2651,9,0,17,8,64653120,3634,344100,19,17807
2652,11,0,21,4,64685040,3634,344100,19,17818
2653,8,0,17,8,64713300,3633,344100,19,17826
2654,8,0,19,6,64731420,3633,344100,19,17834
2655,6,0,15,10,64764540,3633,344100,19,17840
2656,8,0,18,7,64780380,3633,344100,19,17848
2657,9,0,15,10,64813560,3632,344100,19,17857
2658,6,0,17,8,64824900,3632,344100,19,17863
2659,2,0,15,10,64842840,3632,344100,19,17865
2660,5,0,16,9,64858200,3632,344100,19,17870
2661,3,0,14,11,64878360,3632,344100,19,17873
2662,4,0,14,11,64898100,3633,344100,19,17877
2663,4,0,11,14,64913460,3632,344100,19,17881
2664,3,0,14,11,64913460,3632,344100,19,17884
2665,3,0,15,10,64919100,3632,344100,19,17887
2666,2,0,14,11,64932840,3632,344100,19,17889
2667,7,0,18,7,64937100,3632,344100,19,17896
2668,3,0,17,8,64953840,3632,344100,19,17899
2669,3,0,16,9,64983300,3633,344100,19,17902
2670,5,0,15,10,65006760,3633,344100,19,17907
2671,6,0,16,9,65020440,3633,344100,19,17913
2672,4,0,15,10,65046780,3633,344100,19,17917
2673,8,0,19,6,65059920,3633,344100,19,17925
2674,13,0,20,5,65096700,3633,344100,19,17938
2675,9,0,20,5,65117640,3632,344100,19,17947
2676,10,0,20,5,65149320,3632,344100,19,17957
2677,8,0,20,5,65177400,3632,344100,19,17965
2678,9,0,18,7,65223240,3632,344100,19,17974
2679,5,0,19,6,65231400,3632,344100,19,17979
2680,5,0,17,8,65252040,3631,344100,19,17984
2681,9,0,19,6,65281020,3631,344100,19,17993
2682,3,0,18,7,65303700,3632,344100,19,17996
2683,5,0,16,9,65330220,3632,344100,19,18001
2684,6,0,15,10,65350200,3632,344100,19,18007
2685,4,0,14,11,65372220,3632,344100,19,18011
2686,5,0,16,9,65376780,3632,344100,19,18016
2687,3,0,15,10,65395560,3632,344100,19,18019

