Hour,Arrivals,Waiting,Treating,Available Rooms,Total Treatment Time,Average Treatment Time,Total Wait Time,Average Wait Time,Total Arrivals
1,6,0,6,19,0,0,0,0,6
2,7,0,7,18,21540,3590,0,0,13
3,4,0,4,21,48000,3692,0,0,17
4,7,0,5,20,62100,3268,0,0,24
5,1,0,2,23,82980,3607,0,0,25
6,6,0,6,19,86700,3468,0,0,31
7,6,0,6,19,102420,3303,0,0,37
8,7,0,8,17,129780,3605,0,0,44
9,13,0,14,11,154440,3591,0,0,57
10,7,0,12,13,192240,3696,0,0,64
11,12,0,14,11,226800,3658,0,0,76
12,9,0,11,14,294480,3979,0,0,85
13,9,0,13,12,319620,3945,0,0,94
14,10,0,13,12,364080,4000,0,0,104
15,9,0,9,16,425580,4092,0,0,113
16,10,0,7,18,459960,3965,0,0,123
17,8,0,9,16,472260,3870,0,0,131
18,10,0,10,15,504240,3849,0,0,141
19,6,0,9,16,526740,3816,0,0,147
20,6,0,7,18,568860,3896,0,0,153
21,7,0,7,18,588480,3846,0,0,160
22,6,0,4,21,608160,3754,0,0,166
23,4,0,4,21,629160,3790,0,0,170
24,3,0,3,22,641520,3773,0,0,173
25,3,0,4,21,650760,3783,0,0,176
26,10,0,7,18,671340,3750,0,0,186
27,4,0,5,20,689760,3728,0,0,190
28,5,0,6,19,710040,3756,0,0,195
29,5,0,7,18,728700,3775,0,0,200
30,6,0,7,18,751440,3776,0,0,206
31,5,0,6,19,773880,3775,0,0,211
32,6,0,5,20,807000,3806,0,0,217
33,8,0,11,14,812580,3797,0,0,225
34,9,0,6,19,870720,3818,0,0,234
35,9,0,5,20,897480,3770,0,0,243
36,13,0,14,11,907020,3748,0,0,256
37,11,0,12,13,952560,3735,0,0,267
38,10,0,10,15,1001640,3751,0,0,277
39,13,0,9,16,1043280,3712,0,0,290
40,5,0,9,16,1056600,3694,0,0,295
41,7,0,8,17,1084020,3687,0,0,302
42,9,0,8,17,1114200,3677,0,0,311
43,13,0,12,13,1152660,3694,0,0,324
44,4,0,6,19,1173900,3645,0,0,328
45,4,0,3,22,1210500,3679,0,0,332
46,3,0,3,22,1215900,3662,0,0,335
47,6,0,6,19,1227000,3662,0,0,341
48,5,0,7,18,1243200,3667,0,0,346
49,3,0,2,23,1274100,3671,0,0,349
50,3,0,1,24,1290420,3676,0,0,352
51,4,0,2,23,1294560,3656,0,0,356
52,6,0,5,20,1297080,3633,0,0,362
53,8,0,10,15,1305900,3627,0,0,370
54,7,0,8,17,1333260,3613,0,0,377
55,4,0,6,19,1370220,3653,0,0,381
56,7,0,6,19,1400160,3665,0,0,388
57,14,0,12,13,1422360,3647,0,0,402
58,9,0,8,17,1462980,3630,0,0,411
59,6,0,4,21,1503600,3640,0,0,417
60,2,0,2,23,1519260,3643,0,0,419
61,3,0,3,22,1522920,3634,0,0,422
62,5,0,6,19,1527240,3627,0,0,427
63,13,0,10,15,1552200,3609,0,0,440
64,7,0,7,18,1577880,3586,0,0,447
65,5,0,4,21,1602840,3577,0,0,452
66,12,0,9,16,1622820,3566,0,0,464
67,12,0,14,11,1646940,3564,0,0,476
68,6,0,8,17,1687800,3560,0,0,482
69,3,0,2,23,1735920,3594,0,0,485
70,8,0,8,17,1737660,3582,0,0,493
71,6,0,4,21,1767480,3570,0,0,499
72,7,0,5,20,1788000,3568,0,0,506
73,6,0,4,21,1804980,3553,0,0,512
74,4,0,4,21,1816260,3547,0,0,516
75,1,0,0,25,1840200,3559,0,0,517
76,4,0,2,23,1842480,3550,0,0,521
77,6,0,4,21,1853220,3543,0,0,527
78,4,0,4,21,1864920,3538,0,0,531
79,9,0,7,18,1870620,3509,0,0,540
80,11,0,9,16,1895580,3497,0,0,551
81,10,0,11,14,1929060,3507,0,0,561
82,11,0,13,12,1967220,3519,0,0,572
83,7,0,11,14,2000100,3521,0,0,579
84,4,0,6,19,2030520,3519,0,0,583
85,8,0,7,18,2067180,3539,0,0,591
86,12,0,14,11,2083500,3537,0,0,603
87,11,0,14,11,2123280,3538,0,0,614
88,9,0,12,13,2167020,3546,0,0,623
89,4,0,10,15,2203740,3571,0,0,627
90,4,0,5,20,2254920,3602,0,0,631
91,5,0,2,23,2277180,3591,0,0,636
92,8,0,7,18,2282460,3583,0,0,644
93,4,0,5,20,2308500,3590,0,0,648
94,3,0,4,21,2328240,3598,0,0,651
95,4,0,7,18,2331660,3598,0,0,655
96,5,0,5,20,2363160,3607,0,0,660
97,4,0,5,20,2378160,3608,0,0,664
98,4,0,5,20,2390880,3606,0,0,668
99,3,0,5,20,2413680,3624,0,0,671
100,6,0,6,19,2430000,3621,0,0,677
101,8,0,5,20,2455200,3610,0,0,685
102,9,0,8,17,2474220,3606,0,0,694
103,6,0,7,18,2491620,3595,0,0,700
104,8,0,6,19,2534340,3610,0,0,708
105,10,0,11,14,2548860,3605,0,0,718
106,11,0,15,10,2570940,3600,0,0,729
107,13,0,15,10,2625600,3611,0,0,742
108,9,0,8,17,2691420,3622,0,0,751
109,11,0,10,15,2722200,3619,0,0,762
110,6,0,9,16,2751420,3625,0,0,768
111,9,0,7,18,2787300,3619,0,0,777
112,8,0,10,15,2807820,3622,0,0,785
113,10,0,13,12,2841900,3634,0,0,795
114,8,0,9,16,2896260,3647,0,0,803
115,7,0,7,18,2929200,3647,0,0,810
116,4,0,7,18,2948280,3653,0,0,814
117,4,0,9,16,2957040,3655,0,0,818
118,6,0,6,19,3002760,3670,0,0,824
119,5,0,6,19,3028860,3680,0,0,829
120,4,0,2,23,3052500,3673,0,0,833
121,2,0,1,24,3070380,3681,0,0,835
122,10,0,8,17,3074040,3672,0,0,845
123,5,0,8,17,3086340,3665,0,0,850
124,6,0,6,19,3113460,3662,0,0,856
125,6,0,8,17,3127860,3662,0,0,862
126,6,0,5,20,3162060,3664,0,0,868
127,3,0,3,22,3181980,3665,0,0,871
128,10,0,6,19,3197040,3653,0,0,881
129,9,0,7,18,3218880,3645,0,0,890
130,13,0,11,14,3243900,3636,0,0,903
131,9,0,11,14,3270540,3629,0,0,912
132,5,0,6,19,3314760,3638,0,0,917
133,5,0,3,22,3341400,3635,0,0,922
134,4,0,1,24,3362280,3634,0,0,926
135,15,0,12,13,3368580,3626,0,0,941
136,7,0,8,17,3406500,3623,0,0,948
137,6,0,10,15,3431580,3635,0,0,954
138,11,0,9,16,3473040,3632,0,0,965
139,6,0,4,21,3502380,3621,0,0,971
140,5,0,3,22,3532800,3630,0,0,976
141,7,0,9,16,3535800,3630,0,0,983
142,4,0,7,18,3551520,3624,0,0,987
143,6,0,7,18,3573720,3624,0,0,993
144,6,0,3,22,3616980,3631,0,0,999
145,5,0,5,20,3627480,3631,0,0,1004
146,8,0,6,19,3647280,3625,0,0,1012
147,4,0,4,21,3663720,3620,0,0,1016
148,1,0,3,22,3670800,3620,0,0,1017
149,2,0,2,23,3686460,3624,0,0,1019
150,6,0,4,21,3691740,3615,0,0,1025
151,3,0,5,20,3695880,3612,0,0,1028
152,10,0,10,15,3715380,3614,0,0,1038
153,4,0,8,17,3744840,3621,0,0,1042
154,15,0,9,16,3788040,3614,0,0,1057
155,10,0,10,15,3813420,3607,0,0,1067
156,6,0,7,18,3843960,3605,0,0,1073
157,9,0,8,17,3886800,3618,0,0,1082
158,9,0,10,15,3917280,3623,0,0,1091
159,6,0,4,21,3966600,3629,0,0,1097
160,6,0,4,21,3984240,3625,0,0,1103
161,7,0,5,20,4002960,3622,0,0,1110
162,11,0,7,18,4021320,3609,0,0,1121
163,10,0,6,19,4051380,3601,0,0,1131
164,6,0,7,18,4066980,3599,0,0,1137
165,5,0,5,20,4093740,3600,0,0,1142
166,9,0,10,15,4105500,3598,0,0,1151
167,11,0,13,12,4131900,3596,0,0,1162
168,7,0,8,17,4190400,3609,0,0,1169
169,3,0,3,22,4228740,3617,0,0,1172
170,9,0,6,19,4253220,3619,0,0,1181
171,3,0,3,22,4268640,3614,0,0,1184
172,3,0,3,22,4286400,3620,0,0,1187
173,6,0,8,17,4293300,3623,0,0,1193
174,4,0,7,18,4314720,3625,0,0,1197
175,5,0,7,18,4341480,3633,0,0,1202
176,7,0,8,17,4357920,3628,0,0,1209
177,6,0,8,17,4387920,3635,0,0,1215
178,7,0,11,14,4400340,3633,0,0,1222
179,7,0,7,18,4460820,3650,0,0,1229
180,9,0,7,18,4498260,3654,0,0,1238
181,7,0,4,21,4525080,3646,0,0,1245
182,9,0,7,18,4535520,3637,0,0,1254
183,7,0,10,15,4555980,3641,0,0,1261
184,9,0,8,17,4595460,3641,0,0,1270
185,3,0,7,18,4615800,3645,0,0,1273
186,5,0,5,20,4650780,3653,0,0,1278
187,12,0,6,19,4673880,3640,0,0,1290
188,3,0,3,22,4692900,3637,0,0,1293
189,2,0,3,22,4700040,3637,0,0,1295
190,2,0,3,22,4711020,3640,0,0,1297
191,6,0,6,19,4718520,3638,0,0,1303
192,4,0,4,21,4739220,3637,0,0,1307
193,4,0,2,23,4760520,3636,0,0,1311
194,5,0,3,22,4764840,3628,0,0,1316
195,4,0,6,19,4765260,3626,0,0,1320
196,8,0,7,18,4791840,3627,0,0,1328
197,9,0,8,17,4823460,3629,0,0,1337
198,5,0,8,17,4851000,3636,0,0,1342
199,3,0,4,21,4881900,3640,0,0,1345
200,6,0,2,23,4902060,3633,0,0,1351
201,11,0,5,20,4914840,3621,0,0,1362
202,8,0,8,17,4923600,3614,0,0,1370
203,8,0,8,17,4961880,3621,0,0,1378
204,8,0,9,16,4987980,3622,0,0,1386
205,10,0,10,15,5014620,3618,0,0,1396
206,15,0,13,12,5040960,3605,0,0,1411
207,12,0,12,13,5072520,3594,0,0,1423
208,9,0,7,18,5136480,3604,0,0,1432
209,9,0,5,20,5171520,3601,0,0,1441
210,12,0,10,15,5184060,3592,0,0,1453
211,5,0,4,21,5232060,3598,0,0,1458
212,6,0,6,19,5249880,3600,0,0,1464
213,4,0,4,21,5270820,3600,0,0,1468
214,5,0,5,20,5283480,3599,0,0,1473
215,4,0,6,19,5297280,3601,0,0,1477
216,4,0,4,21,5322600,3603,0,0,1481
217,3,0,3,22,5337420,3603,0,0,1484
218,3,0,2,23,5355960,3606,0,0,1487
219,10,0,6,19,5366040,3598,0,0,1497
220,5,0,5,20,5383200,3595,0,0,1502
221,2,0,4,21,5399100,3599,0,0,1504
222,3,0,3,22,5422620,3605,0,0,1507
223,8,0,7,18,5427540,3599,0,0,1515
224,7,0,7,18,5451480,3598,0,0,1522
225,4,0,6,19,5473920,3601,0,0,1526
226,8,0,8,17,5499660,3603,0,0,1534
227,7,0,5,20,5536860,3604,0,0,1541
228,7,0,8,17,5547000,3601,0,0,1548
229,9,0,10,15,5573580,3602,0,0,1557
230,19,0,18,7,5608500,3599,0,0,1576
231,19,0,19,6,5665620,3594,0,0,1595
232,8,0,13,12,5735880,3607,0,0,1603
233,10,0,7,18,5795040,3608,0,0,1613
234,7,0,5,20,5818560,3602,0,0,1620
235,5,0,6,19,5830020,3601,0,0,1625
236,2,0,4,21,5852940,3606,0,0,1627
237,7,0,5,20,5877420,3607,0,0,1634
238,5,0,5,20,5888820,3603,0,0,1639
239,6,0,4,21,5911740,3602,0,0,1645
240,7,0,4,21,5934180,3600,0,0,1652
241,2,0,1,24,5953080,3601,0,0,1654
242,4,0,5,20,5953080,3601,0,0,1658
243,7,0,10,15,5954940,3598,0,0,1665
244,3,0,4,21,5996280,3603,0,0,1668
245,7,0,4,21,6017520,3601,0,0,1675
246,6,0,4,21,6032880,3597,0,0,1681
247,4,0,4,21,6045000,3596,0,0,1685
248,8,0,9,16,6048180,3591,0,0,1693
249,6,0,9,16,6080520,3597,0,0,1699
250,7,0,9,16,6114120,3602,0,0,1706
251,10,0,10,15,6136620,3597,0,0,1716
252,11,0,9,16,6182220,3598,0,0,1727
253,17,0,19,6,6200100,3594,0,0,1744
254,8,0,14,11,6251700,3597,0,0,1752
255,12,0,13,12,6307740,3602,0,0,1764
256,11,0,9,16,6367320,3605,0,0,1775
257,10,0,11,14,6402420,3609,0,0,1785
258,7,0,5,20,6448440,3608,0,0,1792
259,8,0,7,18,6474600,3611,0,0,1800
260,8,0,9,16,6492780,3609,0,0,1808
261,7,0,9,16,6524100,3612,0,0,1815
262,5,0,8,17,6550080,3614,0,0,1820
263,2,0,5,20,6576120,3619,0,0,1822
264,7,0,7,18,6597240,3620,0,0,1829
265,6,0,8,17,6616920,3621,0,0,1835
266,5,0,6,19,6642660,3621,0,0,1840
267,3,0,3,22,6667500,3623,0,0,1843
268,9,0,8,17,6684960,3625,0,0,1852
269,8,0,8,17,6705900,3620,0,0,1860
270,5,0,8,17,6735420,3627,0,0,1865
271,4,0,8,17,6754440,3629,0,0,1869
272,6,0,6,19,6788520,3632,0,0,1875
273,8,0,8,17,6816240,3635,0,0,1883
274,8,0,13,12,6826020,3634,0,0,1891
275,14,0,14,11,6888720,3642,0,0,1905
276,8,0,13,12,6938040,3651,0,0,1913
277,11,0,8,17,6987420,3646,0,0,1924
278,10,0,10,15,7036680,3657,0,0,1934
279,6,0,6,19,7066560,3653,0,0,1940
280,10,0,9,16,7088220,3651,0,0,1950
281,1,0,4,21,7124580,3659,0,0,1951
282,5,0,5,20,7148880,3664,0,0,1956
283,6,0,7,18,7162620,3663,0,0,1962
284,11,0,12,13,7172460,3657,0,0,1973
285,7,0,7,18,7230900,3664,0,0,1980
286,2,0,4,21,7252740,3666,0,0,1982
287,6,0,7,18,7265160,3667,0,0,1988
288,8,0,7,18,7305780,3673,0,0,1996
289,6,0,5,20,7325640,3668,0,0,2002
290,1,0,2,23,7348860,3672,0,0,2003
291,3,0,2,23,7358580,3671,0,0,2006
292,7,0,5,20,7368540,3669,0,0,2013
293,2,0,4,21,7380960,3670,0,0,2015
294,2,0,4,21,7398180,3675,0,0,2017
295,9,0,7,18,7412640,3671,0,0,2026
296,3,0,6,19,7427280,3671,0,0,2029
297,13,0,9,16,7464720,3671,0,0,2042
298,13,0,11,14,7489020,3663,0,0,2055
299,7,0,6,19,7523880,3659,0,0,2062
300,7,0,9,16,7539180,3659,0,0,2069
301,11,0,11,14,7568940,3658,0,0,2080
302,8,0,10,15,7603860,3659,0,0,2088
303,5,0,7,18,7636800,3660,0,0,2093
304,9,0,8,17,7673400,3664,0,0,2102
305,13,0,12,13,7691160,3657,0,0,2115
306,11,0,8,17,7737960,3653,0,0,2126
307,6,0,7,18,7766040,3654,0,0,2132
308,5,0,6,19,7780440,3651,0,0,2137
309,4,0,5,20,7804080,3653,0,0,2141
310,3,0,2,23,7827960,3654,0,0,2144
311,5,0,6,19,7833300,3655,0,0,2149
312,4,0,6,19,7846440,3654,0,0,2153
313,6,0,8,17,7863000,3655,0,0,2159
314,3,0,4,21,7894260,3658,0,0,2162
315,3,0,2,23,7909680,3656,0,0,2165
316,9,0,7,18,7923060,3656,0,0,2174
317,1,0,1,24,7949460,3656,0,0,2175
318,6,0,3,22,7958760,3654,0,0,2181
319,12,0,12,13,7964520,3651,0,0,2193
320,8,0,7,18,8004960,3648,0,0,2201
321,9,0,10,15,8022240,3646,0,0,2210
322,10,0,12,13,8050200,3645,0,0,2220
323,8,0,11,14,8102100,3654,0,0,2228
324,11,0,11,14,8130960,3649,0,0,2239
325,15,0,11,14,8184840,3649,0,0,2254
326,4,0,5,20,8229120,3652,0,0,2258
327,8,0,9,16,8245740,3653,0,0,2266
328,12,0,10,15,8292300,3656,0,0,2278
329,9,0,8,17,8324040,3652,0,0,2287
330,7,0,10,15,8340780,3651,0,0,2294
331,5,0,6,19,8388000,3658,0,0,2299
332,8,0,9,16,8403360,3656,0,0,2307
333,6,0,9,16,8426580,3657,0,0,2313
334,5,0,6,19,8466060,3661,0,0,2318
335,2,0,2,23,8492640,3663,0,0,2320
336,2,0,2,23,8504460,3665,0,0,2322
337,4,0,4,21,8505420,3662,0,0,2326
338,7,0,7,18,8510040,3658,0,0,2333
339,6,0,6,19,8537940,3659,0,0,2339
340,4,0,4,21,8558880,3659,0,0,2343
341,5,0,4,21,8577000,3659,0,0,2348
342,4,0,4,21,8593620,3659,0,0,2352
343,11,0,10,15,8607900,3658,0,0,2363
344,10,0,8,17,8641080,3653,0,0,2373
345,8,0,9,16,8676660,3657,0,0,2381
346,8,0,8,17,8703900,3655,0,0,2389
347,9,0,6,19,8742600,3654,0,0,2398
348,11,0,6,19,8763780,3647,0,0,2409
349,5,0,5,20,8779200,3644,0,0,2414
350,6,0,6,19,8801940,3646,0,0,2420
351,6,0,8,17,8809020,3643,0,0,2426
352,6,0,8,17,8828280,3642,0,0,2432
353,12,0,9,16,8867760,3641,0,0,2444
354,6,0,8,17,8896800,3643,0,0,2450
355,5,0,6,19,8927700,3645,0,0,2455
356,8,0,8,17,8940240,3641,0,0,2463
357,6,0,4,21,8981880,3643,0,0,2469
358,7,0,5,20,9002280,3643,0,0,2476
359,6,0,7,18,9015240,3642,0,0,2482
360,7,0,8,17,9033420,3641,0,0,2489
361,2,0,4,21,9062340,3643,0,0,2491
362,2,0,3,22,9077400,3645,0,0,2493
363,4,0,3,22,9090960,3645,0,0,2497
364,8,0,8,17,9097080,3643,0,0,2505
365,6,0,4,21,9122520,3638,0,0,2511
366,9,0,7,18,9141660,3637,0,0,2520
367,12,0,11,14,9164700,3635,0,0,2532
368,10,0,13,12,9202860,3638,0,0,2542
369,8,0,10,15,9236760,3636,0,0,2550
370,5,0,6,19,9281940,3641,0,0,2555
371,10,0,7,18,9312540,3640,0,0,2565
372,14,0,13,12,9328200,3635,0,0,2579
373,10,0,12,13,9368100,3635,0,0,2589
374,9,0,6,19,9433080,3639,0,0,2598
375,5,0,8,17,9442320,3638,0,0,2603
376,8,0,8,17,9482520,3642,0,0,2611
377,6,0,10,15,9493380,3641,0,0,2617
378,11,0,11,14,9530700,3641,0,0,2628
379,6,0,10,15,9568920,3646,0,0,2634
380,1,0,5,20,9606240,3652,0,0,2635
381,5,0,1,24,9649140,3656,0,0,2640
382,2,0,3,22,9649140,3656,0,0,2642
383,3,0,3,22,9657120,3655,0,0,2645
384,5,0,7,18,9660960,3655,0,0,2650
385,3,0,4,21,9687240,3656,0,0,2653
386,1,0,3,22,9693000,3656,0,0,2654
387,3,0,1,24,9714960,3657,0,0,2657
388,4,0,3,22,9721080,3657,0,0,2661
389,7,0,6,19,9728160,3654,0,0,2668
390,4,0,6,19,9746940,3656,0,0,2672
391,7,0,7,18,9768540,3655,0,0,2679
392,6,0,7,18,9790260,3655,0,0,2685
393,8,0,8,17,9812640,3654,0,0,2693
394,8,0,5,20,9858480,3656,0,0,2701
395,5,0,6,19,9877260,3658,0,0,2706
396,7,0,7,18,9899340,3658,0,0,2713
397,12,0,12,13,9920940,3656,0,0,2725
398,9,0,7,18,9957900,3651,0,0,2734
399,6,0,9,16,9982800,3655,0,0,2740
400,11,0,8,17,10024980,3654,0,0,2751
401,9,0,8,17,10055820,3654,0,0,2760
402,6,0,9,16,10070880,3652,0,0,2766
403,5,0,5,20,10116420,3657,0,0,2771
404,8,0,8,17,10136940,3658,0,0,2779
405,5,0,5,20,10164180,3657,0,0,2784
406,10,0,9,16,10181520,3655,0,0,2794
407,5,0,6,19,10217640,3658,0,0,2799
408,4,0,5,20,10240140,3659,0,0,2803
409,7,0,6,19,10266180,3661,0,0,2810
410,4,0,3,22,10293900,3662,0,0,2814
411,5,0,5,20,10304280,3661,0,0,2819
412,5,0,4,21,10325520,3661,0,0,2824
413,4,0,3,22,10334160,3658,0,0,2828
414,7,0,6,19,10346580,3657,0,0,2835
415,8,0,7,18,10359900,3652,0,0,2843
416,7,0,6,19,10389120,3652,0,0,2850
417,8,0,11,14,10400880,3653,0,0,2858
418,9,0,10,15,10438560,3653,0,0,2867
419,8,0,10,15,10482840,3658,0,0,2875
420,7,0,6,19,10526100,3659,0,0,2882
421,9,0,8,17,10552560,3660,0,0,2891
422,6,0,7,18,10578600,3660,0,0,2897
423,4,0,5,20,10607160,3662,0,0,2901
424,10,0,5,20,10639320,3661,0,0,2911
425,9,0,10,15,10645800,3658,0,0,2920
426,5,0,6,19,10676220,3657,0,0,2925
427,6,0,7,18,10699740,3659,0,0,2931
428,3,0,5,20,10717320,3659,0,0,2934
429,7,0,6,19,10741920,3659,0,0,2941
430,7,0,6,19,10760820,3657,0,0,2948
431,5,0,6,19,10786620,3660,0,0,2953
432,6,0,5,20,10807860,3658,0,0,2959
433,3,0,5,20,10813440,3656,0,0,2962
434,7,0,8,17,10828860,3657,0,0,2969
435,5,0,6,19,10850100,3655,0,0,2974
436,8,0,7,18,10879440,3656,0,0,2982
437,5,0,6,19,10908900,3659,0,0,2987
438,7,0,7,18,10935300,3660,0,0,2994
439,10,0,10,15,10955520,3659,0,0,3004
440,4,0,10,15,10973520,3660,0,0,3008
441,11,0,12,13,11013600,3662,0,0,3019
442,10,0,10,15,11076240,3668,0,0,3029
443,5,0,11,14,11099280,3671,0,0,3034
444,10,0,9,16,11159880,3677,0,0,3044
445,14,0,14,11,11184900,3674,0,0,3058
446,13,0,13,12,11241660,3676,0,0,3071
447,9,0,10,15,11275260,3672,0,0,3080
448,9,0,10,15,11320320,3676,0,0,3089
449,3,0,7,18,11355000,3680,0,0,3092
450,11,0,12,13,11387100,3683,0,0,3103
451,6,0,7,18,11424900,3683,0,0,3109
452,4,0,4,21,11452200,3683,0,0,3113
453,8,0,7,18,11465340,3681,0,0,3121
454,5,0,7,18,11480640,3680,0,0,3126
455,1,0,0,25,11510040,3680,0,0,3127
456,5,0,3,22,11512020,3679,0,0,3132
457,4,0,3,22,11518500,3676,0,0,3136
458,4,0,3,22,11531160,3675,0,0,3140
459,2,0,2,23,11536800,3674,0,0,3142
460,3,0,5,20,11536800,3674,0,0,3145
461,8,0,9,16,11558280,3676,0,0,3153
462,8,0,6,19,11596920,3675,0,0,3161
463,10,0,8,17,11613300,3671,0,0,3171
464,5,0,7,18,11638500,3672,0,0,3176
465,3,0,5,20,11666700,3675,0,0,3179
466,12,0,7,18,11695980,3673,0,0,3191
467,4,0,8,17,11708340,3673,0,0,3195
468,9,0,6,19,11740680,3671,0,0,3204
469,7,0,6,19,11774400,3673,0,0,3211
470,5,0,6,19,11787600,3672,0,0,3216
471,6,0,5,20,11809800,3671,0,0,3222
472,6,0,4,21,11828940,3669,0,0,3228
473,3,0,1,24,11854080,3669,0,0,3231
474,8,0,6,19,11858820,3668,0,0,3239
475,9,0,7,18,11875980,3664,0,0,3248
476,3,0,5,20,11895180,3664,0,0,3251
477,7,0,8,17,11916120,3666,0,0,3258
478,6,0,9,16,11934420,3666,0,0,3264
479,5,0,5,20,11980560,3670,0,0,3269
480,4,0,5,20,11995500,3670,0,0,3273
481,4,0,4,21,12015060,3670,0,0,3277
482,3,0,5,20,12028800,3672,0,0,3280
483,0,0,1,24,12044160,3673,0,0,3280
484,3,0,3,22,12051000,3674,0,0,3283
485,5,0,3,22,12061380,3671,0,0,3288
486,3,0,3,22,12067080,3670,0,0,3291
487,6,0,6,19,12078120,3670,0,0,3297
488,7,0,10,15,12085740,3669,0,0,3304
489,10,0,9,16,12129300,3669,0,0,3314
490,12,0,11,14,12151500,3665,0,0,3326
491,7,0,7,18,12201600,3668,0,0,3333
492,8,0,9,16,12219720,3667,0,0,3341
493,9,0,5,20,12249420,3662,0,0,3350
494,13,0,11,14,12267120,3659,0,0,3363
495,8,0,11,14,12294240,3659,0,0,3371
496,6,0,6,19,12335460,3659,0,0,3377
497,7,0,7,18,12349980,3657,0,0,3384
498,3,0,5,20,12377520,3659,0,0,3387
499,9,0,9,16,12408540,3663,0,0,3396
500,8,0,6,19,12436500,3659,0,0,3404
501,10,0,8,17,12462000,3658,0,0,3414
502,5,0,10,15,12478260,3660,0,0,3419
503,2,0,5,20,12519120,3664,0,0,3421
504,4,0,4,21,12541320,3665,0,0,3425
505,4,0,4,21,12559080,3666,0,0,3429
506,4,0,7,18,12559980,3666,0,0,3433
507,7,0,6,19,12594480,3667,0,0,3440
508,4,0,4,21,12615600,3667,0,0,3444
509,1,0,2,23,12630240,3668,0,0,3445
510,5,0,3,22,12648600,3669,0,0,3450
511,8,0,7,18,12658860,3668,0,0,3458
512,8,0,9,16,12679080,3667,0,0,3466
513,15,0,11,14,12714360,3664,0,0,3481
514,6,0,9,16,12748140,3665,0,0,3487
515,5,0,6,19,12790920,3669,0,0,3492
516,8,0,6,19,12810240,3666,0,0,3500
517,14,0,11,14,12840420,3665,0,0,3514
518,6,0,6,19,12890160,3668,0,0,3520
519,10,0,9,16,12911100,3666,0,0,3530
520,11,0,13,12,12941040,3668,0,0,3541
521,9,0,11,14,12993000,3671,0,0,3550
522,4,0,5,20,13033860,3672,0,0,3554
523,8,0,8,17,13054440,3673,0,0,3562
524,7,0,8,17,13087020,3675,0,0,3569
525,8,0,6,19,13119300,3673,0,0,3577
526,3,0,6,19,13126140,3672,0,0,3580
527,2,0,3,22,13161240,3677,0,0,3582
528,5,0,5,20,13170840,3676,0,0,3587
529,4,0,5,20,13183860,3676,0,0,3591
530,10,0,11,14,13191360,3674,0,0,3601
531,5,0,11,14,13216560,3676,0,0,3606
532,3,0,6,19,13257600,3679,0,0,3609
533,7,0,5,20,13284180,3678,0,0,3616
534,5,0,6,19,13300320,3679,0,0,3621
535,11,0,8,17,13326780,3677,0,0,3632
536,6,0,9,16,13345320,3677,0,0,3638
537,7,0,6,19,13390260,3679,0,0,3645
538,10,0,8,17,13406220,3675,0,0,3655
539,10,0,9,16,13433400,3674,0,0,3665
540,9,0,8,17,13479540,3676,0,0,3674
541,12,0,10,15,13516140,3676,0,0,3686
542,6,0,9,16,13544460,3677,0,0,3692
543,5,0,4,21,13586520,3678,0,0,3697
544,7,0,6,19,13602780,3678,0,0,3704
545,6,0,5,20,13628400,3678,0,0,3710
546,4,0,7,18,13640820,3679,0,0,3714
547,9,0,5,20,13677000,3678,0,0,3723
548,11,0,13,12,13681080,3676,0,0,3734
549,3,0,5,20,13722960,3677,0,0,3737
550,3,0,4,21,13754340,3681,0,0,3740
551,1,0,3,22,13767660,3683,0,0,3741
552,7,0,8,17,13771440,3682,0,0,3748
553,4,0,6,19,13799040,3683,0,0,3752
554,7,0,5,20,13833360,3684,0,0,3759
555,10,0,0,25,13861860,3677,0,0,3769
556,4,0,3,22,13862640,3677,0,0,3773
557,4,0,3,22,13874880,3676,0,0,3777
558,7,0,6,19,13880160,3673,0,0,3784
559,7,0,5,20,13905840,3672,0,0,3791
560,6,0,5,20,13928100,3673,0,0,3797
561,9,0,10,15,13939680,3672,0,0,3806
562,3,0,9,16,13964220,3674,0,0,3809
563,9,0,11,14,13995780,3676,0,0,3818
564,13,0,13,12,14038920,3677,0,0,3831
565,9,0,9,16,14080980,3675,0,0,3840
566,10,0,8,17,14121900,3675,0,0,3850
567,13,0,15,10,14134560,3673,0,0,3863
568,11,0,13,12,14192700,3675,0,0,3874
569,3,0,8,17,14238480,3680,0,0,3877
570,4,0,6,19,14277180,3684,0,0,3881
571,8,0,9,16,14293080,3683,0,0,3889
572,4,0,6,19,14329860,3686,0,0,3893
573,3,0,4,21,14361660,3690,0,0,3896
574,3,0,1,24,14376480,3688,0,0,3899
575,8,0,6,19,14387760,3688,0,0,3907
576,3,0,5,20,14401200,3687,0,0,3910
577,3,0,6,19,14407200,3687,0,0,3913
578,6,0,6,19,14440380,3690,0,0,3919
579,1,0,0,25,14453040,3687,0,0,3920
580,3,0,1,24,14457240,3686,0,0,3923
581,12,0,10,15,14461140,3684,0,0,3935
582,5,0,6,19,14489280,3683,0,0,3940
583,10,0,8,17,14518620,3683,0,0,3950
584,4,0,6,19,14532180,3680,0,0,3954
585,5,0,6,19,14556660,3682,0,0,3959
586,6,0,5,20,14591340,3684,0,0,3965
587,17,0,15,10,14606400,3681,0,0,3982
588,7,0,10,15,14658420,3683,0,0,3989
589,10,0,11,14,14697240,3685,0,0,3999
590,7,0,9,16,14736240,3686,0,0,4006
591,11,0,9,16,14771580,3685,0,0,4017
592,7,0,6,19,14805840,3684,0,0,4024
593,7,0,6,19,14825700,3683,0,0,4031
594,5,0,6,19,14839800,3682,0,0,4036
595,10,0,6,19,14876940,3682,0,0,4046
596,11,0,7,18,14916180,3683,0,0,4057
597,5,0,6,19,14929740,3680,0,0,4062
598,1,0,2,23,14954340,3682,0,0,4063
599,2,0,1,24,14968560,3683,0,0,4065
600,3,0,3,22,14969580,3682,0,0,4068
601,4,0,4,21,14975820,3681,0,0,4072
602,4,0,5,20,14992980,3682,0,0,4076
603,4,0,2,23,15012660,3681,0,0,4080
604,5,0,3,22,15023100,3680,0,0,4085
605,7,0,7,18,15025380,3678,0,0,4092
606,9,0,8,17,15048720,3676,0,0,4101
607,6,0,11,14,15060720,3676,0,0,4107
608,8,0,10,15,15093180,3676,0,0,4115
609,6,0,7,18,15145620,3681,0,0,4121
610,5,0,4,21,15172320,3680,0,0,4126
611,9,0,9,16,15182580,3679,0,0,4135
612,10,0,14,11,15199740,3679,0,0,4145
613,7,0,7,18,15255600,3680,0,0,4152
614,10,0,13,12,15281700,3683,0,0,4162
615,14,0,11,14,15335460,3681,0,0,4176
616,6,0,9,16,15373920,3684,0,0,4182
617,8,0,7,18,15406680,3683,0,0,4190
618,8,0,6,19,15440940,3683,0,0,4198
619,8,0,6,19,15457380,3680,0,0,4206
620,5,0,5,20,15472380,3678,0,0,4211
621,5,0,4,21,15485220,3676,0,0,4216
622,5,0,4,21,15513840,3678,0,0,4221
623,2,0,3,22,15525720,3679,0,0,4223
624,4,0,4,21,15542520,3680,0,0,4227
625,5,0,7,18,15546720,3679,0,0,4232
626,6,0,5,20,15575520,3679,0,0,4238
627,6,0,6,19,15592980,3679,0,0,4244
628,7,0,8,17,15609840,3678,0,0,4251
629,3,0,3,22,15644220,3680,0,0,4254
630,8,0,9,16,15655080,3680,0,0,4262
631,4,0,3,22,15679860,3678,0,0,4266
632,7,0,5,20,15694740,3677,0,0,4273
633,8,0,7,18,15710580,3675,0,0,4281
634,10,0,10,15,15728040,3673,0,0,4291
635,9,0,10,15,15761580,3674,0,0,4300
636,13,0,11,14,15803040,3673,0,0,4313
637,4,0,8,17,15826200,3672,0,0,4317
638,5,0,4,21,15865620,3674,0,0,4322
639,12,0,10,15,15889860,3674,0,0,4334
640,5,0,6,19,15912300,3672,0,0,4339
641,11,0,9,16,15943140,3672,0,0,4350
642,10,0,7,18,15975540,3670,0,0,4360
643,5,0,5,20,16007580,3671,0,0,4365
644,8,0,3,22,16038180,3670,0,0,4373
645,3,0,3,22,16052460,3670,0,0,4376
646,4,0,4,21,16060440,3670,0,0,4380
647,3,0,3,22,16074360,3669,0,0,4383
648,3,0,2,23,16089360,3670,0,0,4386
649,3,0,2,23,16098420,3669,0,0,4389
650,8,0,6,19,16103280,3667,0,0,4397
651,3,0,1,24,16128000,3666,0,0,4400
652,2,0,1,24,16135020,3666,0,0,4402
653,4,0,4,21,16135860,3665,0,0,4406
654,7,0,6,19,16151160,3664,0,0,4413
655,6,0,6,19,16167540,3663,0,0,4419
656,6,0,10,15,16175100,3663,0,0,4425
657,10,0,11,14,16213620,3664,0,0,4435
658,9,0,9,16,16248900,3663,0,0,4444
659,9,0,12,13,16279620,3665,0,0,4453
660,8,0,11,14,16315260,3666,0,0,4461
661,7,0,7,18,16360320,3667,0,0,4468
662,6,0,5,20,16396140,3668,0,0,4474
663,10,0,7,18,16411560,3665,0,0,4484
664,11,0,9,16,16436280,3663,0,0,4495
665,10,0,6,19,16477620,3662,0,0,4505
666,6,0,3,22,16501980,3660,0,0,4511
667,2,0,3,22,16512600,3661,0,0,4513
668,8,0,7,18,16523700,3660,0,0,4521
669,5,0,6,19,16542780,3659,0,0,4526
670,3,0,4,21,16571580,3662,0,0,4529
671,1,0,2,23,16590060,3663,0,0,4530
672,4,0,5,20,16595700,3664,0,0,4534
673,3,0,5,20,16599780,3662,0,0,4537
674,5,0,10,15,16599780,3662,0,0,4542
675,4,0,12,13,16602480,3661,0,0,4546
676,4,0,9,16,16647000,3665,0,0,4550
677,7,0,12,13,16663560,3666,0,0,4557
678,1,0,8,17,16683420,3666,0,0,4558
679,12,0,13,12,16712400,3667,0,0,4570
680,9,0,15,10,16731300,3665,0,0,4579
681,12,0,14,11,16771980,3664,0,0,4591
682,11,0,19,6,16799520,3665,0,0,4602
683,13,0,12,13,16878240,3666,0,0,4615
684,8,0,12,13,16905960,3666,0,0,4623
685,12,0,14,11,16930020,3663,0,0,4635
686,3,0,12,13,16961880,3666,0,0,4638
687,7,0,12,13,16998540,3669,0,0,4645
688,7,0,13,12,17018400,3668,0,0,4652
689,7,0,11,14,17049060,3668,0,0,4659
690,3,0,9,16,17070960,3668,0,0,4662
691,11,0,17,8,17082000,3668,0,0,4673
692,3,0,11,14,17121540,3670,0,0,4676
693,10,0,12,13,17167200,3672,0,0,4686
694,6,0,11,14,17187360,3671,0,0,4692
695,4,0,8,17,17216400,3672,0,0,4696
696,4,0,9,16,17229600,3672,0,0,4700
697,4,0,9,16,17246220,3673,0,0,4704
698,1,0,10,15,17246220,3673,0,0,4705
699,4,0,8,17,17282820,3676,0,0,4709
700,9,0,8,17,17301000,3673,0,0,4718
701,8,0,10,15,17319360,3672,0,0,4726
702,5,0,8,17,17343840,3672,0,0,4731
703,8,0,13,12,17357280,3672,0,0,4739
704,10,0,15,10,17388600,3673,0,0,4749
705,9,0,13,12,17420460,3671,0,0,4758
706,10,0,14,11,17454960,3671,0,0,4768
707,10,0,13,12,17482320,3668,0,0,4778
708,12,0,14,11,17523900,3669,0,0,4790
709,11,0,15,10,17559000,3668,0,0,4801
710,10,0,18,7,17587320,3669,0,0,4811
711,9,0,15,10,17636040,3670,0,0,4820
712,13,0,16,9,17689740,3672,0,0,4833
713,6,0,11,14,17740140,3674,0,0,4839
714,8,0,16,9,17751060,3674,0,0,4847
715,9,0,11,14,17806200,3675,0,0,4856
716,6,0,9,16,17825040,3672,0,0,4862
717,6,0,10,15,17842860,3672,0,0,4868
718,3,0,8,17,17868480,3674,0,0,4871
719,7,0,12,13,17873820,3673,0,0,4878
720,5,0,8,17,17899620,3671,0,0,4883
721,5,0,5,20,17923560,3670,0,0,4888
722,2,0,5,20,17926680,3669,0,0,4890
723,6,0,11,14,17926680,3669,0,0,4896
724,5,0,10,15,17940840,3668,0,0,4901
725,6,0,12,13,17949480,3666,0,0,4907
726,3,0,5,20,17983680,3666,0,0,4910
727,9,0,11,14,17995560,3666,0,0,4919
728,6,0,11,14,18013560,3665,0,0,4925
729,11,0,14,11,18034980,3664,0,0,4936
730,12,0,16,9,18078780,3665,0,0,4948
731,7,0,15,10,18103380,3664,0,0,4955
732,8,0,11,14,18143700,3663,0,0,4963
733,11,0,17,8,18163980,3664,0,0,4974
734,9,0,17,8,18196920,3664,0,0,4983
735,9,0,11,14,18255540,3665,0,0,4992
736,8,0,12,13,18282660,3665,0,0,5000
737,10,0,13,12,18309840,3664,0,0,5010
738,5,0,12,13,18335280,3664,0,0,5015
739,12,0,13,12,18381420,3666,0,0,5027
740,7,0,12,13,18414720,3666,0,0,5034
741,4,0,11,14,18433140,3666,0,0,5038
742,5,0,11,14,18464280,3669,0,0,5043
743,3,0,10,15,18486060,3670,0,0,5046
744,7,0,9,16,18525420,3672,0,0,5053
745,4,0,9,16,18530280,3670,0,0,5057
746,4,0,7,18,18551520,3670,0,0,5061
747,3,0,6,19,18567480,3670,0,0,5064
748,1,0,5,20,18568680,3669,0,0,5065
749,8,0,11,14,18576060,3669,0,0,5073
750,9,0,11,14,18599940,3667,0,0,5082
751,6,0,11,14,18617100,3666,0,0,5088
752,11,0,15,10,18643500,3667,0,0,5099
753,9,0,16,9,18673320,3667,0,0,5108
754,12,0,19,6,18720540,3669,0,0,5120
755,19,0,19,6,18793140,3670,0,0,5139
756,9,0,17,8,18829920,3669,0,0,5148
757,11,0,15,10,18880860,3670,0,0,5159
758,9,0,10,15,18926040,3669,0,0,5168
759,13,0,16,9,18949740,3668,0,0,5181
760,3,0,11,14,18979860,3669,0,0,5184
761,5,0,8,17,19018620,3670,0,0,5189
762,5,0,9,16,19027920,3669,0,0,5194
763,9,0,11,14,19053300,3669,0,0,5203
764,6,0,8,17,19082760,3669,0,0,5209
765,6,0,12,13,19093500,3669,0,0,5215
766,3,0,9,16,19118940,3670,0,0,5218
767,5,0,7,18,19146420,3670,0,0,5223
768,4,0,10,15,19149420,3670,0,0,5227
769,6,0,10,15,19177620,3671,0,0,5233
770,2,0,7,18,19192620,3671,0,0,5235
771,4,0,8,17,19211160,3672,0,0,5239
772,6,0,9,16,19223520,3671,0,0,5245
773,4,0,10,15,19228080,3670,0,0,5249
774,12,0,14,11,19257240,3670,0,0,5261
775,9,0,13,12,19284600,3668,0,0,5270
776,9,0,14,11,19315080,3668,0,0,5279
777,9,0,13,12,19353960,3668,0,0,5288
778,6,0,11,14,19380300,3668,0,0,5294
779,8,0,10,15,19404300,3666,0,0,5302
780,11,0,15,10,19432320,3667,0,0,5313
781,10,0,13,12,19471500,3666,0,0,5323
782,14,0,16,9,19501800,3665,0,0,5337
783,11,0,11,14,19548720,3662,0,0,5348
784,6,0,12,13,19570680,3663,0,0,5354
785,17,0,17,8,19610880,3662,0,0,5371
786,8,0,10,15,19654380,3660,0,0,5379
787,10,0,13,12,19679220,3660,0,0,5389
788,8,0,12,13,19702020,3658,0,0,5397
789,6,0,8,17,19735920,3658,0,0,5403
790,6,0,12,13,19737600,3657,0,0,5409
791,2,0,7,18,19773900,3659,0,0,5411
792,5,0,11,14,19776780,3658,0,0,5416
793,5,0,10,15,19800240,3659,0,0,5421
794,8,0,12,13,19821960,3659,0,0,5429
795,3,0,9,16,19849020,3660,0,0,5432
796,7,0,8,17,19872960,3659,0,0,5439
797,10,0,12,13,19882800,3656,0,0,5449
798,6,0,8,17,19917540,3656,0,0,5455
799,4,0,7,18,19937040,3656,0,0,5459
800,9,0,13,12,19939860,3655,0,0,5468
801,5,0,12,13,19961820,3655,0,0,5473
802,11,0,15,10,19992300,3655,0,0,5484
803,4,0,7,18,20030160,3654,0,0,5488
804,10,0,13,12,20040840,3653,0,0,5498
805,11,0,16,9,20067780,3653,0,0,5509
806,8,0,15,10,20111520,3655,0,0,5517
807,11,0,17,8,20143440,3655,0,0,5528
808,6,0,14,11,20177040,3655,0,0,5534
809,7,0,13,12,20234340,3660,0,0,5541
810,5,0,10,15,20264520,3660,0,0,5546
811,4,0,9,16,20285400,3660,0,0,5550
812,6,0,10,15,20312400,3662,0,0,5556
813,4,0,10,15,20324280,3662,0,0,5560
814,4,0,8,17,20352300,3663,0,0,5564
815,5,0,8,17,20364780,3662,0,0,5569
816,7,0,11,14,20379300,3662,0,0,5576
817,4,0,13,12,20384100,3661,0,0,5580
818,5,0,11,14,20418000,3663,0,0,5585
819,3,0,8,17,20451120,3665,0,0,5588
820,4,0,9,16,20462100,3665,0,0,5592
821,5,0,10,15,20482140,3666,0,0,5597
822,9,0,14,11,20497500,3665,0,0,5606
823,6,0,7,18,20554620,3667,0,0,5612
824,7,0,11,14,20562360,3666,0,0,5619
825,10,0,13,12,20587740,3665,0,0,5629
826,4,0,7,18,20624700,3665,0,0,5633
827,6,0,10,15,20637120,3666,0,0,5639
828,7,0,13,12,20645280,3665,0,0,5646
829,12,0,15,10,20679540,3664,0,0,5658
830,13,0,14,11,20720820,3662,0,0,5671
831,6,0,11,14,20760420,3664,0,0,5677
832,7,0,12,13,20790720,3665,0,0,5684
833,6,0,12,13,20807580,3664,0,0,5690
834,10,0,13,12,20844960,3665,0,0,5700
835,5,0,10,15,20877240,3665,0,0,5705
836,6,0,10,15,20898900,3665,0,0,5711
837,7,0,12,13,20917200,3665,0,0,5718
838,3,0,9,16,20940840,3666,0,0,5721
839,4,0,7,18,20968080,3667,0,0,5725
840,2,0,8,17,20972820,3667,0,0,5727
841,5,0,9,16,20985780,3666,0,0,5732
842,3,0,9,16,20992620,3666,0,0,5735
843,5,0,9,16,21014280,3666,0,0,5740
844,5,0,7,18,21039060,3666,0,0,5745
845,4,0,8,17,21049140,3666,0,0,5749
846,6,0,7,18,21071340,3665,0,0,5755
847,5,0,10,15,21073200,3664,0,0,5760
848,4,0,11,14,21084300,3664,0,0,5764
849,7,0,10,15,21113820,3664,0,0,5771
850,9,0,11,14,21141360,3664,0,0,5780
851,4,0,12,13,21151560,3664,0,0,5784
852,8,0,11,14,21196260,3666,0,0,5792
853,4,0,9,16,21215640,3666,0,0,5796
854,8,0,13,12,21240780,3667,0,0,5804
855,8,0,13,12,21265140,3667,0,0,5812
856,10,0,11,14,21299640,3665,0,0,5822
857,6,0,9,16,21332340,3665,0,0,5828
858,9,0,14,11,21349380,3666,0,0,5837
859,6,0,12,13,21380460,3666,0,0,5843
860,8,0,13,12,21409140,3667,0,0,5851
861,5,0,13,12,21427860,3667,0,0,5856
862,1,0,6,19,21470640,3669,0,0,5857
863,1,0,4,21,21484680,3670,0,0,5858
864,4,0,7,18,21485700,3669,0,0,5862
865,0,0,5,20,21495060,3669,0,0,5862
866,1,0,5,20,21500580,3670,0,0,5863
867,5,0,10,15,21500580,3670,0,0,5868
868,4,0,7,18,21515940,3668,0,0,5872
869,9,0,11,14,21531240,3668,0,0,5881
870,2,0,6,19,21555780,3667,0,0,5883
871,5,0,7,18,21564240,3666,0,0,5888
872,5,0,7,18,21585540,3667,0,0,5893
873,4,0,7,18,21595140,3666,0,0,5897
874,6,0,10,15,21602220,3665,0,0,5903
875,8,0,11,14,21623760,3665,0,0,5911
876,9,0,15,10,21636180,3664,0,0,5920
877,14,0,19,6,21678600,3665,0,0,5934
878,11,0,20,5,21717780,3665,0,0,5945
879,6,0,11,14,21780480,3666,0,0,5951
880,6,0,7,18,21826260,3668,0,0,5957
881,6,0,7,18,21837480,3666,0,0,5963
882,6,0,9,16,21843120,3664,0,0,5969
883,12,0,16,9,21857820,3664,0,0,5981
884,11,0,18,7,21888720,3663,0,0,5992
885,3,0,12,13,21931260,3665,0,0,5995
886,2,0,6,19,21984000,3669,0,0,5997
887,9,0,11,14,21994080,3668,0,0,6006
888,3,0,10,15,22007460,3668,0,0,6009
889,3,0,7,18,22030140,3668,0,0,6012
890,5,0,10,15,22038360,3668,0,0,6017
891,2,0,9,16,22055880,3669,0,0,6019
892,10,0,11,14,22084140,3669,0,0,6029
893,5,0,11,14,22107420,3670,0,0,6034
894,8,0,14,11,22124820,3670,0,0,6042
895,4,0,7,18,22156020,3668,0,0,6046
896,8,0,13,12,22165920,3669,0,0,6054
897,8,0,14,11,22192260,3669,0,0,6062
898,6,0,11,14,22231800,3670,0,0,6068
899,10,0,12,13,22258560,3669,0,0,6078
900,7,0,12,13,22272840,3667,0,0,6085
901,9,0,12,13,22307760,3667,0,0,6094
902,6,0,9,16,22340700,3667,0,0,6100
903,3,0,5,20,22364400,3667,0,0,6103
904,7,0,10,15,22370820,3667,0,0,6110
905,4,0,12,13,22375440,3666,0,0,6114
906,6,0,12,13,22397040,3666,0,0,6120
907,8,0,12,13,22432380,3667,0,0,6128
908,5,0,8,17,22460280,3666,0,0,6133
909,6,0,10,15,22471380,3666,0,0,6139
910,9,0,12,13,22497780,3666,0,0,6148
911,1,0,4,21,22529220,3666,0,0,6149
912,7,0,6,19,22536000,3664,0,0,6156
913,5,0,8,17,22542660,3663,0,0,6161
914,9,0,11,14,22557900,3662,0,0,6170
915,8,0,12,13,22576080,3661,0,0,6178
916,2,0,7,18,22602360,3661,0,0,6180
917,7,0,10,15,22615680,3661,0,0,6187
918,9,0,14,11,22635060,3661,0,0,6196
919,3,0,10,15,22666680,3662,0,0,6199
920,5,0,10,15,22702620,3665,0,0,6204
921,11,0,13,12,22721700,3663,0,0,6215
922,8,0,14,11,22739100,3662,0,0,6223
923,7,0,14,11,22775100,3663,0,0,6230
924,15,0,22,3,22805580,3664,0,0,6245
925,9,0,16,9,22871760,3666,0,0,6254
926,7,0,11,14,22931400,3669,0,0,6261
927,7,0,15,10,22941360,3668,0,0,6268
928,8,0,12,13,22993500,3670,0,0,6276
929,9,0,11,14,23020200,3669,0,0,6285
930,8,0,13,12,23039280,3668,0,0,6293
931,5,0,9,16,23075340,3669,0,0,6298
932,7,0,12,13,23099340,3670,0,0,6305
933,4,0,9,16,23127360,3671,0,0,6309
934,8,0,11,14,23148840,3670,0,0,6317
935,2,0,7,18,23160960,3669,0,0,6319
936,3,0,7,18,23176260,3670,0,0,6322
937,2,0,7,18,23183040,3669,0,0,6324
938,3,0,7,18,23195100,3670,0,0,6327
939,8,0,12,13,23213040,3671,0,0,6335
940,5,0,8,17,23230500,3668,0,0,6340
941,5,0,9,16,23251200,3669,0,0,6345
942,8,0,11,14,23263800,3668,0,0,6353
943,8,0,11,14,23295540,3668,0,0,6361
944,9,0,13,12,23319180,3668,0,0,6370
945,5,0,13,12,23346240,3669,0,0,6375
946,7,0,13,12,23376060,3670,0,0,6382
947,4,0,9,16,23413860,3671,0,0,6386
948,13,0,14,11,23442480,3671,0,0,6399
949,10,0,17,8,23466900,3671,0,0,6409
950,9,0,15,10,23515140,3672,0,0,6418
951,11,0,16,9,23555220,3673,0,0,6429
952,8,0,13,12,23595600,3673,0,0,6437
953,10,0,16,9,23625300,3673,0,0,6447
954,14,0,18,7,23670480,3673,0,0,6461
955,5,0,12,13,23719800,3675,0,0,6466
956,8,0,11,14,23762460,3676,0,0,6474
957,3,0,9,16,23782800,3676,0,0,6477
958,8,0,13,12,23796420,3676,0,0,6485
959,6,0,14,11,23817120,3677,0,0,6491
960,3,0,8,17,23843400,3676,0,0,6494
961,8,0,10,15,23866980,3676,0,0,6502
962,5,0,8,17,23893620,3676,0,0,6507
963,10,0,13,12,23904180,3675,0,0,6517
964,7,0,14,11,23926080,3675,0,0,6524
965,12,0,14,11,23970300,3675,0,0,6536
966,3,0,10,15,24002460,3676,0,0,6539
967,5,0,7,18,24028680,3675,0,0,6544
968,10,0,12,13,24044280,3675,0,0,6554
969,9,0,13,12,24072720,3675,0,0,6563
970,10,0,16,9,24104340,3676,0,0,6573
971,6,0,11,14,24142440,3675,0,0,6579
972,4,0,10,15,24173700,3677,0,0,6583
973,9,0,14,11,24186720,3676,0,0,6592
974,8,0,13,12,24227880,3678,0,0,6600
975,5,0,12,13,24253440,3678,0,0,6605
976,13,0,16,9,24293820,3679,0,0,6618
977,8,0,20,5,24306300,3679,0,0,6626
978,6,0,12,13,24363120,3680,0,0,6632
979,7,0,9,16,24403200,3680,0,0,6639
980,6,0,9,16,24419880,3679,0,0,6645
981,5,0,10,15,24439380,3680,0,0,6650
982,7,0,11,14,24462960,3680,0,0,6657
983,9,0,11,14,24486540,3679,0,0,6666
984,6,0,6,19,24523140,3678,0,0,6672
985,7,0,7,18,24542040,3678,0,0,6679
986,4,0,8,17,24553680,3678,0,0,6683
987,0,0,4,21,24571860,3678,0,0,6683
988,2,0,6,19,24571860,3678,0,0,6685
989,2,0,6,19,24576900,3678,0,0,6687
990,7,0,9,16,24587400,3677,0,0,6694
991,1,0,7,18,24593460,3677,0,0,6695
992,4,0,9,16,24600600,3677,0,0,6699
993,7,0,8,17,24630000,3677,0,0,6706
994,8,0,9,16,24648600,3676,0,0,6714
995,5,0,10,15,24662760,3676,0,0,6719
996,10,0,15,10,24674940,3675,0,0,6729
997,11,0,10,15,24723180,3673,0,0,6740
998,16,0,19,6,24741420,3672,0,0,6756
999,7,0,13,12,24789720,3672,0,0,6763
1000,11,0,12,13,24832020,3672,0,0,6774
1001,10,0,10,15,24873540,3671,0,0,6784
1002,9,0,13,12,24886800,3670,0,0,6793
1003,3,0,8,17,24921540,3671,0,0,6796
1004,6,0,7,18,24947460,3671,0,0,6802
1005,7,0,11,14,24952920,3670,0,0,6809
1006,8,0,14,11,24977520,3671,0,0,6817
1007,4,0,11,14,25006500,3672,0,0,6821
1008,5,0,6,19,25042140,3671,0,0,6826
1009,5,0,9,16,25043520,3670,0,0,6831
1010,4,0,10,15,25050180,3670,0,0,6835
1011,4,0,9,16,25082160,3672,0,0,6839
1012,5,0,9,16,25096860,3671,0,0,6844
1013,7,0,10,15,25112640,3670,0,0,6851
1014,5,0,8,17,25142640,3671,0,0,6856
1015,4,0,9,16,25151520,3671,0,0,6860
1016,7,0,14,11,25153080,3670,0,0,6867
1017,6,0,9,16,25200000,3671,0,0,6873
1018,4,0,10,15,25211880,3671,0,0,6877
1019,12,0,14,11,25244460,3671,0,0,6889
1020,7,0,13,12,25261740,3670,0,0,6896
1021,12,0,16,9,25304700,3671,0,0,6908
1022,5,0,12,13,25331160,3670,0,0,6913
1023,3,0,9,16,25364160,3672,0,0,6916
1024,9,0,11,14,25387620,3671,0,0,6925
1025,6,0,14,11,25403880,3672,0,0,6931
1026,8,0,13,12,25435260,3672,0,0,6939
1027,6,0,8,17,25471020,3671,0,0,6945
1028,6,0,8,17,25502340,3673,0,0,6951
1029,4,0,7,18,25513980,3672,0,0,6955
1030,5,0,8,17,25523880,3671,0,0,6960
1031,4,0,10,15,25528980,3671,0,0,6964
1032,2,0,8,17,25551420,3672,0,0,6966
1033,4,0,9,16,25567860,3673,0,0,6970
1034,2,0,8,17,25585860,3674,0,0,6972
1035,4,0,8,17,25608360,3675,0,0,6976
1036,2,0,4,21,25629960,3675,0,0,6978
1037,11,0,12,13,25635120,3674,0,0,6989
1038,4,0,11,14,25650900,3673,0,0,6993
1039,6,0,9,16,25686780,3674,0,0,6999
1040,11,0,11,14,25700340,3672,0,0,7010
1041,7,0,10,15,25725060,3671,0,0,7017
1042,3,0,6,19,25750440,3671,0,0,7020
1043,11,0,14,11,25754880,3670,0,0,7031
1044,13,0,12,13,25796160,3668,0,0,7044
1045,13,1,21,4,25803480,3667,120,0,7057
1046,9,7,14,11,25859040,3670,6000,0,7066
1047,5,8,14,11,25886580,3672,16080,2,7071
1048,8,6,19,6,25924620,3675,45000,6,7079
1049,6,0,12,13,25997940,3675,84660,11,7085
1050,6,0,9,16,26044500,3677,84660,11,7091
1051,4,0,7,18,26063520,3677,84660,11,7095
1052,7,0,8,17,26080680,3676,84660,11,7102
1053,4,0,10,15,26085720,3676,84660,11,7106
1054,5,0,12,13,26099160,3676,84660,11,7111
1055,6,0,11,14,26129760,3677,84660,11,7117
1056,2,0,5,20,26161080,3677,84660,11,7119
1057,3,0,6,19,26167980,3677,84660,11,7122
1058,5,0,7,18,26175660,3676,84660,11,7127
1059,4,0,10,15,26180100,3676,84660,11,7131
1060,8,0,11,14,26191980,3674,84660,11,7139
1061,7,0,11,14,26226660,3675,84660,11,7146
1062,10,0,11,14,26251440,3674,84660,11,7156
1063,9,0,12,13,26273340,3673,84660,11,7165
1064,7,0,11,14,26296500,3672,84660,11,7172
1065,8,0,11,14,26332980,3673,84660,11,7180
1066,6,0,10,15,26354640,3672,84660,11,7186
1067,12,0,16,9,26374020,3672,84660,11,7198
1068,8,0,12,13,26422020,3672,84660,11,7206
1069,13,0,18,7,26450160,3673,84660,11,7219
1070,19,1,25,0,26485800,3672,88860,12,7238
1071,9,0,15,10,26564400,3673,89460,12,7247
1072,7,0,9,16,26605260,3672,89460,12,7254
1073,6,0,10,15,26623800,3672,89460,12,7260
1074,6,0,8,17,26663340,3673,89460,12,7266
1075,8,0,9,16,26680800,3672,89460,12,7274
1076,3,0,9,16,26694900,3672,89460,12,7277
1077,5,0,9,16,26712960,3672,89460,12,7282
1078,5,0,9,16,26732760,3673,89460,12,7287
1079,6,0,11,14,26750940,3673,89460,12,7293
1080,3,0,9,16,26774580,3674,89460,12,7296
1081,3,0,4,21,26805600,3674,89460,12,7299
1082,3,0,5,20,26807460,3673,89460,12,7302
1083,6,0,9,16,26812200,3673,89460,12,7308
1084,11,0,18,7,26815140,3672,89460,12,7319
1085,9,0,15,10,26849940,3671,89460,12,7328
1086,8,0,13,12,26893740,3672,89460,12,7336
1087,9,0,11,14,26926020,3671,89460,12,7345
1088,2,0,6,19,26961960,3672,89460,12,7347
1089,6,0,8,17,26981340,3673,89460,12,7353
1090,5,0,8,17,26996460,3672,89460,12,7358
1091,12,0,11,14,27018120,3671,89460,12,7370
1092,8,0,11,14,27048060,3671,89460,12,7378
1093,10,0,9,16,27086700,3670,89460,12,7388
1094,13,0,17,8,27105060,3670,89460,12,7401
1095,7,0,16,9,27119760,3668,89460,12,7408
1096,9,0,10,15,27174900,3668,89460,12,7417
1097,7,0,9,16,27215520,3670,89460,12,7424
1098,3,0,8,17,27220860,3669,89460,12,7427
1099,9,0,11,14,27238380,3668,89460,12,7436
1100,3,0,9,16,27262320,3669,89460,12,7439
1101,7,0,10,15,27279480,3668,89460,12,7446
1102,5,0,8,17,27311460,3669,89460,12,7451
1103,5,0,7,18,27332760,3669,89460,11,7456
1104,3,0,7,18,27339840,3668,89460,11,7459
1105,6,0,7,18,27356280,3668,89460,11,7465
1106,5,0,11,14,27359280,3667,89460,11,7470
1107,4,0,10,15,27382020,3668,89460,11,7474
1108,4,0,7,18,27413460,3669,89460,11,7478
1109,2,0,8,17,27418920,3669,89460,11,7480
1110,10,0,12,13,27438720,3669,89460,11,7490
1111,10,0,17,8,27455400,3669,89460,11,7500
1112,6,0,10,15,27509760,3669,89460,11,7506
1113,10,0,16,9,27520080,3669,89460,11,7516
1114,8,0,17,8,27568320,3672,89460,11,7524
1115,11,0,16,9,27622020,3673,89460,11,7535
1116,11,0,17,8,27649320,3672,89460,11,7546
1117,11,0,16,9,27711300,3674,89580,11,7557
1118,11,0,17,8,27754440,3675,89580,11,7568
1119,5,0,14,11,27790800,3676,89580,11,7573
1120,5,0,10,15,27848100,3679,89580,11,7578
1121,5,0,10,15,27872880,3680,89580,11,7583
1122,7,0,10,15,27897000,3680,89580,11,7590
1123,2,0,6,19,27922260,3680,89580,11,7592
1124,6,0,9,16,27929400,3680,89580,11,7598
1125,7,0,10,15,27940980,3678,89580,11,7605
1126,3,0,8,17,27965100,3679,89580,11,7608
1127,4,0,8,17,27979680,3679,89580,11,7612
1128,6,0,8,17,27989940,3678,89580,11,7618
1129,4,0,9,16,28004580,3678,89580,11,7622
1130,2,0,7,18,28021680,3678,89580,11,7624
1131,5,0,10,15,28030380,3679,89580,11,7629
1132,5,0,12,13,28042620,3679,89580,11,7634
1133,5,0,10,15,28069440,3679,89580,11,7639
1134,7,0,13,12,28082280,3679,89580,11,7646
1135,7,0,11,14,28120200,3679,89580,11,7653
1136,6,0,14,11,28126860,3679,89580,11,7659
1137,4,0,10,15,28172520,3681,89580,11,7663
1138,2,0,7,18,28201140,3682,89580,11,7665
1139,9,0,11,14,28213020,3681,89580,11,7674
1140,14,0,14,11,28242660,3680,89580,11,7688
1141,10,0,15,10,28266180,3679,89580,11,7698
1142,10,0,15,10,28312200,3680,89580,11,7708
1143,10,0,14,11,28346940,3679,89580,11,7718
1144,11,0,13,12,28395240,3680,89580,11,7729
1145,11,0,17,8,28415220,3679,89580,11,7740
1146,7,0,14,11,28461480,3680,89580,11,7747
1147,6,0,9,16,28504080,3680,89580,11,7753
1148,6,0,10,15,28525140,3681,89580,11,7759
1149,4,0,9,16,28544040,3681,89580,11,7763
1150,3,0,7,18,28569000,3682,89580,11,7766
1151,6,0,10,15,28575600,3681,89580,11,7772
1152,10,0,13,12,28595220,3680,89580,11,7782
1153,4,0,9,16,28622160,3680,89580,11,7786
1154,1,0,4,21,28647000,3680,89580,11,7787
1155,6,0,8,17,28649700,3680,89580,11,7793
1156,3,0,8,17,28658340,3679,89580,11,7796
1157,9,0,12,13,28676040,3679,89580,11,7805
1158,5,0,9,16,28699740,3678,89580,11,7810
1159,7,0,8,17,28734300,3679,89580,11,7817
1160,5,0,10,15,28743120,3679,89580,11,7822
1161,9,0,13,12,28763640,3679,89580,11,7831
1162,5,0,8,17,28808160,3680,89580,11,7836
1163,9,0,10,15,28823700,3678,89580,11,7845
1164,12,0,14,11,28844100,3677,89580,11,7857
1165,13,0,19,6,28883520,3678,89580,11,7870
1166,14,0,20,5,28923660,3677,89580,11,7884
1167,17,0,21,4,28976340,3677,89580,11,7901
1168,8,0,16,9,29030340,3677,89820,11,7909
1169,11,0,19,6,29057880,3677,89820,11,7920
1170,4,0,10,15,29133840,3681,89820,11,7924
1171,11,0,13,12,29161920,3681,89820,11,7935
1172,5,0,11,14,29189160,3681,89820,11,7940
1173,6,0,10,15,29215980,3681,89820,11,7946
1174,4,0,9,16,29230920,3681,89820,11,7950
1175,5,0,8,17,29257620,3681,89820,11,7955
1176,4,0,8,17,29267520,3680,89820,11,7959
1177,2,0,8,17,29283480,3682,89820,11,7961
1178,5,0,11,14,29290500,3682,89820,11,7966
1179,2,0,8,17,29318100,3683,89820,11,7968
1180,2,0,8,17,29327220,3683,89820,11,7970
1181,11,0,14,11,29343720,3683,89820,11,7981
1182,8,0,13,12,29373120,3682,89820,11,7989
1183,6,0,10,15,29410560,3683,89820,11,7995
1184,10,0,12,13,29437980,3682,89820,11,8005
1185,6,0,11,14,29468340,3683,89820,11,8011
1186,9,0,11,14,29491080,3682,89820,11,8020
1187,7,0,11,14,29515860,3682,89820,11,8027
1188,10,0,16,9,29527020,3681,89820,11,8037
1189,7,0,12,13,29580660,3682,89820,11,8044
1190,13,0,16,9,29608380,3682,89820,11,8057
1191,10,0,16,9,29649120,3682,89820,11,8067
1192,9,0,13,12,29698920,3683,89820,11,8076
1193,5,0,11,14,29724180,3683,89820,11,8081
1194,9,0,13,12,29751120,3683,89820,11,8090
1195,5,0,9,16,29781420,3683,89820,11,8095
1196,6,0,10,15,29807340,3684,89820,11,8101
1197,3,0,7,18,29822580,3683,89820,11,8104
1198,6,0,10,15,29837280,3683,89820,11,8110
1199,6,0,11,14,29851320,3683,89820,11,8116
1200,4,0,8,17,29872080,3682,89820,11,8120
1201,2,0,8,17,29884080,3683,89820,11,8122
1202,6,0,9,16,29904120,3683,89820,11,8128
1203,5,0,8,17,29931900,3683,89820,11,8133
1204,3,0,11,14,29931900,3683,89820,11,8136
1205,3,0,9,16,29952180,3684,89820,11,8139
1206,8,0,11,14,29979300,3684,89820,11,8147
1207,5,0,10,15,30003000,3684,89820,11,8152
1208,8,0,8,17,30033660,3684,89820,11,8160
1209,6,0,9,16,30051420,3684,89820,10,8166
1210,11,0,15,10,30062460,3683,89820,10,8177
1211,9,0,16,9,30095820,3683,89820,10,8186
1212,8,0,13,12,30131280,3683,89820,10,8194
1213,7,0,11,14,30179220,3684,89820,10,8201
1214,9,0,11,14,30212940,3684,89820,10,8210
1215,11,0,14,11,30233880,3683,89820,10,8221
1216,5,0,11,14,30262680,3683,89820,10,8226
1217,6,0,9,16,30298500,3684,89820,10,8232
1218,7,0,15,10,30304560,3684,89820,10,8239
1219,12,0,13,12,30343260,3683,89820,10,8251
1220,5,0,12,13,30369060,3683,89820,10,8256
1221,3,0,8,17,30406680,3685,89820,10,8259
1222,4,0,7,18,30428160,3685,89820,10,8263
1223,3,0,6,19,30440340,3685,89820,10,8266
1224,1,0,5,20,30448680,3685,89820,10,8267
1225,4,0,8,17,30449460,3685,89820,10,8271
1226,2,0,6,19,30467100,3685,89820,10,8273
1227,5,0,8,17,30472080,3684,89820,10,8278
1228,3,0,9,16,30482340,3685,89820,10,8281
1229,6,0,12,13,30499740,3685,89820,10,8287
1230,3,0,10,15,30522540,3686,89820,10,8290
1231,5,0,11,14,30544140,3687,89820,10,8295
1232,5,0,11,14,30560760,3686,89820,10,8300
1233,10,0,14,11,30588360,3687,89820,10,8310
1234,13,0,17,8,30624840,3687,89820,10,8323
1235,7,0,14,11,30666780,3687,89820,10,8330
1236,8,0,12,13,30706740,3688,89820,10,8338
1237,10,0,16,9,30737520,3689,89820,10,8348
1238,7,0,13,12,30772680,3688,89820,10,8355
1239,5,0,12,13,30795360,3688,89820,10,8360
1240,12,0,15,10,30831420,3689,89820,10,8372
1241,12,0,18,7,30864360,3689,89820,10,8384
1242,9,0,14,11,30915840,3689,89820,10,8393
1243,12,0,15,10,30964560,3690,89820,10,8405
1244,7,0,14,11,30997500,3691,89820,10,8412
1245,6,0,13,12,31019520,3690,89820,10,8418
1246,5,0,9,16,31064700,3692,89820,10,8423
1247,5,0,8,17,31086600,3691,89820,10,8428
1248,2,0,5,20,31102440,3691,89820,10,8430
1249,7,0,8,17,31109880,3690,89820,10,8437
1250,4,0,6,19,31123620,3689,89820,10,8441
1251,3,0,7,18,31129980,3689,89820,10,8444
1252,2,0,6,19,31138080,3689,89820,10,8446
1253,4,0,7,18,31149180,3689,89820,10,8450
1254,10,0,13,12,31156620,3688,89820,10,8460
1255,8,0,13,12,31178940,3687,89820,10,8468
1256,6,0,9,16,31216740,3687,89820,10,8474
1257,6,0,9,16,31240620,3687,89820,10,8480
1258,11,0,9,16,31260360,3685,89820,10,8491
1259,6,0,11,14,31268640,3684,89820,10,8497
1260,10,0,13,12,31297740,3684,89820,10,8507
1261,9,0,12,13,31326540,3683,89820,10,8516
1262,8,0,13,12,31352340,3683,89820,10,8524
1263,10,0,15,10,31382640,3683,89820,10,8534
1264,14,0,16,9,31426320,3683,89820,10,8548
1265,8,0,11,14,31467660,3682,89820,10,8556
1266,8,0,14,11,31484280,3682,89820,10,8564
1267,11,0,15,10,31519320,3682,89820,10,8575
1268,3,0,10,15,31547220,3681,89820,10,8578
1269,6,0,10,15,31581000,3683,89820,10,8584
1270,7,0,12,13,31591620,3682,89820,10,8591
1271,6,0,11,14,31620720,3682,89820,10,8597
1272,4,0,7,18,31655280,3683,89820,10,8601
1273,4,0,8,17,31663260,3683,89820,10,8605
1274,8,0,13,12,31675140,3683,89820,10,8613
1275,4,0,10,15,31705800,3683,89820,10,8617
1276,6,0,12,13,31720740,3683,89820,10,8623
1277,4,0,7,18,31754400,3683,89820,10,8627
1278,4,0,8,17,31768620,3684,89820,10,8631
1279,16,0,16,9,31779060,3681,89820,10,8647
1280,9,0,11,14,31828020,3681,89820,10,8656
1281,12,0,13,12,31858920,3680,89820,10,8668
1282,15,0,13,12,31891200,3678,89820,10,8683
1283,10,0,12,13,31918680,3676,89820,10,8693
1284,7,0,7,18,31963020,3676,89820,10,8700
1285,6,0,11,14,31970460,3676,89820,10,8706
1286,7,0,13,12,31985640,3676,89820,10,8713
1287,10,0,12,13,32029740,3676,89820,10,8723
1288,6,0,8,17,32063160,3676,89820,10,8729
1289,4,0,8,17,32079000,3676,89820,10,8733
1290,10,0,14,11,32089860,3676,89820,10,8743
1291,6,0,9,16,32123700,3675,89820,10,8749
1292,9,0,12,13,32151480,3676,89820,10,8758
1293,6,0,12,13,32165460,3675,89820,10,8764
1294,7,0,12,13,32196300,3675,89820,10,8771
1295,11,0,15,10,32223360,3675,89820,10,8782
1296,5,0,9,16,32263440,3675,89820,10,8787
1297,2,0,8,17,32278020,3675,89820,10,8789
1298,10,0,15,10,32288880,3675,89820,10,8799
1299,3,0,9,16,32332920,3677,89820,10,8802
1300,3,0,8,17,32351580,3677,89820,10,8805
1301,6,0,9,16,32369460,3677,89820,10,8811
1302,6,0,9,16,32390100,3677,89820,10,8817
1303,6,0,10,15,32406840,3677,89820,10,8823
1304,0,0,5,20,32425320,3677,89820,10,8823
1305,8,0,9,16,32433120,3676,89820,10,8831
1306,10,0,10,15,32450400,3674,89820,10,8841
1307,5,0,11,14,32464020,3674,89820,10,8846
1308,9,0,14,11,32487120,3674,89820,10,8855
1309,7,0,12,13,32520180,3674,89820,10,8862
1310,13,0,18,7,32544600,3674,89820,10,8875
1311,5,0,13,12,32592420,3675,89820,10,8880
1312,11,0,19,6,32622660,3677,89820,10,8891
1313,11,0,22,3,32653260,3677,89820,10,8902
1314,10,0,17,8,32721480,3678,89820,10,8912
1315,6,0,12,13,32771580,3679,89820,10,8918
1316,7,0,13,12,32806920,3681,89820,10,8925
1317,3,0,8,17,32833560,3680,89820,10,8928
1318,5,0,8,17,32858940,3681,89820,10,8933
1319,4,0,8,17,32866920,3680,89820,10,8937
1320,4,0,8,17,32879520,3680,89820,10,8941
1321,3,0,8,17,32889300,3680,89820,10,8944
1322,3,0,7,18,32905740,3680,89820,10,8947
1323,9,0,10,15,32924400,3680,89820,10,8956
1324,7,0,12,13,32933400,3679,89820,10,8963
1325,4,0,8,17,32965740,3679,89820,10,8967
1326,4,0,9,16,32973960,3679,89820,10,8971
1327,10,0,12,13,32995920,3678,89820,10,8981
1328,10,0,13,12,33026100,3678,89820,9,8991
1329,11,0,16,9,33057360,3678,89820,9,9002
1330,11,0,18,7,33087840,3678,89820,9,9013
1331,5,0,11,14,33151380,3680,89820,9,9018
1332,10,0,13,12,33173700,3679,89820,9,9028
1333,12,0,14,11,33218820,3680,89820,9,9040
1334,8,0,15,10,33242220,3680,89820,9,9048
1335,8,0,9,16,33282960,3678,89820,9,9056
1336,6,0,8,17,33308460,3678,89820,9,9062
1337,6,0,11,14,33314520,3678,89820,9,9068
1338,3,0,5,20,33343080,3677,89820,9,9071
1339,7,0,9,16,33350220,3677,89820,9,9078
1340,7,0,9,16,33366420,3676,89820,9,9085
1341,2,0,6,19,33384840,3676,89820,9,9087
1342,5,0,9,16,33388200,3675,89820,9,9092
1343,1,0,6,19,33402660,3675,89820,9,9093
1344,6,0,10,15,33408840,3675,89820,9,9099
1345,3,0,13,12,33408840,3675,89820,9,9102
1346,10,0,15,10,33418620,3673,89820,9,9112
1347,8,0,17,8,33431100,3672,89820,9,9120
1348,5,0,14,11,33455760,3672,89820,9,9125
1349,5,0,14,11,33484980,3673,89820,9,9130
1350,3,0,13,12,33508020,3674,89820,9,9133
1351,7,0,14,11,33525960,3673,89820,9,9140
1352,5,0,14,11,33533160,3672,89820,9,9145
1353,5,0,16,9,33550320,3673,89820,9,9150
1354,11,0,20,5,33572460,3672,89820,9,9161
1355,8,0,18,7,33605040,3672,89820,9,9169
1356,11,0,19,6,33644760,3672,89820,9,9180
1357,7,0,15,10,33682680,3672,89820,9,9187
1358,10,0,21,4,33691080,3671,89820,9,9197
1359,11,0,24,1,33733680,3673,89820,9,9208
1360,7,0,22,3,33764520,3672,89820,9,9215
1361,6,0,18,7,33818040,3674,89820,9,9221
1362,7,0,17,8,33857940,3675,89820,9,9228
1363,4,0,15,10,33890760,3676,89820,9,9232
1364,11,0,15,10,33920820,3675,89820,9,9243
1365,9,0,16,9,33939660,3674,89820,9,9252
1366,10,0,16,9,33958200,3672,89820,9,9262
1367,6,0,14,11,33989820,3672,89820,9,9268
1368,4,0,13,12,34012920,3673,89820,9,9272
1369,7,0,15,10,34029240,3673,89820,9,9279
1370,3,0,15,10,34040760,3673,89820,9,9282
1371,8,0,14,11,34072620,3673,89820,9,9290
1372,5,0,13,12,34088520,3672,89820,9,9295
1373,3,0,14,11,34100880,3673,89820,9,9298
1374,6,0,14,11,34123620,3673,89820,9,9304
1375,5,0,13,12,34141080,3672,89820,9,9309
1376,6,0,17,8,34156140,3673,89820,9,9315
1377,6,0,15,10,34182240,3673,89820,9,9321
1378,9,0,17,8,34200540,3672,89820,9,9330
1379,9,0,18,7,34227240,3672,89820,9,9339
1380,6,0,15,10,34254300,3671,89820,9,9345
1381,13,0,18,7,34288380,3671,89820,9,9358
1382,7,0,18,7,34307040,3670,89820,9,9365
1383,9,0,17,8,34346760,3670,89820,9,9374
1384,9,0,20,5,34361760,3669,89820,9,9383
1385,8,0,18,7,34405500,3670,89820,9,9391
1386,7,0,18,7,34431120,3670,89820,9,9398
1387,11,0,20,5,34474140,3671,89820,9,9409
1388,4,0,16,9,34499040,3671,89820,9,9413
1389,5,0,15,10,34532640,3672,89820,9,9418
1390,9,0,17,8,34563840,3673,89820,9,9427
1391,6,0,16,9,34595460,3673,89820,9,9433
1392,5,0,13,12,34626240,3673,89820,9,9438
1393,4,0,13,12,34643100,3674,89820,9,9442
1394,7,0,16,9,34650000,3673,89820,9,9449
1395,7,0,16,9,34670460,3672,89820,9,9456
1396,7,0,18,7,34696500,3673,89820,9,9463
1397,4,0,14,11,34729080,3673,89820,9,9467
1398,5,0,13,12,34752180,3673,89820,9,9472
1399,5,0,14,11,34767660,3674,89820,9,9477
1400,11,0,18,7,34784700,3673,89820,9,9488
1401,13,0,24,1,34808880,3672,91140,9,9501
1402,6,0,15,10,34865940,3673,91140,9,9507
1403,8,0,16,9,34892220,3673,91140,9,9515
1404,9,0,17,8,34916160,3672,91140,9,9524
1405,9,0,20,5,34931340,3671,91140,9,9533
1406,8,0,16,9,34984740,3672,91140,9,9541
1407,10,0,17,8,35003280,3671,91140,9,9551
1408,5,0,12,13,35048340,3672,91140,9,9556
1409,8,0,14,11,35067060,3671,91140,9,9564
1410,7,0,17,8,35082540,3672,91140,9,9571
1411,8,0,15,10,35111520,3671,91140,9,9579
1412,4,0,15,10,35127840,3671,91140,9,9583
1413,9,0,16,9,35152920,3670,91140,9,9592
1414,10,0,17,8,35178840,3670,91140,9,9602
1415,3,0,14,11,35209440,3671,91140,9,9605
1416,8,0,17,8,35226000,3670,91140,9,9613
1417,5,0,14,11,35254800,3670,91140,9,9618
1418,5,0,12,13,35280480,3670,91140,9,9623
1419,4,0,14,11,35282880,3670,91140,9,9627
1420,5,0,16,9,35292480,3670,91140,9,9632
1421,4,0,12,13,35324220,3670,91140,9,9636
1422,5,0,14,11,35335800,3670,91140,9,9641
1423,8,0,18,7,35344560,3669,91140,9,9649
1424,7,0,18,7,35375220,3670,91140,9,9656
1425,6,0,20,5,35391840,3670,91140,9,9662
1426,11,0,20,5,35439660,3671,91140,9,9673
1427,5,0,17,8,35467200,3671,91140,9,9678
1428,11,0,21,4,35496420,3671,91140,9,9689
1429,8,0,16,9,35551140,3672,91140,9,9697
1430,7,0,16,9,35574540,3672,91140,9,9704
1431,9,0,17,8,35608200,3672,91140,9,9713
1432,5,0,14,11,35629500,3671,91140,9,9718
1433,10,0,13,12,35660580,3670,91140,9,9728
1434,8,0,16,9,35679480,3670,91140,9,9736
1435,10,0,18,7,35706420,3670,91140,9,9746
1436,8,0,17,8,35734620,3669,91140,9,9754
1437,5,0,16,9,35756160,3669,91140,9,9759
1438,10,0,18,7,35797740,3671,91140,9,9769
1439,8,0,18,7,35819700,3670,91140,9,9777
1440,1,0,16,9,35829600,3670,91140,9,9778
1441,10,0,20,5,35866560,3671,91140,9,9788
1442,4,0,18,7,35901540,3673,91140,9,9792
1443,10,0,16,9,35941560,3672,91140,9,9802
1444,10,0,18,7,35968740,3672,91140,9,9812
1445,8,0,17,8,36004260,3672,91140,9,9820
1446,6,0,18,7,36024600,3672,91140,9,9826
1447,10,0,18,7,36056400,3672,91140,9,9836
1448,8,0,15,10,36085080,3671,91140,9,9844
1449,7,0,14,11,36117960,3671,91140,9,9851
1450,12,0,21,4,36132720,3671,91140,9,9863
1451,10,0,20,5,36166260,3670,91140,9,9873
1452,10,0,20,5,36209580,3671,91140,9,9883
1453,10,0,19,6,36250260,3671,91140,9,9893
1454,11,0,21,4,36276420,3670,91140,9,9904
1455,5,0,16,9,36323700,3671,91140,9,9909
1456,16,0,19,6,36360720,3670,91140,9,9925
1457,12,1,25,0,36374040,3670,91260,9,9937
1458,4,0,13,12,36442380,3670,91320,9,9941
1459,1,0,11,14,36459780,3671,91320,9,9942
1460,2,0,10,15,36475440,3671,91320,9,9944
1461,3,0,13,12,36475440,3671,91320,9,9947
1462,6,0,11,14,36492060,3670,91320,9,9953
1463,5,0,12,13,36503940,3670,91320,9,9958
1464,4,0,14,11,36508320,3669,91320,9,9962
1465,5,0,16,9,36519240,3669,91320,9,9967
1466,7,0,16,9,36547920,3670,91320,9,9974
1467,5,0,15,10,36575940,3670,91320,9,9979
1468,4,0,15,10,36596760,3671,91320,9,9983
1469,5,0,15,10,36612240,3671,91320,9,9988
1470,6,0,17,8,36628380,3671,91320,9,9994
1471,4,0,13,12,36660480,3671,91320,9,9998
1472,10,0,16,9,36680640,3671,91320,9,10008
1473,9,0,19,6,36697260,3670,91320,9,10017
1474,7,0,15,10,36734700,3670,91320,9,10024
1475,5,0,17,8,36747480,3670,91320,9,10029
1476,9,0,18,7,36778500,3670,91320,9,10038
1477,10,0,19,6,36809700,3670,91320,9,10048
1478,4,0,18,7,36838080,3671,91320,9,10052
1479,5,0,15,10,36882000,3672,91320,9,10057
1480,6,0,14,11,36907320,3672,91320,9,10063
1481,11,0,19,6,36925440,3672,91320,9,10074
1482,12,0,18,7,36957180,3670,91320,9,10086
1483,8,0,18,7,36977100,3669,91320,9,10094
1484,6,0,17,8,37027500,3672,91320,9,10100
1485,6,0,17,8,37048800,3672,91320,9,10106
1486,10,0,17,8,37086240,3672,91320,9,10116
1487,4,0,17,8,37101720,3672,91320,9,10120
1488,2,0,12,13,37131180,3672,91320,9,10122
1489,4,0,10,15,37149960,3672,91320,9,10126
1490,4,0,11,14,37154100,3671,91320,9,10130
1491,1,0,10,15,37161300,3671,91320,9,10131
1492,11,0,17,8,37167240,3670,91320,9,10142
1493,4,0,15,10,37191180,3671,91320,9,10146
1494,4,0,15,10,37203240,3670,91320,8,10150
1495,8,0,14,11,37239420,3671,91320,8,10158
1496,8,0,19,6,37244580,3670,91320,8,10166
1497,9,0,18,7,37280700,3670,91320,8,10175
1498,7,0,21,4,37290540,3669,91320,8,10182
1499,12,0,21,4,37338000,3670,91320,8,10194
1500,8,0,21,4,37375320,3671,91320,8,10202
1501,10,0,16,9,37430400,3671,91320,8,10212
1502,5,0,15,10,37460580,3671,91320,8,10217
1503,1,0,12,13,37477200,3672,91320,8,10218
1504,5,0,12,13,37500480,3672,91320,8,10223
1505,14,0,16,9,37513860,3670,91320,8,10237
1506,8,0,20,5,37525080,3669,91320,8,10245
1507,8,0,19,6,37556400,3669,91320,8,10253
1508,11,0,19,6,37607460,3670,91320,8,10264
1509,6,0,16,9,37640460,3670,91320,8,10270
1510,1,0,13,12,37663680,3671,91320,8,10271
1511,3,0,14,11,37675920,3672,91320,8,10274
1512,5,0,13,12,37699920,3672,91320,8,10279
1513,7,0,16,9,37711560,3672,91320,8,10286
1514,3,0,14,11,37723320,3671,91320,8,10289
1515,4,0,13,12,37740480,3671,91320,8,10293
1516,7,0,14,11,37762320,3671,91320,8,10300
1517,6,0,16,9,37769160,3670,91320,8,10306
1518,9,0,16,9,37809420,3671,91320,8,10315
1519,6,0,16,9,37824420,3670,91320,8,10321
1520,9,0,19,6,37848960,3670,91320,8,10330
1521,7,0,19,6,37876020,3670,91320,8,10337
1522,9,0,21,4,37918920,3672,91320,8,10346
1523,3,0,15,10,37947360,3672,91320,8,10349
1524,12,0,14,11,37993020,3671,91320,8,10361
1525,13,0,14,11,38021520,3670,91320,8,10374
1526,12,2,21,4,38028000,3669,91320,8,10386
1527,14,10,21,4,38061660,3670,99240,9,10400
1528,8,7,25,0,38110800,3672,120180,11,10408
1529,6,0,15,10,38182980,3671,156720,15,10414
1530,8,0,17,8,38196780,3671,156720,15,10422
1531,10,0,20,5,38220180,3670,156720,15,10432
1532,6,0,18,7,38247540,3670,156720,15,10438
1533,5,0,13,12,38296620,3671,156720,15,10443
1534,8,0,16,9,38314320,3671,156720,14,10451
1535,4,0,15,10,38327940,3671,156720,14,10455
1536,7,0,15,10,38353620,3671,156720,14,10462
1537,8,0,15,10,38374260,3670,156720,14,10470
1538,4,0,14,11,38398020,3670,156720,14,10474
1539,1,0,11,14,38418540,3671,156720,14,10475
1540,5,0,11,14,38433540,3671,156720,14,10480
1541,8,0,17,8,38437260,3670,156720,14,10488
1542,7,0,16,9,38463300,3670,156720,14,10495
1543,10,0,17,8,38488020,3669,156720,14,10505
1544,3,0,13,12,38520420,3670,156720,14,10508
1545,14,0,21,4,38538720,3670,156720,14,10522
1546,5,0,18,7,38560560,3669,156720,14,10527
1547,10,0,18,7,38610000,3670,156720,14,10537
1548,12,0,17,8,38649240,3669,156720,14,10549
1549,10,0,20,5,38669940,3669,156720,14,10559
1550,6,0,20,5,38694480,3669,156720,14,10565
1551,9,0,16,9,38746920,3669,156720,14,10574
1552,8,0,17,8,38764140,3669,156720,14,10582
1553,7,0,15,10,38796240,3669,156720,14,10589
1554,7,0,17,8,38807580,3668,156720,14,10596
1555,5,0,11,14,38848200,3668,156720,14,10601
1556,5,0,12,13,38859600,3668,156720,14,10606
1557,6,0,11,14,38874300,3667,156720,14,10612
1558,1,0,10,15,38883780,3667,156720,14,10613
1559,1,0,11,14,38883780,3667,156720,14,10614
1560,1,0,11,14,38884680,3666,156720,14,10615
1561,5,0,15,10,38885640,3666,156720,14,10620
1562,3,0,11,14,38917800,3667,156720,14,10623
1563,2,0,11,14,38919540,3666,156720,14,10625
1564,5,0,14,11,38936640,3667,156720,14,10630
1565,5,0,17,8,38942160,3667,156720,14,10635
1566,9,0,18,7,38976660,3668,156720,14,10644
1567,3,0,12,13,39008160,3667,156720,14,10647
1568,7,0,15,10,39026340,3668,156720,14,10654
1569,8,0,17,8,39050460,3668,156720,14,10662
1570,8,0,17,8,39073920,3667,156720,14,10670
1571,11,0,20,5,39101580,3667,156720,14,10681
1572,12,0,21,4,39139620,3667,156720,14,10693
1573,14,0,24,1,39176940,3667,156720,14,10707
1574,9,0,17,8,39240360,3667,156720,14,10716
1575,9,0,18,7,39264840,3667,156720,14,10725
1576,8,0,15,10,39303900,3667,156720,14,10733
1577,9,0,14,11,39334800,3666,156720,14,10742
1578,7,0,15,10,39354480,3666,156720,14,10749
1579,6,0,14,11,39382860,3666,156720,14,10755
1580,3,0,14,11,39398940,3667,156720,14,10758
1581,6,0,15,10,39414420,3666,156720,14,10764
1582,6,0,16,9,39431520,3666,156720,14,10770
1583,6,0,16,9,39454560,3666,156720,14,10776
1584,8,0,16,9,39476760,3666,156720,14,10784
1585,6,0,16,9,39494460,3665,156720,14,10790
1586,2,0,12,13,39524460,3666,156720,14,10792
1587,2,0,10,15,39550380,3667,156720,14,10794
1588,4,0,12,13,39554160,3667,156720,14,10798
1589,8,0,15,10,39566280,3666,156720,14,10806
1590,3,0,11,14,39588360,3666,156720,14,10809
1591,5,0,13,12,39603480,3666,156720,14,10814
1592,11,0,16,9,39622800,3665,156720,14,10825
1593,12,0,22,3,39639360,3665,156720,14,10837
1594,9,0,17,8,39688260,3664,156780,14,10846
1595,7,0,15,10,39727920,3665,156780,14,10853
1596,8,0,15,10,39750780,3665,156780,14,10861
1597,8,0,15,10,39770820,3664,156780,14,10869
1598,7,0,16,9,39796560,3664,156780,14,10876
1599,8,0,17,8,39825600,3664,156780,14,10884
1600,5,0,17,8,39846540,3665,156780,14,10889
1601,6,0,18,7,39861660,3664,156780,14,10895
1602,5,0,15,10,39907860,3666,156780,14,10900
1603,7,0,16,9,39934920,3666,156780,14,10907
1604,3,0,11,14,39966540,3666,156780,14,10910
1605,5,0,13,12,39972420,3666,156780,14,10915
1606,4,0,13,12,39978780,3665,156780,14,10919
1607,7,0,15,10,40008840,3666,156780,14,10926
1608,3,0,15,10,40016760,3666,156780,14,10929
1609,5,0,15,10,40041180,3667,156780,14,10934
1610,7,0,17,8,40071180,3668,156780,14,10941
1611,3,0,13,12,40097040,3668,156780,14,10944
1612,5,0,13,12,40125840,3669,156780,14,10949
1613,3,0,11,14,40135140,3668,156780,14,10952
1614,4,0,13,12,40143240,3668,156780,14,10956
1615,4,0,16,9,40145700,3668,156780,14,10960
1616,11,0,22,3,40166040,3668,156780,14,10971
1617,11,0,21,4,40211100,3668,156780,14,10982
1618,10,0,19,6,40254600,3668,156780,14,10992
1619,8,0,16,9,40300200,3668,156780,14,11000
1620,9,0,18,7,40315500,3668,156780,14,11009
1621,5,0,18,7,40334700,3668,156780,14,11014
1622,10,0,16,9,40384920,3668,156780,14,11024
1623,6,0,14,11,40417440,3668,156780,14,11030
1624,10,0,21,4,40426680,3668,156780,14,11040
1625,5,0,14,11,40470900,3668,156780,14,11045
1626,14,0,20,5,40487280,3667,156780,14,11059
1627,8,0,16,9,40526160,3667,156780,14,11067
1628,2,0,12,13,40549380,3667,156780,14,11069
1629,8,0,14,11,40568340,3667,156780,14,11077
1630,4,0,15,10,40584240,3667,156780,14,11081
1631,6,0,14,11,40610580,3667,156780,14,11087
1632,4,0,13,12,40623300,3667,156780,14,11091
1633,3,0,13,12,40639140,3667,156780,14,11094
1634,4,0,10,15,40662420,3667,156780,14,11098
1635,1,0,10,15,40665960,3667,156780,14,11099
1636,3,0,10,15,40671660,3666,156780,14,11102
1637,3,0,10,15,40676580,3666,156780,14,11105
1638,5,0,14,11,40684500,3666,156780,14,11110
1639,5,0,15,10,40697400,3666,156780,14,11115
1640,10,0,18,7,40718880,3666,156780,14,11125
1641,6,0,16,9,40742280,3665,156780,14,11131
1642,5,0,12,13,40773060,3665,156780,14,11136
1643,10,0,18,7,40790040,3665,156780,14,11146
1644,9,0,16,9,40819500,3664,156780,14,11155
1645,11,0,23,2,40831020,3664,156780,14,11166
1646,10,0,19,6,40879740,3664,156780,14,11176
1647,9,0,17,8,40915020,3663,156780,14,11185
1648,7,0,16,9,40932720,3662,156780,14,11192
1649,7,0,16,9,40958100,3662,156780,13,11199
1650,6,0,15,10,40985160,3662,156780,13,11205
1651,5,0,16,9,41001780,3662,156780,13,11210
1652,4,0,13,12,41028180,3662,156780,13,11214
1653,8,0,16,9,41042220,3662,156780,13,11222
1654,5,0,14,11,41067360,3662,156780,13,11227
1655,4,0,15,10,41083080,3662,156780,13,11231
1656,6,0,16,9,41092740,3662,156780,13,11237
1657,4,0,16,9,41115540,3662,156780,13,11241
1658,2,0,11,14,41153940,3663,156780,13,11243
1659,5,0,13,12,41163360,3663,156780,13,11248
1660,6,0,14,11,41174700,3663,156780,13,11254
1661,2,0,12,13,41188440,3663,156780,13,11256
1662,6,0,14,11,41199900,3662,156780,13,11262
1663,13,0,24,1,41214900,3663,156780,13,11275
1664,11,1,25,0,41245200,3662,157560,13,11286
1665,11,0,23,2,41312940,3664,159120,14,11297
1666,14,2,25,0,41343180,3663,161160,14,11311
1667,9,0,20,5,41411460,3664,163860,14,11320
1668,3,0,14,11,41459760,3666,163860,14,11323
1669,10,0,17,8,41486580,3666,163860,14,11333
1670,6,0,16,9,41508900,3665,163860,14,11339
1671,6,0,13,12,41547480,3666,163860,14,11345
1672,8,0,14,11,41557440,3665,163860,14,11353
1673,8,0,16,9,41566620,3663,163860,14,11361
1674,7,0,17,8,41608020,3665,163860,14,11368
1675,6,0,16,9,41630880,3665,163860,14,11374
1676,3,0,13,12,41655600,3665,163860,14,11377
1677,7,0,15,10,41670360,3665,163860,14,11384
1678,4,0,13,12,41690760,3665,163860,14,11388
1679,7,0,14,11,41702040,3664,163860,14,11395
1680,7,0,15,10,41718480,3663,163860,14,11402
1681,5,0,15,10,41739960,3663,163860,14,11407
1682,7,0,15,10,41755680,3663,163860,14,11414
1683,5,0,16,9,41763480,3662,163860,14,11419
1684,3,0,13,12,41792340,3663,163860,14,11422
1685,5,0,13,12,41814600,3663,163860,14,11427
1686,4,0,15,10,41829540,3664,163860,14,11431
1687,10,0,17,8,41852700,3663,163860,14,11441
1688,1,0,11,14,41870520,3662,163860,14,11442
1689,11,0,17,8,41883480,3662,163860,14,11453
1690,5,0,17,8,41894940,3661,163860,14,11458
1691,9,0,20,5,41923860,3662,163860,14,11467
1692,13,0,23,2,41971800,3663,163860,14,11480
1693,3,0,13,12,42022320,3663,163860,14,11483
1694,4,0,11,14,42042900,3663,163860,14,11487
1695,8,0,17,8,42047700,3663,163860,14,11495
1696,11,0,15,10,42071160,3661,163860,14,11506
1697,6,0,13,12,42097200,3660,163860,14,11512
1698,4,0,13,12,42108180,3660,163860,14,11516
1699,9,0,18,7,42128220,3661,163860,14,11525
1700,6,0,15,10,42156120,3660,163860,14,11531
1701,10,0,18,7,42185940,3661,163860,14,11541
1702,4,0,13,12,42217980,3660,163860,14,11545
1703,7,0,17,8,42229020,3660,163860,14,11552
1704,4,0,16,9,42250380,3661,163860,14,11556
1705,4,0,14,11,42280800,3661,163860,14,11560
1706,7,0,16,9,42294240,3661,163860,14,11567
1707,6,0,14,11,42319980,3661,163860,14,11573
1708,3,0,10,15,42343500,3661,163860,14,11576
1709,6,0,14,11,42347280,3660,163860,14,11582
1710,7,0,16,9,42354120,3659,163860,14,11589
1711,5,0,14,11,42370320,3658,163860,14,11594
1712,7,0,13,12,42406260,3659,163860,14,11601
1713,7,0,16,9,42423180,3659,163860,14,11608
1714,7,0,15,10,42447060,3659,163860,14,11615
1715,10,0,17,8,42469620,3658,163860,14,11625
1716,9,0,20,5,42494460,3658,163860,14,11634
1717,12,0,25,0,42528960,3659,164580,14,11646
1718,14,3,25,0,42574920,3660,165060,14,11660
1719,15,0,24,1,42651000,3660,169380,14,11675
1720,9,0,20,5,42698220,3660,169380,14,11684
1721,6,0,16,9,42738300,3660,169380,14,11690
1722,4,0,12,13,42780240,3662,169380,14,11694
1723,7,0,14,11,42793740,3661,169380,14,11701
1724,4,0,11,14,42815400,3661,169380,14,11705
1725,5,0,11,14,42824580,3660,169380,14,11710
1726,5,0,12,13,42835560,3660,169380,14,11715
1727,4,0,14,11,42843780,3660,169380,14,11719
1728,3,0,13,12,42854100,3659,169380,14,11722
1729,5,0,15,10,42868980,3660,169380,14,11727
1730,6,0,16,9,42885540,3660,169380,14,11733
1731,5,0,15,10,42905820,3659,169380,14,11738
1732,8,0,13,12,42937200,3659,169380,14,11746
1733,3,0,14,11,42939480,3659,169380,14,11749
1734,2,0,11,14,42960120,3659,169380,14,11751
1735,5,0,15,10,42960660,3659,169380,14,11756
1736,3,0,13,12,42978660,3659,169380,14,11759
1737,8,0,14,11,43011960,3659,169380,14,11767
1738,13,0,22,3,43023900,3659,169380,14,11780
1739,8,0,18,7,43064160,3658,169380,14,11788
1740,11,0,16,9,43110720,3658,169380,14,11799
1741,9,0,21,4,43116180,3657,169380,14,11808
1742,6,0,18,7,43157280,3658,169380,14,11814
1743,10,0,23,2,43181640,3659,169380,14,11824
1744,14,3,25,0,43215900,3659,170700,14,11838
1745,6,0,16,9,43308300,3661,174120,14,11844
1746,8,0,19,6,43329360,3661,174120,14,11852
1747,10,0,15,10,43378500,3661,174120,14,11862
1748,5,0,17,8,43390380,3661,174120,14,11867
1749,6,0,17,8,43419720,3662,174120,14,11873
1750,3,0,13,12,43445400,3662,174120,14,11876
1751,3,0,12,13,43463280,3662,174120,14,11879
1752,3,0,13,12,43472640,3662,174120,14,11882
1753,5,0,12,13,43486860,3662,174120,14,11887
1754,3,0,13,12,43495440,3662,174120,14,11890
1755,4,0,12,13,43507320,3661,174120,14,11894
1756,3,0,11,14,43516740,3661,174120,14,11897
1757,5,0,11,14,43526880,3660,174120,14,11902
1758,5,0,14,11,43537500,3660,174120,14,11907
1759,4,0,14,11,43550940,3660,174120,14,11911
1760,10,0,16,9,43580460,3660,174120,14,11921
1761,5,0,15,10,43595820,3660,174120,14,11926
1762,8,0,19,6,43614360,3660,174120,14,11934
1763,10,0,19,6,43649880,3660,174120,14,11944
1764,11,0,20,5,43687980,3660,174120,14,11955
1765,6,0,18,7,43726980,3661,174120,14,11961
1766,7,0,19,6,43750200,3661,174120,14,11968
1767,7,0,16,9,43788780,3661,174120,14,11975
1768,8,0,15,10,43825920,3661,174120,14,11983
1769,6,0,14,11,43839960,3660,174120,14,11989
1770,6,0,15,10,43861380,3661,174120,14,11995
1771,9,0,14,11,43890420,3660,174120,14,12004
1772,5,0,15,10,43902420,3660,174120,14,12009
1773,3,0,11,14,43928040,3660,174120,14,12012
1774,5,0,13,12,43934640,3660,174120,14,12017
1775,3,0,12,13,43950900,3660,174120,14,12020
1776,4,0,11,14,43965060,3659,174120,14,12024
1777,3,0,11,14,43967460,3659,174120,14,12027
1778,5,0,11,14,43976700,3658,174120,14,12032
1779,4,0,12,13,43979220,3657,174120,14,12036
1780,4,0,12,13,43993560,3657,174120,14,12040
1781,2,0,10,15,44003040,3657,174120,14,12042
1782,6,0,15,10,44011320,3657,174120,14,12048
1783,7,0,16,9,44026920,3657,174120,14,12055
1784,6,0,14,11,44048160,3656,174120,14,12061
1785,7,0,16,9,44060640,3655,174120,14,12068
1786,8,0,14,11,44087040,3655,174120,14,12076
1787,12,0,22,3,44098500,3654,174120,14,12088
1788,7,0,19,6,44128740,3654,174120,14,12095
1789,6,0,16,9,44164920,3654,174120,14,12101
1790,7,0,16,9,44210880,3656,174120,14,12108
1791,7,0,18,7,44220540,3655,174120,14,12115
1792,8,0,15,10,44248560,3654,174120,14,12123
1793,6,0,15,10,44272020,3654,174120,14,12129
1794,6,0,15,10,44302320,3655,174120,14,12135
1795,9,0,16,9,44329140,3655,174120,14,12144
1796,8,0,16,9,44353680,3654,174120,14,12152
1797,8,0,16,9,44383200,3654,174120,14,12160
1798,6,0,16,9,44408580,3655,174120,14,12166
1799,5,0,13,12,44435160,3654,174120,14,12171
1800,3,0,13,12,44456340,3655,174120,14,12174
1801,3,0,12,13,44470140,3655,174120,14,12177
1802,3,0,13,12,44482500,3655,174120,14,12180
1803,6,0,16,9,44489820,3655,174120,14,12186
1804,4,0,13,12,44520300,3656,174120,14,12190
1805,5,0,12,13,44545860,3656,174120,14,12195
1806,11,0,18,7,44559300,3655,174120,14,12206
1807,5,0,16,9,44585340,3656,174120,14,12211
1808,4,0,12,13,44620500,3656,174120,14,12215
1809,5,0,13,12,44634900,3656,174120,14,12220
1810,8,0,15,10,44649300,3655,174120,14,12228
1811,6,0,16,9,44662440,3655,174120,14,12234
1812,8,0,15,10,44693880,3655,174120,14,12242
1813,6,0,16,9,44710920,3655,174120,14,12248
1814,11,0,22,3,44727960,3655,174120,14,12259
1815,9,0,17,8,44774940,3654,174120,14,12268
1816,6,0,18,7,44796720,3655,174120,14,12274
1817,5,0,13,12,44842980,3655,174120,14,12279
1818,11,0,20,5,44854500,3655,174120,14,12290
1819,9,0,14,11,44904180,3655,174120,14,12299
1820,5,0,15,10,44922600,3655,174120,14,12304
1821,7,0,15,10,44944140,3655,174120,14,12311
1822,2,0,13,12,44960820,3655,174120,14,12313
1823,5,0,13,12,44978340,3655,174120,14,12318
1824,8,0,20,5,44979120,3655,174120,14,12326
1825,7,0,18,7,45016380,3655,174120,14,12333
1826,4,0,13,12,45046620,3655,174120,14,12337
1827,5,0,13,12,45066660,3655,174120,14,12342
1828,6,0,15,10,45085620,3655,174120,14,12348
1829,6,0,16,9,45098580,3655,174120,14,12354
1830,8,0,17,8,45118620,3654,174120,14,12362
1831,9,0,18,7,45147120,3654,174120,14,12371
1832,7,0,18,7,45173340,3654,174120,14,12378
1833,4,0,15,10,45208020,3655,174120,14,12382
1834,12,0,17,8,45247980,3655,174120,14,12394
1835,6,0,16,9,45265380,3655,174120,14,12400
1836,10,0,19,6,45286020,3654,174120,14,12410
1837,11,0,21,4,45315720,3654,174120,14,12421
1838,9,0,17,8,45357120,3654,174120,14,12430
1839,6,0,16,9,45386520,3654,174120,14,12436
1840,5,0,16,9,45409080,3654,174120,13,12441
1841,12,0,20,5,45441420,3654,174120,13,12453
1842,7,0,18,7,45474360,3654,174120,13,12460
1843,7,0,19,6,45494460,3654,174120,13,12467
1844,4,0,15,10,45538500,3655,174120,13,12471
1845,2,0,12,13,45567420,3656,174120,13,12473
1846,8,0,13,12,45586140,3656,174120,13,12481
1847,5,0,11,14,45603840,3655,174120,13,12486
1848,1,0,10,15,45612600,3655,174120,13,12487
1849,3,0,12,13,45613380,3655,174120,13,12490
1850,3,0,11,14,45621840,3655,174120,13,12493
1851,2,0,11,14,45629460,3655,174120,13,12495
1852,3,0,12,13,45638100,3655,174120,13,12498
1853,7,0,17,8,45639420,3654,174120,13,12505
1854,6,0,15,10,45672780,3654,174120,13,12511
1855,16,0,24,1,45697800,3654,174120,13,12527
1856,10,0,22,3,45732240,3654,174120,13,12537
1857,18,0,23,2,45789240,3653,174360,13,12555
1858,7,0,18,7,45832080,3653,174360,13,12562
1859,9,0,18,7,45875100,3654,174360,13,12571
1860,6,0,18,7,45895740,3654,174360,13,12577
1861,14,0,22,3,45932940,3654,174360,13,12591
1862,9,0,18,7,45975480,3654,174360,13,12600
1863,8,0,21,4,45995460,3654,174360,13,12608
1864,8,0,17,8,46039740,3654,174360,13,12616
1865,12,0,17,8,46080780,3654,174360,13,12628
1866,5,0,15,10,46105080,3653,174360,13,12633
1867,12,0,19,6,46128240,3653,174360,13,12645
1868,4,0,12,13,46164780,3653,174360,13,12649
1869,5,0,12,13,46188000,3653,174360,13,12654
1870,4,0,13,12,46199580,3653,174360,13,12658
1871,1,0,11,14,46209720,3653,174360,13,12659
1872,9,0,15,10,46227000,3653,174360,13,12668
1873,4,0,14,11,46234680,3652,174360,13,12672
1874,6,0,17,8,46249320,3652,174360,13,12678
1875,4,0,14,11,46275300,3652,174360,13,12682
1876,3,0,12,13,46291860,3652,174360,13,12685
1877,7,0,15,10,46307940,3652,174360,13,12692
1878,5,0,18,7,46316820,3653,174360,13,12697
1879,5,0,14,11,46354020,3653,174360,13,12702
1880,6,0,10,15,46384800,3652,174360,13,12708
1881,8,0,17,8,46385580,3652,174360,13,12716
1882,9,0,21,4,46398900,3652,174360,13,12725
1883,10,0,22,3,46425480,3651,174360,13,12735
1884,11,0,20,5,46491840,3653,174360,13,12746
1885,9,0,20,5,46522800,3653,174360,13,12755
1886,10,0,20,5,46562220,3653,174360,13,12765
1887,13,0,24,1,46600020,3653,174360,13,12778
1888,8,0,16,9,46651380,3653,174540,13,12786
1889,13,0,20,5,46673520,3652,174540,13,12799
1890,11,0,21,4,46723140,3653,174540,13,12810
1891,4,0,16,9,46762260,3653,174540,13,12814
1892,7,0,17,8,46791120,3654,174540,13,12821
1893,8,0,17,8,46823820,3654,174540,13,12829
1894,4,0,15,10,46842060,3654,174540,13,12833
1895,7,0,16,9,46883040,3655,174540,13,12840
1896,10,0,20,5,46903980,3655,174540,13,12850
1897,6,0,13,12,46942980,3655,174540,13,12856
1898,3,0,11,14,46959960,3655,174540,13,12859
1899,6,0,13,12,46971420,3654,174540,13,12865
1900,5,0,14,11,46986240,3654,174540,13,12870
1901,2,0,13,12,47004840,3655,174540,13,12872
1902,4,0,15,10,47015100,3655,174540,13,12876
1903,11,0,20,5,47034120,3655,174540,13,12887
1904,15,0,23,2,47077080,3655,174540,13,12902
1905,11,0,20,5,47107800,3653,174540,13,12913
1906,8,0,16,9,47163720,3654,174540,13,12921
1907,10,0,20,5,47180520,3654,174540,13,12931
1908,7,0,16,9,47225520,3654,174540,13,12938
1909,10,0,20,5,47237580,3653,174540,13,12948
1910,7,0,15,10,47273220,3653,174540,13,12955
1911,6,0,15,10,47299140,3653,174540,13,12961
1912,14,0,19,6,47325660,3652,174540,13,12975
1913,12,0,25,0,47339640,3652,174540,13,12987
1914,10,0,20,5,47400480,3652,174540,13,12997
1915,7,0,20,5,47438700,3653,174540,13,13004
1916,5,0,15,10,47485080,3654,174540,13,13009
1917,9,0,18,7,47499120,3653,174540,13,13018
1918,0,0,14,11,47514300,3653,174540,13,13018
1919,5,0,11,14,47552640,3654,174540,13,13023
1920,8,0,14,11,47560380,3653,174540,13,13031
1921,5,0,15,10,47578260,3653,174540,13,13036
1922,3,0,12,13,47602800,3654,174540,13,13039
1923,2,0,11,14,47617560,3654,174540,13,13041
1924,6,0,14,11,47625360,3654,174540,13,13047
1925,2,0,10,15,47651280,3654,174540,13,13049
1926,5,0,13,12,47653620,3654,174540,13,13054
1927,5,0,14,11,47660880,3653,174540,13,13059
1928,6,0,15,10,47688000,3654,174540,13,13065
1929,6,0,16,9,47698380,3653,174540,13,13071
1930,6,0,16,9,47726760,3654,174540,13,13077
1931,13,0,20,5,47759100,3654,174540,13,13090
1932,11,0,18,7,47787900,3652,174540,13,13101
1933,8,0,18,7,47814600,3652,174540,13,13109
1934,8,0,16,9,47860440,3653,174540,13,13117
1935,6,0,17,8,47871300,3652,174540,13,13123
1936,6,0,15,10,47904480,3652,174540,13,13129
1937,5,0,13,12,47931600,3653,174540,13,13134
1938,8,0,17,8,47952120,3653,174540,13,13142
1939,9,0,18,7,47973000,3652,174540,13,13151
1940,11,0,18,7,48005580,3652,174540,13,13162
1941,11,0,21,4,48028440,3651,174540,13,13173
1942,9,0,17,8,48085020,3652,174540,13,13182
1943,2,0,13,12,48116400,3653,174540,13,13184
1944,4,0,14,11,48127980,3653,174540,13,13188
1945,3,0,12,13,48150000,3653,174540,13,13191
1946,5,0,14,11,48157260,3653,174540,13,13196
1947,4,0,13,12,48179400,3653,174540,13,13200
1948,2,0,12,13,48185940,3653,174540,13,13202
1949,4,0,13,12,48203100,3653,174540,13,13206
1950,6,0,15,10,48211020,3653,174540,13,13212
1951,7,0,16,9,48227160,3652,174540,13,13219
1952,8,0,17,8,48250740,3652,174540,13,13227
1953,7,0,16,9,48290040,3653,174540,13,13234
1954,11,0,19,6,48311820,3652,174540,13,13245
1955,10,0,21,4,48327120,3651,174540,13,13255
1956,10,0,20,5,48377100,3652,174540,13,13265
1957,9,0,20,5,48412080,3652,174540,13,13274
1958,12,0,19,6,48467160,3653,174540,13,13286
1959,14,0,23,2,48488580,3652,174540,13,13300
1960,7,0,17,8,48549780,3653,174540,13,13307
1961,13,0,23,2,48580920,3653,174540,13,13320
1962,7,0,16,9,48635640,3653,174600,13,13327
1963,3,0,12,13,48668040,3654,174600,13,13330
1964,8,0,16,9,48680340,3654,174600,13,13338
1965,4,0,16,9,48695520,3654,174600,13,13342
1966,6,0,14,11,48727440,3654,174600,13,13348
1967,3,0,14,11,48739560,3654,174600,13,13351
1968,1,0,9,16,48767100,3654,174600,13,13352
1969,4,0,11,14,48771420,3654,174600,13,13356
1970,4,0,12,13,48776220,3654,174600,13,13360
1971,7,0,15,10,48782160,3653,174600,13,13367
1972,5,0,14,11,48801900,3653,174600,13,13372
1973,4,0,14,11,48815280,3653,174600,13,13376
1974,4,0,14,11,48834300,3653,174600,13,13380
1975,8,0,17,8,48850020,3653,174600,13,13388
1976,6,0,15,10,48878940,3653,174600,13,13394
1977,10,0,18,7,48896820,3652,174600,13,13404
1978,5,0,14,11,48934500,3653,174600,13,13409
1979,10,0,18,7,48952080,3652,174600,13,13419
1980,10,0,19,6,48986340,3652,174600,13,13429
1981,7,0,18,7,49018080,3653,174600,12,13436
1982,13,0,18,7,49063380,3652,174600,12,13449
1983,8,0,21,4,49080600,3652,174600,12,13457
1984,13,0,21,4,49118160,3652,174600,12,13470
1985,3,0,16,9,49150560,3652,174600,12,13473
1986,7,0,14,11,49189920,3652,174600,12,13480
1987,5,0,13,12,49213980,3653,174600,12,13485
1988,4,0,13,12,49225440,3652,174600,12,13489
1989,4,0,13,12,49235520,3652,174600,12,13493
1990,3,0,15,10,49236600,3652,174600,12,13496
1991,7,0,16,9,49254060,3651,174600,12,13503
1992,5,0,15,10,49278480,3652,174600,12,13508
1993,3,0,12,13,49312560,3653,174600,12,13511
1994,1,0,10,15,49329540,3653,174600,12,13512
1995,0,0,9,16,49330680,3653,174600,12,13512
1996,5,0,13,12,49331400,3653,174600,12,13517
1997,9,0,16,9,49344600,3652,174600,12,13526
1998,12,0,18,7,49368000,3651,174600,12,13538
1999,6,0,15,10,49398780,3651,174600,12,13544
2000,10,0,16,9,49425420,3650,174600,12,13554
2001,5,0,15,10,49446480,3650,174600,12,13559
2002,4,0,12,13,49470840,3650,174600,12,13563
2003,7,0,14,11,49484520,3650,174600,12,13570
2004,7,0,18,7,49496460,3650,174600,12,13577
2005,11,0,19,6,49524720,3649,174600,12,13588
2006,9,0,15,10,49564140,3649,174600,12,13597
2007,7,0,15,10,49578480,3648,174600,12,13604
2008,11,0,18,7,49607640,3648,174600,12,13615
2009,7,0,16,9,49629900,3647,174600,12,13622
2010,3,0,12,13,49661340,3648,174600,12,13625
2011,8,0,15,10,49677480,3647,174600,12,13633
2012,3,0,15,10,49686600,3647,174600,12,13636
2013,2,0,12,13,49709820,3648,174600,12,13638
2014,4,0,13,12,49728840,3648,174600,12,13642
2015,5,0,12,13,49745100,3648,174600,12,13647
2016,6,0,17,8,49750200,3648,174600,12,13653
2017,2,0,18,7,49753020,3648,174600,12,13655
2018,7,0,22,3,49755780,3647,174600,12,13662
2019,3,0,19,6,49779360,3647,174600,12,13665
2020,4,0,21,4,49785900,3647,174600,12,13669
2021,3,0,20,5,49807080,3648,174600,12,13672
2022,5,0,21,4,49824840,3648,174600,12,13677
2023,0,0,17,8,49841280,3648,174600,12,13677
2024,2,0,17,8,49852260,3648,174600,12,13679
2025,8,0,20,5,49858020,3648,174600,12,13687
2026,9,0,25,0,49864080,3647,174600,12,13696
2027,13,2,25,0,49900320,3647,177480,12,13709
2028,9,7,25,0,49917180,3647,180000,13,13718
2029,7,8,25,0,49955760,3648,195780,14,13725
2030,6,9,25,0,49989660,3649,207420,15,13731
2031,8,10,25,0,50019060,3649,235200,17,13739
2032,10,12,25,0,50056200,3650,239940,17,13749
2033,9,13,25,0,50082120,3650,258900,18,13758
2034,9,8,25,0,50127060,3649,301800,21,13767
2035,7,5,25,0,50151900,3649,365280,26,13774
2036,4,0,19,6,50201700,3648,429660,31,13778
2037,1,0,20,5,50201700,3648,429660,31,13779
2038,6,0,20,5,50225340,3648,429660,31,13785
2039,4,0,20,5,50239080,3648,429660,31,13789
2040,5,0,20,5,50255760,3648,429660,31,13794
2041,3,0,20,5,50260740,3648,429660,31,13797
2042,3,0,19,6,50271780,3647,429660,31,13800
2043,9,0,23,2,50292780,3648,429660,31,13809
2044,9,4,25,0,50299560,3647,430560,31,13818
2045,6,0,23,2,50351160,3648,441000,31,13824
2046,7,0,20,5,50375100,3647,441000,31,13831
2047,6,0,21,4,50390280,3647,441000,31,13837
2048,5,0,17,8,50412360,3646,441000,31,13842
2049,7,0,22,3,50414040,3646,441000,31,13849
2050,8,0,25,0,50425200,3645,441000,31,13857
2051,9,0,22,3,50467080,3645,441420,31,13866
2052,10,0,24,1,50486580,3644,441420,31,13876
2053,12,3,25,0,50506980,3644,443040,31,13888
2054,4,0,24,1,50535060,3644,448740,32,13892
2055,4,0,20,5,50565660,3644,448740,32,13896
2056,8,0,24,1,50586720,3644,448740,32,13904
2057,6,0,21,4,50615520,3644,449400,32,13910
2058,7,0,22,3,50643780,3644,449400,32,13917
2059,16,6,25,0,50663040,3644,450180,32,13933
2060,8,10,25,0,50683860,3644,459180,32,13941
2061,2,1,25,0,50743620,3646,503940,36,13943
2062,5,0,18,7,50767260,3644,508440,36,13948
2063,3,0,18,7,50773800,3644,508440,36,13951
2064,6,0,18,7,50782380,3643,508440,36,13957
2065,2,0,18,7,50790780,3643,508440,36,13959
2066,6,0,21,4,50793300,3642,508440,36,13965
2067,5,0,22,3,50814600,3643,508440,36,13970
2068,4,0,20,5,50834220,3642,508440,36,13974
2069,3,0,20,5,50845740,3643,508440,36,13977
2070,6,0,20,5,50858760,3642,508440,36,13983
2071,6,0,23,2,50862780,3641,508440,36,13989
2072,5,0,23,2,50879700,3641,508440,36,13994
2073,14,3,25,0,50915040,3641,509580,36,14008
2074,18,15,25,0,50932860,3641,512640,36,14026
2075,10,19,25,0,50966340,3642,519120,36,14036
2076,10,23,25,0,51005880,3643,531540,37,14046
2077,13,32,25,0,51026820,3644,538500,38,14059
2078,10,37,25,0,51063420,3645,542520,38,14069
2079,13,40,25,0,51103080,3646,586800,41,14082
2080,9,39,25,0,51124740,3647,623220,44,14091
2081,4,32,25,0,51179520,3648,760920,54,14095
2082,9,32,25,0,51210960,3648,870420,61,14104
2083,9,34,25,0,51230820,3648,892320,63,14113
2084,7,37,25,0,51251460,3648,913500,64,14120
2085,9,34,25,0,51306180,3649,1023240,72,14129
2086,7,33,25,0,51333720,3649,1033020,73,14136
2087,3,21,25,0,51373980,3648,1471920,104,14139
2088,7,2,25,0,51408480,3643,2008800,142,14146
2089,3,0,21,4,51425220,3642,2063580,145,14149
2090,5,0,21,4,51444240,3642,2063580,145,14154
2091,7,0,24,1,51465120,3643,2063580,145,14161
2092,4,0,21,4,51488040,3643,2063580,145,14165
2093,4,0,22,3,51504660,3643,2063580,145,14169
2094,9,0,25,0,51519720,3643,2063880,145,14178
2095,5,0,22,3,51561600,3643,2063940,145,14183
2096,9,0,25,0,51584220,3643,2063940,145,14192
2097,7,0,23,2,51610500,3643,2063940,145,14199
2098,8,0,21,4,51638160,3642,2063940,145,14207
2099,7,0,24,1,51647400,3642,2063940,145,14214
2100,9,0,23,2,51681780,3642,2065800,145,14223
2101,14,6,25,0,51711780,3642,2069700,145,14237
2102,11,12,25,0,51735300,3643,2073900,145,14248
2103,3,7,25,0,51779880,3644,2119440,148,14251
2104,16,16,25,0,51804780,3644,2124060,149,14267
2105,8,17,25,0,51836880,3644,2142240,150,14275
2106,8,17,25,0,51871620,3645,2164500,151,14283
2107,5,15,25,0,51894840,3645,2172840,152,14288
2108,5,2,25,0,51947460,3644,2375640,166,14293
2109,7,0,21,4,51975540,3642,2402520,168,14300
2110,4,0,19,6,52000200,3643,2402520,168,14304
2111,6,0,21,4,52013520,3642,2402520,168,14310
2112,1,0,20,5,52019940,3642,2402520,168,14311
2113,12,1,25,0,52050840,3643,2403780,167,14323
2114,5,0,22,3,52073700,3642,2403840,167,14328
2115,5,0,21,4,52102260,3643,2403840,167,14333
2116,1,0,17,8,52128060,3643,2403840,167,14334
2117,2,0,18,7,52135800,3644,2403840,167,14336
2118,6,0,21,4,52144320,3643,2403840,167,14342
2119,7,0,22,3,52162020,3643,2403840,167,14349
2120,5,0,23,2,52171140,3643,2403840,167,14354
2121,6,0,23,2,52199400,3643,2403840,167,14360
2122,6,2,25,0,52215780,3644,2405820,167,14366
2123,11,6,25,0,52251300,3645,2412780,167,14377
2124,9,10,25,0,52281660,3645,2416800,168,14386
2125,11,17,25,0,52305960,3646,2419080,168,14397
2126,14,25,25,0,52348200,3647,2428620,168,14411
2127,9,31,25,0,52369020,3648,2440800,169,14420
2128,8,34,25,0,52402980,3649,2451060,170,14428
2129,6,35,25,0,52440660,3651,2461860,170,14434
2130,8,36,25,0,52477560,3651,2525520,175,14442
2131,5,35,25,0,52501920,3652,2558220,177,14447
2132,6,35,25,0,52535520,3652,2585580,179,14453
2133,10,38,25,0,52574100,3653,2671860,184,14463
2134,5,35,25,0,52612740,3654,2769660,191,14468
2135,4,30,25,0,52651800,3654,2939820,203,14472
2136,6,25,25,0,52683120,3654,3118680,215,14478
2137,3,16,25,0,52712220,3653,3384540,233,14481
2138,5,0,19,6,52759920,3649,3863460,266,14486
2139,3,0,18,7,52766640,3649,3863460,266,14489
2140,7,0,22,3,52774080,3648,3863460,266,14496
2141,4,0,19,6,52799760,3648,3863460,266,14500
2142,3,0,18,7,52818480,3649,3863460,266,14503
2143,6,0,21,4,52827060,3649,3863460,266,14509
2144,8,0,22,3,52840080,3648,3863460,266,14517
2145,4,0,22,3,52851900,3647,3863460,266,14521
2146,9,0,23,2,52871820,3647,3863460,266,14530
2147,10,0,25,0,52901400,3647,3865260,266,14540
2148,5,0,21,4,52927440,3646,3865620,265,14545
2149,4,0,20,5,52950780,3647,3865620,265,14549
2150,6,0,21,4,52973580,3647,3865620,265,14555
2151,7,0,24,1,52981560,3647,3865620,265,14562
2152,5,0,22,3,53009100,3647,3865620,265,14567
2153,8,0,25,0,53031600,3647,3866100,265,14575
2154,8,2,25,0,53053380,3647,3870900,265,14583
2155,5,0,21,4,53090940,3647,3872580,265,14588
2156,6,0,22,3,53107980,3647,3872580,265,14594
2157,3,0,17,8,53129400,3646,3872580,265,14597
2158,7,0,21,4,53141220,3646,3872580,265,14604
2159,5,0,20,5,53155620,3646,3872580,265,14609
2160,6,0,23,2,53173140,3646,3872580,265,14615
2161,6,1,25,0,53181000,3646,3874260,265,14621
2162,7,0,23,2,53221920,3646,3877320,265,14628
2163,4,0,20,5,53243400,3646,3877320,265,14632
2164,9,0,20,5,53271300,3646,3877320,265,14641
2165,6,0,22,3,53284260,3646,3877320,264,14647
2166,6,0,24,1,53295240,3645,3877320,264,14653
2167,3,0,21,4,53317380,3645,3877320,264,14656
2168,8,0,23,2,53346120,3646,3877320,264,14664
2169,5,0,21,4,53366460,3645,3877320,264,14669
2170,7,0,21,4,53385600,3645,3877320,264,14676
2171,6,0,22,3,53405820,3645,3877320,264,14682
2172,9,0,24,1,53425500,3645,3877320,264,14691
2173,9,2,25,0,53438520,3644,3878160,264,14700
2174,12,8,25,0,53466240,3645,3880380,263,14712
2175,5,8,25,0,53499300,3646,3888540,264,14717
2176,5,6,25,0,53537940,3646,3905220,265,14722
2177,9,8,25,0,53577360,3647,3909180,265,14731
2178,10,11,25,0,53602140,3647,3917580,265,14741
2179,7,13,25,0,53633580,3648,3920220,266,14748
2180,8,14,25,0,53672100,3649,3937620,267,14756
2181,6,14,25,0,53697120,3649,3966540,268,14762
2182,1,0,25,0,53733180,3648,4195920,284,14763
2183,3,0,16,9,53775420,3648,4195920,284,14766
2184,2,0,17,8,53776620,3648,4195920,284,14768
2185,10,0,24,1,53780100,3647,4195920,284,14778
2186,4,0,21,4,53795640,3647,4195920,284,14782
2187,6,0,20,5,53815380,3646,4195920,283,14788
2188,2,0,18,7,53835960,3647,4195920,283,14790
2189,3,0,20,5,53846520,3647,4195920,283,14793
2190,5,0,20,5,53862840,3647,4195920,283,14798
2191,5,0,20,5,53872560,3646,4195920,283,14803
2192,0,0,18,7,53886720,3647,4195920,283,14803
2193,6,0,21,4,53904300,3647,4195920,283,14809
2194,6,0,23,2,53912940,3647,4195920,283,14815
2195,10,2,25,0,53932020,3647,4195920,283,14825
2196,8,0,25,0,53965200,3647,4199160,283,14833
2197,6,0,24,1,53987160,3646,4199160,283,14839
2198,6,0,22,3,54020760,3647,4199160,283,14845
2199,10,4,25,0,54026940,3646,4200600,282,14855
2200,12,11,25,0,54051000,3647,4203360,283,14867
2201,17,19,25,0,54101340,3648,4214580,283,14884
2202,4,18,25,0,54127260,3648,4224360,283,14888
2203,5,19,25,0,54151260,3649,4237860,284,14893
2204,5,13,25,0,54204780,3650,4301580,288,14898
2205,8,15,25,0,54229380,3650,4336380,291,14906
2206,5,10,25,0,54261180,3650,4389000,294,14911
2207,2,0,18,7,54301680,3648,4584240,307,14913
2208,3,0,20,5,54309120,3648,4584240,307,14916
2209,0,0,16,9,54322980,3648,4584240,307,14916
2210,4,0,19,6,54324480,3648,4584240,307,14920
2211,4,0,22,3,54326880,3648,4584240,307,14924
2212,2,0,20,5,54345300,3648,4584240,307,14926
2213,6,0,20,5,54363060,3648,4584240,307,14932
2214,6,0,21,4,54375300,3647,4584240,307,14938
2215,8,0,24,1,54389760,3647,4584240,306,14946
2216,5,0,21,4,54417960,3647,4584240,306,14951
2217,7,0,22,3,54435120,3647,4584240,306,14958
2218,6,0,22,3,54449040,3646,4584240,306,14964
2219,2,0,19,6,54474360,3647,4584240,306,14966
2220,9,0,24,1,54483420,3646,4584240,306,14975
2221,10,0,23,2,54517320,3646,4585260,306,14985
2222,7,0,25,0,54529260,3645,4585260,306,14992
2223,13,7,25,0,54558000,3646,4588020,306,15005
2224,8,3,25,0,54587100,3645,4602180,306,15013
2225,12,8,25,0,54616680,3645,4605660,306,15025
2226,8,11,25,0,54644040,3646,4613100,307,15033
2227,8,7,25,0,54698820,3647,4631940,308,15041
2228,1,0,19,6,54724860,3645,4717680,313,15042
2229,3,0,18,7,54740820,3645,4717680,313,15045
2230,9,1,25,0,54743940,3645,4718160,313,15054
2231,3,0,21,4,54787440,3646,4719900,313,15057
2232,6,0,24,1,54795420,3646,4719900,313,15063
2233,3,0,22,3,54824940,3646,4719900,313,15066
2234,3,0,19,6,54856920,3647,4719900,313,15069
2235,9,1,25,0,54866580,3647,4719900,313,15078
2236,6,2,25,0,54884940,3647,4724280,313,15084
2237,4,0,23,2,54923520,3648,4737540,314,15088
2238,6,0,21,4,54946440,3648,4737540,314,15094
2239,8,0,25,0,54963600,3648,4737540,313,15102
2240,10,4,25,0,54983280,3648,4739340,313,15112
2241,5,4,25,0,55010340,3648,4748640,314,15117
2242,9,6,25,0,55042020,3649,4761060,315,15126
2243,10,4,25,0,55076100,3648,4777200,315,15136
2244,6,0,25,0,55114680,3648,4794660,316,15142
2245,13,2,25,0,55155900,3648,4798920,316,15155
2246,13,10,25,0,55174320,3648,4800780,316,15168
2247,7,12,25,0,55207980,3649,4810500,317,15175
2248,7,13,25,0,55248060,3650,4834440,318,15182
2249,9,14,25,0,55284660,3651,4877460,321,15191
2250,3,10,25,0,55312260,3651,4898820,322,15194
2251,5,8,25,0,55333020,3651,4928040,324,15199
2252,4,0,19,6,55379280,3649,5054700,332,15203
2253,4,0,20,5,55396140,3650,5054700,332,15207
2254,3,0,21,4,55402860,3650,5054700,332,15210
2255,2,0,19,6,55428540,3650,5054700,332,15212
2256,2,0,20,5,55433520,3651,5054700,332,15214
2257,4,0,18,7,55455480,3651,5054700,332,15218
2258,2,0,19,6,55461540,3651,5054700,332,15220
2259,3,0,19,6,55472940,3651,5054700,332,15223
2260,2,0,18,7,55493040,3651,5054700,332,15225
2261,7,0,23,2,55498440,3651,5054700,332,15232
2262,7,0,24,1,55517340,3651,5056320,332,15239
2263,3,0,20,5,55555320,3652,5056320,331,15242
2264,7,0,21,4,55571520,3651,5056320,331,15249
2265,5,0,19,6,55588440,3651,5056320,331,15254
2266,9,0,24,1,55601100,3651,5056320,331,15263
2267,4,0,22,3,55623480,3651,5056320,331,15267
2268,15,3,25,0,55645260,3650,5056920,331,15282
2269,6,0,25,0,55671960,3650,5060520,331,15288
2270,5,0,21,4,55701960,3649,5060520,331,15293
2271,14,2,25,0,55730280,3649,5061960,330,15307
2272,14,10,25,0,55749780,3649,5066640,330,15321
2273,7,11,25,0,55781400,3650,5075520,331,15328
2274,8,13,25,0,55814940,3651,5079840,331,15336
2275,7,16,25,0,55839840,3651,5102580,332,15343
2276,8,16,25,0,55876260,3652,5125080,334,15351
2277,3,8,25,0,55917240,3652,5222760,340,15354
2278,9,0,23,2,55950180,3649,5331960,347,15363
2279,6,0,21,4,55982760,3650,5331960,347,15369
2280,6,0,22,3,55997400,3649,5331960,347,15375
2281,3,0,18,7,56020620,3649,5331960,346,15378
2282,6,0,21,4,56026080,3649,5331960,346,15384
2283,7,0,25,0,56035860,3649,5331960,346,15391
2284,2,0,19,6,56071380,3649,5331960,346,15393
2285,8,0,24,1,56083440,3649,5331960,346,15401
2286,10,3,25,0,56114940,3650,5334480,346,15411
2287,7,3,25,0,56142720,3650,5340960,346,15418
2288,6,0,24,1,56183460,3650,5363340,347,15424
2289,6,0,23,2,56204940,3650,5363700,347,15430
2290,11,2,25,0,56230440,3650,5364840,347,15441
2291,9,5,25,0,56264280,3651,5368620,347,15450
2292,9,7,25,0,56294100,3651,5383140,348,15459
2293,8,8,25,0,56328240,3652,5391420,348,15467
2294,11,13,25,0,56356680,3652,5395080,348,15478
2295,10,14,25,0,56397780,3653,5415540,349,15488
2296,16,22,25,0,56426520,3653,5421780,350,15504
2297,7,22,25,0,56456040,3653,5429520,350,15511
2298,7,25,25,0,56476860,3653,5440620,350,15518
2299,3,19,25,0,56525580,3654,5507400,355,15521
2300,4,6,25,0,56564460,3653,5736420,369,15525
2301,3,0,21,4,56591880,3652,5866080,378,15528
2302,3,0,19,6,56608140,3651,5866080,377,15531
2303,6,0,22,3,56620740,3652,5866080,377,15537
2304,2,0,19,6,56638080,3651,5866080,377,15539
2305,5,0,21,4,56659200,3652,5866080,377,15544
2306,7,0,20,5,56675640,3651,5866080,377,15551
2307,5,0,21,4,56689860,3651,5866080,377,15556
2308,4,0,19,6,56711460,3651,5866080,377,15560
2309,4,0,18,7,56728200,3651,5866080,377,15564
2310,4,0,20,5,56734200,3651,5866080,377,15568
2311,5,0,20,5,56744460,3651,5866080,376,15573
2312,5,0,20,5,56762160,3651,5866080,376,15578
2313,7,0,21,4,56775540,3650,5866080,376,15585
2314,11,0,25,0,56798400,3650,5869380,376,15596
2315,7,0,23,2,56828700,3650,5871120,376,15603
2316,14,6,25,0,56849760,3650,5871900,376,15617
2317,7,7,25,0,56880060,3650,5881500,376,15624
2318,6,9,25,0,56901300,3651,5886840,376,15630
2319,13,16,25,0,56944380,3652,5898660,377,15643
2320,10,20,25,0,56980740,3653,5918700,378,15653
2321,11,22,25,0,57016680,3653,5950740,380,15664
2322,6,18,25,0,57049380,3653,5992980,382,15670
2323,5,13,25,0,57077520,3652,6078300,388,15675
2324,7,0,21,4,57124440,3650,6278880,400,15682
2325,4,0,20,5,57135960,3649,6278880,400,15686
2326,4,0,18,7,57158040,3649,6278880,400,15690
2327,4,0,21,4,57159000,3649,6278880,400,15694
2328,5,0,20,5,57175920,3649,6278880,400,15699
2329,4,0,21,4,57193860,3649,6278880,400,15703
2330,5,0,22,3,57205860,3649,6278880,400,15708
2331,6,0,20,5,57231960,3649,6278880,399,15714
2332,2,0,20,5,57237780,3649,6278880,399,15716
2333,7,0,24,1,57241740,3648,6278880,399,15723
2334,4,0,25,0,57258840,3649,6279840,399,15727
2335,3,0,18,7,57308940,3650,6280140,399,15730
2336,10,0,23,2,57326760,3649,6280140,399,15740
2337,1,0,19,6,57339000,3649,6280140,399,15741
2338,6,0,18,7,57364980,3649,6280140,399,15747
2339,8,0,25,0,57368400,3649,6280140,398,15755
2340,10,5,25,0,57387240,3649,6283680,398,15765
2341,8,6,25,0,57419640,3650,6294060,399,15773
2342,8,0,25,0,57456840,3649,6322200,400,15781
2343,9,0,22,3,57494100,3648,6323280,400,15790
2344,8,1,25,0,57508740,3648,6323700,400,15798
2345,8,3,25,0,57541680,3649,6325020,400,15806
2346,7,0,23,2,57584340,3649,6330840,400,15813
2347,7,0,22,3,57598200,3648,6330840,400,15820
2348,7,0,24,1,57623580,3648,6330840,400,15827
2349,9,0,25,0,57654240,3649,6331320,400,15836
2350,2,0,20,5,57688140,3649,6331320,400,15838
2351,4,0,20,5,57704640,3649,6331320,399,15842
2352,3,0,19,6,57724560,3649,6331320,399,15845
2353,6,0,19,6,57738300,3649,6331320,399,15851
2354,3,0,22,3,57738300,3649,6331320,399,15854
2355,4,0,24,1,57753960,3650,6331320,399,15858
2356,3,0,20,5,57783900,3650,6331320,399,15861
2357,7,0,23,2,57797520,3650,6331320,399,15868
2358,5,0,23,2,57812640,3650,6331320,399,15873
2359,11,0,25,0,57839760,3649,6331860,398,15884
2360,6,0,23,2,57867180,3649,6332460,398,15890
2361,6,0,23,2,57894420,3649,6332460,398,15896
2362,7,0,24,1,57915120,3649,6333180,398,15903
2363,8,1,25,0,57941160,3650,6335160,398,15911
2364,9,3,25,0,57965880,3650,6336000,398,15920
2365,11,3,25,0,58017480,3650,6344100,398,15931
2366,4,0,22,3,58049100,3650,6358440,399,15935
2367,10,0,22,3,58073280,3649,6358440,399,15945
2368,5,0,25,0,58077840,3649,6358440,398,15950
2369,8,0,22,3,58122660,3649,6358620,398,15958
2370,6,0,20,5,58138440,3648,6358620,398,15964
2371,7,0,24,1,58147200,3648,6358620,398,15971
2372,8,3,25,0,58165740,3649,6360180,398,15979
2373,3,0,22,3,58211340,3649,6365760,398,15982
2374,7,0,23,2,58237380,3650,6366060,398,15989
2375,7,0,23,2,58260600,3649,6366420,398,15996
2376,7,0,22,3,58290540,3650,6366420,398,16003
2377,0,0,18,7,58313760,3650,6366420,398,16003
2378,2,0,18,7,58328100,3650,6366420,398,16005
2379,5,0,20,5,58336620,3650,6366420,397,16010
2380,2,0,20,5,58347480,3651,6366420,397,16012
2381,6,0,21,4,58364100,3650,6366420,397,16018
2382,7,0,23,2,58385340,3651,6366420,397,16025
2383,6,0,21,4,58419480,3651,6366420,397,16031
2384,6,0,19,6,58435020,3650,6366420,397,16037
2385,9,0,24,1,58454700,3650,6366420,397,16046
2386,9,0,23,2,58473120,3649,6366660,396,16055
2387,6,0,22,3,58499820,3649,6366660,396,16061
2388,7,0,21,4,58531500,3650,6366660,396,16068
2389,11,0,25,0,58548540,3649,6367200,396,16079
2390,13,6,25,0,58569720,3649,6371400,396,16092
2391,14,13,25,0,58608900,3650,6378120,396,16106
2392,19,25,25,0,58636920,3650,6388680,396,16125
2393,4,25,25,0,58658580,3650,6395700,396,16129
2394,7,25,25,0,58700940,3651,6413880,397,16136
2395,4,25,25,0,58727760,3652,6431280,398,16140
2396,3,21,25,0,58759260,3652,6481500,401,16143
2397,5,15,25,0,58810860,3653,6623220,410,16148
2398,4,5,25,0,58836540,3651,6835800,423,16152
2399,5,0,21,4,58863120,3650,6924240,428,16157
2400,3,0,20,5,58884420,3650,6924240,428,16160
2401,5,0,20,5,58904580,3650,6924240,428,16165
2402,1,0,17,8,58917900,3650,6924240,428,16166
2403,5,0,19,6,58923240,3650,6924240,428,16171
2404,8,0,18,7,58937520,3649,6924240,428,16179
2405,8,0,23,2,58948140,3649,6924240,428,16187
2406,3,0,21,4,58967820,3649,6924240,427,16190
2407,7,0,21,4,58992600,3649,6924240,427,16197
2408,9,1,25,0,59006460,3649,6925560,427,16206
2409,14,9,25,0,59030940,3649,6928260,427,16220
2410,6,10,25,0,59056800,3649,6937440,427,16226
2411,7,11,25,0,59092020,3650,6946320,428,16233
2412,7,11,25,0,59125920,3651,6969360,429,16240
2413,10,4,25,0,59172660,3650,7037700,433,16250
2414,13,11,25,0,59191380,3650,7047780,433,16263
2415,11,18,25,0,59215920,3650,7053300,433,16274
2416,9,22,25,0,59248500,3651,7066560,434,16283
2417,6,24,25,0,59276460,3652,7080420,435,16289
2418,5,22,25,0,59327280,3654,7135680,438,16294
2419,6,21,25,0,59360760,3654,7162320,439,16300
2420,8,21,25,0,59392320,3654,7190040,441,16308
2421,6,23,25,0,59414940,3655,7205940,442,16314
2422,6,19,25,0,59454900,3655,7234620,443,16320
2423,6,0,21,4,59504520,3651,7709160,472,16326
2424,8,0,24,1,59509980,3651,7709160,472,16334
2425,3,0,23,2,59527560,3651,7710360,472,16337
2426,5,0,19,6,59562780,3651,7710360,472,16342
2427,3,0,20,5,59570940,3651,7710360,472,16345
2428,6,0,21,4,59588820,3651,7710360,471,16351
2429,8,0,25,0,59604660,3651,7710960,471,16359
2430,5,0,22,3,59635680,3651,7710960,471,16364
2431,8,0,22,3,59657460,3651,7710960,471,16372
2432,8,0,24,1,59674860,3650,7711260,471,16380
2433,8,0,22,3,59720040,3651,7712640,470,16388
2434,6,0,22,3,59743380,3651,7712640,470,16394
2435,10,1,25,0,59758680,3651,7714140,470,16404
2436,15,10,25,0,59786340,3651,7717200,470,16419
2437,8,10,25,0,59827920,3652,7734360,471,16427
2438,8,8,25,0,59857020,3651,7757220,472,16435
2439,9,2,25,0,59886000,3650,7820700,475,16444
2440,5,0,24,1,59912880,3650,7821540,475,16449
2441,7,0,24,1,59937300,3650,7822140,475,16456
2442,10,0,25,0,59975160,3650,7824840,475,16466
2443,9,5,25,0,59982900,3649,7826460,475,16475
2444,4,4,25,0,60018120,3650,7836240,475,16479
2445,5,0,19,6,60083460,3651,7846200,476,16484
2446,6,0,19,6,60100440,3651,7846200,476,16490
2447,7,0,24,1,60108240,3651,7846200,475,16497
2448,3,0,22,3,60125400,3651,7846200,475,16500
2449,5,0,22,3,60145440,3651,7846200,475,16505
2450,2,0,20,5,60165960,3651,7846200,475,16507
2451,4,0,20,5,60189360,3652,7846200,475,16511
2452,2,0,18,7,60210480,3652,7846200,475,16513
2453,4,0,19,6,60221460,3652,7846200,475,16517
2454,5,0,18,7,60235200,3652,7846200,475,16522
2455,8,0,22,3,60245580,3651,7846200,474,16530
2456,6,0,23,2,60261240,3651,7846200,474,16536
2457,12,3,25,0,60295920,3652,7850820,474,16548
2458,9,3,25,0,60329100,3652,7865880,475,16557
2459,7,3,25,0,60348900,3651,7870980,475,16564
2460,7,0,24,1,60385440,3651,7873980,475,16571
2461,10,2,25,0,60412080,3651,7873980,475,16581
2462,10,4,25,0,60441480,3651,7880820,475,16591
2463,5,6,25,0,60463680,3652,7886040,475,16596
2464,12,9,25,0,60511680,3653,7902420,476,16608
2465,11,12,25,0,60543360,3653,7911240,476,16619
2466,7,16,25,0,60560640,3653,7913160,476,16626
2467,10,21,25,0,60592320,3654,7923480,476,16636
2468,6,22,25,0,60630540,3655,7936500,477,16642
2469,3,16,25,0,60670440,3656,8026020,482,16645
2470,3,0,23,2,60707160,3653,8257980,496,16648
2471,6,0,18,7,60736140,3653,8257980,496,16654
2472,6,0,23,2,60742260,3653,8257980,496,16660
2473,1,0,21,4,60756900,3653,8257980,495,16661
2474,5,0,20,5,60778920,3653,8257980,495,16666
2475,2,0,17,8,60790980,3653,8257980,495,16668
2476,3,0,19,6,60792060,3653,8257980,495,16671
2477,4,0,20,5,60800760,3653,8257980,495,16675
2478,3,0,18,7,60815460,3652,8257980,495,16678
2479,7,0,23,2,60825960,3652,8257980,495,16685
2480,6,0,25,0,60839940,3652,8258220,495,16691
2481,9,0,24,1,60879360,3653,8258280,494,16700
2482,8,0,25,0,60898380,3652,8260080,494,16708
2483,11,8,25,0,60911100,3652,8263800,494,16719
2484,9,12,24,1,60951660,3653,8273280,494,16728
2485,18,23,25,0,60986640,3654,8290800,495,16746
2486,11,32,24,1,61006860,3655,8292600,495,16757
2487,13,39,24,1,61044720,3656,8304540,495,16770
2488,14,40,24,1,61063560,3656,8314680,496,16784
2489,6,39,25,0,61092600,3658,8333220,497,16790
2490,8,38,25,0,61146180,3659,8412360,501,16798
2491,9,39,25,0,61174140,3659,8470560,504,16807
2492,4,31,25,0,61211700,3659,8606940,512,16811
2493,11,28,25,0,61241700,3658,8789460,523,16822
2494,3,24,25,0,61259400,3657,8881320,528,16825
2495,5,15,25,0,61310940,3657,9153540,544,16830
2496,2,0,23,2,61345740,3655,9578820,570,16832
2497,4,0,20,5,61354560,3654,9578820,569,16836
2498,4,0,23,2,61362420,3654,9578820,569,16840
2499,3,0,22,3,61382520,3655,9578820,569,16843
2500,6,0,21,4,61417440,3655,9578820,569,16849
2501,4,0,20,5,61425960,3655,9578820,569,16853
2502,6,0,22,3,61446000,3655,9578820,569,16859
2503,6,0,25,0,61452240,3655,9578820,568,16865
2504,8,0,25,0,61481940,3655,9579960,568,16873
2505,9,0,24,1,61511400,3654,9580380,568,16882
2506,14,4,25,0,61553160,3655,9585660,568,16896
2507,9,7,25,0,61579800,3655,9600360,568,16905
2508,6,0,25,0,61616640,3655,9634980,570,16911
2509,7,1,25,0,61628820,3654,9634980,570,16918
2510,5,0,23,2,61671360,3655,9635160,570,16923
2511,4,0,22,3,61696080,3655,9635160,570,16927
2512,11,0,24,1,61714440,3654,9635580,569,16938
2513,5,0,23,2,61751220,3655,9635580,569,16943
2514,7,1,25,0,61762320,3655,9635580,569,16950
2515,8,0,23,2,61805700,3655,9637860,569,16958
2516,6,0,22,3,61828860,3655,9637860,569,16964
2517,7,0,24,1,61848960,3655,9639180,568,16971
2518,7,0,24,1,61880100,3655,9639180,568,16978
2519,5,0,19,6,61914540,3655,9639180,568,16983
2520,7,0,21,4,61930560,3655,9639180,568,16990
2521,6,0,23,2,61945560,3655,9639180,568,16996
2522,4,0,21,4,61963500,3655,9639180,567,17000
2523,3,0,20,5,61988700,3656,9639180,567,17003
2524,6,0,21,4,62001600,3655,9639180,567,17009
2525,4,0,19,6,62028600,3656,9639180,567,17013
2526,8,0,23,2,62035740,3655,9639180,567,17021
2527,3,0,21,4,62058000,3655,9639180,567,17024
2528,6,0,21,4,62088360,3656,9639180,566,17030
2529,9,0,22,3,62110620,3655,9639360,566,17039
2530,7,0,25,0,62127720,3656,9639360,566,17046
2531,12,3,25,0,62156820,3655,9639360,566,17058
2532,10,7,25,0,62174520,3655,9643320,565,17068
2533,10,10,25,0,62209380,3656,9650760,566,17078
2534,13,15,25,0,62249040,3656,9661320,566,17091
2535,7,13,25,0,62284440,3656,9677340,566,17098
2536,7,12,25,0,62309040,3656,9689820,567,17105
2537,11,15,25,0,62338200,3656,9716640,568,17116
2538,9,21,25,0,62356980,3657,9719220,568,17125
2539,9,26,24,1,62392680,3658,9729660,568,17134
2540,11,28,25,0,62442480,3659,9748200,569,17145
2541,4,25,25,0,62477580,3659,9769140,570,17149
2542,8,23,25,0,62510160,3659,9832680,574,17157
2543,2,8,25,0,62540760,3657,10229520,597,17159
2544,2,0,19,6,62567940,3655,10382160,605,17161
2545,1,0,17,8,62586180,3656,10382160,605,17162
2546,4,0,19,6,62590320,3656,10382160,605,17166
2547,8,0,23,2,62594880,3655,10382160,605,17174
2548,4,0,24,1,62607600,3655,10382400,605,17178
2549,11,0,24,1,62647980,3655,10382400,604,17189
2550,5,0,23,2,62667900,3655,10382400,604,17194
2551,8,0,20,5,62702460,3655,10382760,604,17202
2552,4,0,22,3,62709540,3655,10382760,604,17206
2553,17,7,25,0,62733180,3655,10384620,604,17223
2554,10,10,25,0,62764380,3655,10391100,604,17233
2555,9,14,25,0,62791800,3656,10398720,604,17242
2556,7,16,25,0,62820780,3656,10411260,604,17249
2557,6,8,25,0,62862780,3656,10478580,608,17255
2558,6,0,21,4,62897220,3654,10571400,613,17261
2559,10,2,25,0,62910060,3654,10571640,613,17271
2560,5,2,25,0,62941260,3654,10575960,613,17276
2561,9,1,25,0,62984520,3655,10582440,613,17285
2562,6,0,22,3,63012540,3654,10582800,613,17291
2563,15,4,25,0,63033420,3654,10583220,612,17306
2564,5,3,25,0,63058440,3654,10589160,612,17311
2565,5,0,22,3,63098760,3654,10596960,612,17316
2566,5,0,21,4,63124980,3654,10596960,612,17321
2567,10,0,25,0,63147000,3654,10596960,612,17331
2568,3,0,23,2,63165000,3654,10596960,612,17334
2569,2,0,21,4,63194040,3655,10596960,612,17336
2570,7,0,22,3,63221820,3655,10596960,612,17343
2571,4,0,21,4,63240300,3655,10596960,611,17347
2572,2,0,18,7,63254760,3655,10596960,611,17349
2573,6,0,20,5,63274620,3656,10596960,611,17355
2574,7,0,22,3,63289620,3655,10596960,611,17362
2575,9,0,25,0,63304080,3655,10596960,611,17371
2576,11,0,25,0,63330300,3654,10598100,610,17382
2577,6,0,23,2,63354780,3654,10598520,610,17388
2578,7,0,19,6,63391200,3654,10598520,610,17395
2579,10,0,22,3,63403560,3653,10598520,609,17405
2580,12,0,23,2,63425880,3652,10598940,609,17417
2581,2,0,21,4,63449040,3652,10598940,609,17419
2582,10,0,24,1,63466920,3652,10599000,609,17429
2583,13,3,25,0,63503040,3652,10599600,608,17442
2584,5,5,25,0,63512100,3652,10602900,608,17447
2585,11,0,24,1,63569880,3652,10622700,609,17458
2586,8,0,25,0,63594780,3652,10624920,609,17466
2587,6,0,24,1,63622800,3652,10624920,609,17472
2588,9,0,25,0,63649200,3652,10625880,608,17481
2589,3,0,21,4,63684000,3652,10625880,608,17484
2590,5,0,21,4,63701580,3652,10625880,608,17489
2591,5,0,24,1,63714240,3652,10625880,608,17494
2592,7,0,22,3,63747480,3652,10626900,608,17501
2593,3,0,20,5,63770460,3653,10626900,608,17504
2594,6,0,21,4,63789300,3653,10626900,607,17510
2595,8,0,22,3,63810180,3652,10626900,607,17518
2596,5,0,21,4,63826560,3652,10626900,607,17523
2597,7,0,24,1,63842820,3652,10626900,607,17530
2598,4,0,25,0,63853860,3652,10626900,607,17534
2599,4,0,22,3,63879120,3652,10627380,606,17538
2600,5,0,22,3,63916020,3653,10627380,606,17543
2601,10,0,21,4,63939420,3652,10627380,606,17553
2602,9,0,24,1,63957120,3652,10627860,606,17562
2603,9,0,25,0,63989640,3652,10628460,605,17571
2604,4,0,24,1,64006200,3652,10628460,605,17575
2605,11,4,25,0,64041300,3653,10631820,605,17586
2606,8,3,25,0,64075140,3653,10645020,606,17594
2607,7,0,24,1,64111860,3653,10646160,605,17601
2608,7,1,25,0,64123500,3652,10647960,605,17608
2609,11,0,25,0,64168800,3653,10653720,605,17619
2610,8,0,25,0,64195920,3652,10653900,605,17627
2611,9,0,25,0,64226940,3652,10654080,605,17636
2612,4,0,22,3,64253460,3652,10654200,604,17640
2613,2,0,21,4,64265460,3652,10654200,604,17642
2614,7,0,23,2,64291980,3653,10654200,604,17649
2615,2,0,19,6,64314360,3653,10654200,604,17651
2616,2,0,18,7,64330320,3653,10654200,604,17653
2617,3,0,19,6,64337640,3653,10654200,604,17656
2618,3,0,22,3,64337640,3653,10654200,604,17659
2619,2,0,22,3,64348740,3653,10654200,604,17661
2620,4,0,21,4,64376400,3654,10654200,604,17665
2621,9,1,25,0,64394760,3654,10654200,603,17674
2622,12,6,25,0,64425180,3654,10658520,603,17686
2623,6,0,25,0,64454460,3654,10678200,604,17692
2624,7,1,25,0,64483440,3654,10678200,604,17699
2625,11,1,25,0,64514820,3653,10679100,603,17710
2626,8,0,24,1,64555020,3654,10681200,603,17718
2627,15,7,25,0,64580760,3654,10684860,603,17733
2628,13,18,25,0,64593900,3654,10687380,603,17746
2629,9,20,25,0,64633260,3655,10706700,604,17755
2630,5,17,25,0,64680360,3656,10728900,605,17760
2631,15,25,25,0,64712580,3656,10736700,605,17775
2632,9,30,25,0,64736520,3657,10746600,605,17784
2633,12,34,25,0,64774680,3657,10795440,607,17796
2634,7,32,25,0,64809540,3657,10862940,611,17803
2635,6,29,25,0,64840740,3657,10925400,614,17809
2636,3,16,25,0,64876620,3656,11157540,627,17812
2637,7,0,23,2,64918620,3653,11486340,645,17819
2638,6,0,24,1,64928700,3653,11486340,645,17825
2639,2,0,20,5,64958640,3653,11486340,645,17827
2640,4,0,19,6,64980060,3653,11486340,645,17831
2641,4,0,18,7,64989480,3653,11486340,645,17835
2642,4,0,20,5,64994760,3653,11486340,644,17839
2643,7,0,21,4,65006820,3652,11486340,644,17846
2644,6,0,19,6,65030160,3652,11486340,644,17852
2645,10,0,24,1,65038860,3651,11486340,644,17862
2646,7,0,22,3,65058000,3651,11486340,643,17869
2647,5,0,22,3,65084400,3651,11486340,643,17874
2648,4,0,20,5,65102940,3651,11486340,643,17878
2649,2,0,20,5,65113620,3651,11486340,643,17880
2650,13,0,24,1,65130960,3650,11487120,642,17893
2651,8,0,23,2,65161740,3650,11487120,642,17901
2652,12,0,23,2,65189580,3649,11491500,642,17913
2653,13,7,25,0,65206380,3649,11492640,642,17926
2654,6,9,25,0,65228040,3650,11499300,642,17932
2655,7,8,25,0,65275500,3651,11511660,642,17939
2656,9,11,25,0,65304180,3651,11522460,643,17948
2657,9,14,25,0,65338860,3652,11529000,643,17957
2658,4,14,25,0,65360520,3652,11534040,643,17961
2659,5,12,25,0,65396340,3653,11569020,644,17966
2660,5,9,25,0,65434440,3653,11631120,648,17971
2661,8,0,23,2,65478540,3652,11774460,655,17979
2662,6,0,25,0,65491080,3652,11774520,655,17985
2663,3,0,20,5,65522760,3652,11774520,655,17988
2664,4,0,19,6,65548800,3652,11774520,655,17992
2665,6,0,21,4,65556420,3652,11774520,655,17998
2666,4,0,21,4,65570100,3652,11774520,655,18002
2667,4,0,21,4,65590980,3652,11774520,654,18006
2668,6,0,22,3,65605080,3652,11774520,654,18012
2669,3,0,20,5,65630760,3652,11774520,654,18015
2670,4,0,21,4,65641560,3652,11774520,654,18019
2671,5,0,21,4,65662680,3653,11774520,654,18024
2672,2,0,20,5,65675100,3653,11774520,654,18026
2673,8,0,21,4,65696400,3652,11774520,653,18034
2674,12,1,25,0,65705820,3651,11775120,653,18046
2675,9,0,24,1,65735400,3651,11777160,653,18055
2676,9,2,25,0,65761800,3651,11777880,653,18064
2677,11,2,25,0,65794320,3651,11784720,653,18075
2678,10,7,25,0,65823660,3651,11789880,652,18085
2679,14,16,25,0,65855340,3652,11797560,652,18099
2680,5,16,25,0,65884980,3653,11807220,653,18104
2681,12,18,25,0,65925660,3653,11836260,654,18116
2682,4,13,25,0,65961420,3653,11867040,655,18120
2683,11,14,25,0,65992500,3653,11895060,657,18131
2684,8,16,25,0,66009540,3652,11899440,657,18139
2685,6,13,25,0,66058020,3653,11957820,660,18145
2686,4,2,25,0,66089640,3652,12175020,671,18149
2687,8,0,24,1,66117360,3651,12212880,673,18157

