Hour,Arrivals,Waiting,Treating,Available Rooms,Total Treatment Time,Average Treatment Time,Total Wait Time,Average Wait Time,Total Arrivals
1,3,0,3,22,0,0,0,0,3
2,2,0,3,22,8340,4170,0,0,5
3,4,0,4,21,21300,4260,0,0,9
4,5,0,4,21,32280,3228,0,0,14
5,4,0,2,23,51300,3206,0,0,18
6,4,0,3,22,55380,2914,0,0,22
7,6,0,6,19,62760,2852,0,0,28
8,9,0,5,20,87720,2741,0,0,37
9,11,0,10,15,105480,2775,0,0,48
10,7,0,6,19,133380,2722,0,0,55
11,8,0,7,18,162180,2896,0,0,63
12,11,0,8,17,186240,2821,0,0,74
13,6,0,6,19,213720,2888,0,0,80
14,6,0,8,17,232680,2983,0,0,86
15,8,0,9,16,255420,3004,0,0,94
16,7,0,8,17,292260,3142,0,0,101
17,3,0,6,19,319500,3260,0,0,104
18,7,0,7,18,349440,3360,0,0,111
19,8,0,7,18,376560,3362,0,0,119
20,7,0,10,15,388620,3350,0,0,126
21,8,0,12,13,403560,3307,0,0,134
22,7,0,6,19,462060,3422,0,0,141
23,3,0,4,21,490440,3503,0,0,144
24,5,0,2,23,513060,3490,0,0,149
25,2,0,3,22,513840,3471,0,0,151
26,3,0,3,22,523920,3469,0,0,154
27,3,0,1,24,541740,3472,0,0,157
28,7,0,8,17,541740,3472,0,0,164
29,3,0,5,20,561780,3467,0,0,167
30,5,0,4,21,589500,3508,0,0,172
31,8,0,10,15,599460,3526,0,0,180
32,13,0,15,10,622440,3496,0,0,193
33,6,0,5,20,686460,3538,0,0,199
34,6,0,6,19,713100,3583,0,0,205
35,13,0,12,13,730140,3544,0,0,218
36,16,0,16,9,771540,3539,0,0,234
37,8,0,6,19,834960,3537,0,0,242
38,7,0,6,19,859920,3538,0,0,249
39,4,0,3,22,881040,3524,0,0,253
40,5,0,5,20,889920,3517,0,0,258
41,8,0,9,16,901740,3508,0,0,266
42,8,0,10,15,929220,3519,0,0,274
43,3,0,4,21,970320,3554,0,0,277
44,4,0,3,22,998940,3593,0,0,281
45,4,0,7,18,998940,3593,0,0,285
46,3,0,4,21,1026900,3615,0,0,288
47,6,0,6,19,1040340,3612,0,0,294
48,3,0,4,21,1057980,3610,0,0,297
49,4,0,4,21,1075800,3622,0,0,301
50,5,0,3,22,1090860,3600,0,0,306
51,8,0,6,19,1103760,3583,0,0,314
52,5,0,5,20,1123200,3577,0,0,319
53,4,0,6,19,1141380,3600,0,0,323
54,8,0,8,17,1151640,3565,0,0,331
55,7,0,9,16,1186320,3605,0,0,338
56,5,0,6,19,1220520,3621,0,0,343
57,10,0,7,18,1246200,3601,0,0,353
58,11,0,9,16,1275540,3593,0,0,364
59,7,0,8,17,1298940,3578,0,0,371
60,5,0,7,18,1339500,3630,0,0,376
61,11,0,7,18,1366200,3595,0,0,387
62,10,0,7,18,1412280,3621,0,0,397
63,6,0,9,16,1422000,3609,0,0,403
64,6,0,6,19,1468020,3642,0,0,409
65,6,0,6,19,1495920,3657,0,0,415
66,4,0,3,22,1520400,3654,0,0,419
67,11,0,9,16,1529580,3633,0,0,430
68,6,0,8,17,1550880,3623,0,0,436
69,9,0,11,14,1569540,3616,0,0,445
70,8,0,11,14,1619040,3662,0,0,453
71,3,0,2,23,1660500,3657,0,0,456
72,4,0,3,22,1678680,3673,0,0,460
73,2,0,5,20,1678680,3673,0,0,462
74,6,0,6,19,1695780,3670,0,0,468
75,4,0,5,20,1707840,3657,0,0,472
76,8,0,5,20,1730940,3644,0,0,480
77,7,0,7,18,1744860,3635,0,0,487
78,2,0,4,21,1764600,3638,0,0,489
79,3,0,2,23,1781760,3636,0,0,492
80,10,0,8,17,1793880,3631,0,0,502
81,7,0,8,17,1810200,3613,0,0,509
82,10,0,10,15,1835640,3606,0,0,519
83,15,0,17,8,1866060,3609,0,0,534
84,5,0,11,14,1922040,3640,0,0,539
85,11,0,13,12,1970820,3670,0,0,550
86,15,0,12,13,2014680,3643,0,0,565
87,11,0,9,16,2075640,3660,0,0,576
88,6,0,5,20,2114400,3664,0,0,582
89,11,0,12,13,2124780,3657,0,0,593
90,8,0,8,17,2164020,3649,0,0,601
91,7,0,10,15,2185260,3654,0,0,608
92,3,0,2,23,2231580,3664,0,0,611
93,6,0,5,20,2235720,3653,0,0,617
94,4,0,6,19,2241840,3645,0,0,621
95,3,0,4,21,2268900,3659,0,0,624
96,7,0,7,18,2282040,3657,0,0,631
97,5,0,5,20,2312820,3665,0,0,636
98,7,0,7,18,2334300,3670,0,0,643
99,2,0,5,20,2352960,3676,0,0,645
100,3,0,3,22,2382120,3693,0,0,648
101,7,0,6,19,2391060,3684,0,0,655
102,6,0,9,16,2400480,3681,0,0,661
103,5,0,3,22,2452320,3698,0,0,666
104,4,0,5,20,2455740,3692,0,0,670
105,6,0,5,20,2483940,3701,0,0,676
106,7,0,4,21,2499060,3680,0,0,683
107,7,0,5,20,2510160,3664,0,0,690
108,10,0,9,16,2518200,3644,0,0,700
109,9,0,12,13,2548560,3656,0,0,709
110,13,0,13,12,2604060,3672,0,0,722
111,9,0,10,15,2636520,3656,0,0,731
112,10,0,9,16,2679420,3660,0,0,741
113,8,0,7,18,2726940,3675,0,0,749
114,10,0,9,16,2744340,3659,0,0,759
115,9,0,14,11,2767680,3670,0,0,768
116,7,0,9,16,2810760,3669,0,0,775
117,3,0,5,20,2855160,3693,0,0,778
118,5,0,4,21,2874420,3689,0,0,783
119,7,0,5,20,2900220,3694,0,0,790
120,4,0,4,21,2909400,3682,0,0,794
121,7,0,7,18,2924100,3682,0,0,801
122,3,0,6,19,2939220,3683,0,0,804
123,7,0,7,18,2967000,3690,0,0,811
124,4,0,7,18,2981280,3689,0,0,815
125,9,0,6,19,3009900,3679,0,0,824
126,7,0,5,20,3042300,3683,0,0,831
127,8,0,8,17,3058380,3680,0,0,839
128,9,0,4,21,3087120,3657,0,0,848
129,8,0,6,19,3100680,3647,0,0,856
130,9,0,7,18,3126240,3643,0,0,865
131,11,0,12,13,3148920,3644,0,0,876
132,10,0,10,15,3181620,3631,0,0,886
133,8,0,7,18,3236520,3648,0,0,894
134,4,0,8,17,3246780,3648,0,0,898
135,13,0,14,11,3273300,3649,0,0,911
136,5,0,8,17,3317640,3653,0,0,916
137,8,0,8,17,3346920,3653,0,0,924
138,12,0,13,12,3369060,3650,0,0,936
139,5,0,10,15,3402960,3655,0,0,941
140,7,0,6,19,3451740,3664,0,0,948
141,4,0,5,20,3471840,3666,0,0,952
142,9,0,8,17,3494160,3666,0,0,961
143,6,0,7,18,3507720,3653,0,0,967
144,4,0,5,20,3538980,3663,0,0,971
145,5,0,5,20,3558180,3664,0,0,976
146,6,0,7,18,3581340,3673,0,0,982
147,4,0,5,20,3603780,3673,0,0,986
148,6,0,6,19,3618240,3669,0,0,992
149,4,0,4,21,3639600,3668,0,0,996
150,10,0,7,18,3660000,3663,0,0,1006
151,6,0,4,21,3685140,3655,0,0,1012
152,6,0,9,16,3686940,3654,0,0,1018
153,8,0,12,13,3710280,3659,0,0,1026
154,12,0,12,13,3753720,3658,0,0,1038
155,8,0,10,15,3795540,3663,0,0,1046
156,13,0,13,12,3835020,3666,0,0,1059
157,2,0,5,20,3874140,3668,0,0,1061
158,16,0,15,10,3894060,3666,0,0,1077
159,9,0,8,17,3957000,3670,0,0,1086
160,14,0,11,14,3988920,3662,0,0,1100
161,8,0,7,18,4029540,3659,0,0,1108
162,11,0,10,15,4055820,3657,0,0,1119
163,7,0,10,15,4088700,3663,0,0,1126
164,3,0,6,19,4119180,3668,0,0,1129
165,6,0,4,21,4150380,3669,0,0,1135
166,6,0,4,21,4164120,3662,0,0,1141
167,5,0,5,20,4176720,3660,0,0,1146
168,2,0,5,20,4186020,3662,0,0,1148
169,4,0,4,21,4201980,3660,0,0,1152
170,3,0,3,22,4214820,3658,0,0,1155
171,2,0,3,22,4224600,3660,0,0,1157
172,6,0,5,20,4243740,3664,0,0,1163
173,9,0,10,15,4253460,3660,0,0,1172
174,6,0,8,17,4277460,3655,0,0,1178
175,1,0,2,23,4323120,3672,0,0,1179
176,7,0,7,18,4334640,3676,0,0,1186
177,4,0,5,20,4349640,3670,0,0,1190
178,7,0,5,20,4382760,3676,0,0,1197
179,12,0,15,10,4395780,3681,0,0,1209
180,7,0,11,14,4435500,3680,0,0,1216
181,7,0,8,17,4481940,3688,0,0,1223
182,8,0,9,16,4509960,3690,0,0,1231
183,9,0,8,17,4537140,3682,0,0,1240
184,6,0,8,17,4570620,3691,0,0,1246
185,9,0,8,17,4591620,3682,0,0,1255
186,4,0,7,18,4624020,3693,0,0,1259
187,7,0,8,17,4658340,3702,0,0,1266
188,8,0,8,17,4683960,3699,0,0,1274
189,5,0,6,19,4713180,3702,0,0,1279
190,8,0,6,19,4739700,3700,0,0,1287
191,6,0,5,20,4758480,3694,0,0,1293
192,4,0,5,20,4769280,3691,0,0,1297
193,6,0,5,20,4794300,3693,0,0,1303
194,5,0,5,20,4812060,3693,0,0,1308
195,7,0,7,18,4837980,3698,0,0,1315
196,5,0,4,21,4860480,3693,0,0,1320
197,4,0,4,21,4878660,3695,0,0,1324
198,4,0,4,21,4888500,3692,0,0,1328
199,7,0,4,21,4908780,3688,0,0,1335
200,9,0,6,19,4933800,3687,0,0,1344
201,6,0,6,19,4951440,3684,0,0,1350
202,12,0,11,14,4964280,3674,0,0,1362
203,11,0,14,11,4991340,3672,0,0,1373
204,13,0,12,13,5056980,3680,0,0,1386
205,7,0,9,16,5084940,3674,0,0,1393
206,6,0,5,20,5122500,3674,0,0,1399
207,11,0,11,14,5139060,3673,0,0,1410
208,11,0,10,15,5175420,3667,0,0,1421
209,6,0,9,16,5209500,3673,0,0,1427
210,9,0,8,17,5243820,3672,0,0,1436
211,2,0,2,23,5283000,3678,0,0,1438
212,3,0,2,23,5291640,3677,0,0,1441
213,5,0,6,19,5293860,3676,0,0,1446
214,5,0,7,18,5308800,3676,0,0,1451
215,7,0,6,19,5329800,3670,0,0,1458
216,3,0,4,21,5354220,3674,0,0,1461
217,3,0,5,20,5356620,3671,0,0,1464
218,2,0,2,23,5383920,3677,0,0,1466
219,6,0,5,20,5386740,3671,0,0,1472
220,6,0,4,21,5402400,3665,0,0,1478
221,6,0,7,18,5410860,3663,0,0,1484
222,11,0,11,14,5432700,3660,0,0,1495
223,4,0,5,20,5456760,3652,0,0,1499
224,17,0,14,11,5482680,3650,0,0,1516
225,14,0,13,12,5518260,3637,0,0,1530
226,6,0,6,19,5571240,3641,0,0,1536
227,6,0,9,16,5587860,3645,0,0,1542
228,6,0,9,16,5613780,3647,0,0,1548
229,7,0,8,17,5650860,3652,0,0,1555
230,10,0,8,17,5683740,3650,0,0,1565
231,9,0,11,14,5699640,3646,0,0,1574
232,9,0,6,19,5750400,3646,0,0,1583
233,5,0,5,20,5772840,3646,0,0,1588
234,6,0,7,18,5784840,3645,0,0,1594
235,8,0,11,14,5791440,3640,0,0,1602
236,5,0,5,20,5848140,3650,0,0,1607
237,12,0,11,14,5863500,3646,0,0,1619
238,5,0,10,15,5888520,3648,0,0,1624
239,7,0,9,16,5929380,3655,0,0,1631
240,3,0,4,21,5975040,3665,0,0,1634
241,4,0,6,19,5984640,3667,0,0,1638
242,5,0,6,19,6007560,3669,0,0,1643
243,8,0,7,18,6037620,3672,0,0,1651
244,3,0,5,20,6062460,3676,0,0,1654
245,4,0,3,22,6088020,3678,0,0,1658
246,5,0,5,20,6096720,3677,0,0,1663
247,8,0,3,22,6114180,3665,0,0,1671
248,9,0,8,17,6130860,3666,0,0,1680
249,10,0,12,13,6145320,3662,0,0,1690
250,6,0,8,17,6191940,3668,0,0,1696
251,10,0,10,15,6226500,3671,0,0,1706
252,13,0,13,12,6269400,3674,0,0,1719
253,6,0,12,13,6295260,3674,0,0,1725
254,6,0,3,22,6349800,3674,0,0,1731
255,16,0,15,10,6360960,3672,0,0,1747
256,6,0,11,14,6395460,3671,0,0,1753
257,8,0,10,15,6438600,3677,0,0,1761
258,4,0,5,20,6481260,3682,0,0,1765
259,11,0,6,19,6507300,3676,0,0,1776
260,3,0,3,22,6529860,3676,0,0,1779
261,6,0,4,21,6544500,3674,0,0,1785
262,5,0,6,19,6558600,3676,0,0,1790
263,3,0,4,21,6571980,3673,0,0,1793
264,4,0,5,20,6582420,3673,0,0,1797
265,8,0,7,18,6605340,3673,0,0,1805
266,7,0,6,19,6624420,3668,0,0,1812
267,6,0,7,18,6648900,3671,0,0,1818
268,4,0,5,20,6674400,3673,0,0,1822
269,4,0,4,21,6693540,3673,0,0,1826
270,10,0,11,14,6707640,3675,0,0,1836
271,1,0,3,22,6745320,3677,0,0,1837
272,5,0,4,21,6771180,3683,0,0,1842
273,6,0,6,19,6783420,3682,0,0,1848
274,10,0,10,15,6801780,3680,0,0,1858
275,6,0,9,16,6830400,3682,0,0,1864
276,8,0,10,15,6856740,3682,0,0,1872
277,6,0,9,16,6895620,3689,0,0,1878
278,12,0,13,12,6940740,3697,0,0,1890
279,9,0,13,12,6971880,3696,0,0,1899
280,10,0,12,13,7027020,3704,0,0,1909
281,3,0,8,17,7050840,3703,0,0,1912
282,5,0,3,22,7100220,3709,0,0,1917
283,7,0,8,17,7103220,3707,0,0,1924
284,8,0,10,15,7117980,3703,0,0,1932
285,7,0,6,19,7163640,3705,0,0,1939
286,3,0,5,20,7173900,3703,0,0,1942
287,1,0,2,23,7199400,3709,0,0,1943
288,6,0,5,20,7207500,3707,0,0,1949
289,1,0,3,22,7217700,3707,0,0,1950
290,4,0,3,22,7232400,3707,0,0,1954
291,2,0,2,23,7248120,3709,0,0,1956
292,4,0,6,19,7248120,3709,0,0,1960
293,7,0,8,17,7258440,3705,0,0,1967
294,7,0,6,19,7294740,3706,0,0,1974
295,4,0,6,19,7307880,3705,0,0,1978
296,5,0,2,23,7339440,3704,0,0,1983
297,6,0,6,19,7346040,3704,0,0,1989
298,10,0,7,18,7368780,3699,0,0,1999
299,10,0,7,18,7392780,3692,0,0,2009
300,11,0,11,14,7415400,3691,0,0,2020
301,10,0,8,17,7461660,3690,0,0,2030
302,9,0,7,18,7498080,3690,0,0,2039
303,8,0,9,16,7510380,3685,0,0,2047
304,10,0,11,14,7556700,3693,0,0,2057
305,8,0,9,16,7593720,3693,0,0,2065
306,8,0,9,16,7621860,3692,0,0,2073
307,7,0,7,18,7651620,3691,0,0,2080
308,3,0,3,22,7676880,3690,0,0,2083
309,8,0,7,18,7692840,3691,0,0,2091
310,4,0,5,20,7711740,3689,0,0,2095
311,4,0,2,23,7742220,3692,0,0,2099
312,7,0,7,18,7745940,3690,0,0,2106
313,4,0,6,19,7761480,3688,0,0,2110
314,5,0,5,20,7794600,3694,0,0,2115
315,3,0,6,19,7802760,3694,0,0,2118
316,5,0,5,20,7822140,3693,0,0,2123
317,1,0,1,24,7853700,3699,0,0,2124
318,5,0,3,22,7859160,3696,0,0,2129
319,4,0,5,20,7864620,3695,0,0,2133
320,10,0,11,14,7878720,3695,0,0,2143
321,6,0,10,15,7908960,3697,0,0,2149
322,10,0,10,15,7955400,3701,0,0,2159
323,11,0,13,12,7977780,3698,0,0,2170
324,7,0,8,17,8032080,3703,0,0,2177
325,7,0,6,19,8081340,3710,0,0,2184
326,11,0,11,14,8097420,3707,0,0,2195
327,10,0,14,11,8124360,3708,0,0,2205
328,8,0,9,16,8179620,3711,0,0,2213
329,5,0,8,17,8210220,3715,0,0,2218
330,7,0,6,19,8249340,3717,0,0,2225
331,8,0,9,16,8267760,3717,0,0,2233
332,7,0,6,19,8308140,3718,0,0,2240
333,3,0,4,21,8336460,3723,0,0,2243
334,4,0,2,23,8362080,3724,0,0,2247
335,5,0,4,21,8367420,3722,0,0,2252
336,3,0,5,20,8371620,3720,0,0,2255
337,3,0,3,22,8397780,3724,0,0,2258
338,3,0,4,21,8403660,3723,0,0,2261
339,5,0,6,19,8411220,3721,0,0,2266
340,4,0,3,22,8432220,3719,0,0,2270
341,4,0,5,20,8440380,3719,0,0,2274
342,9,0,6,19,8466600,3718,0,0,2283
343,9,0,10,15,8484120,3717,0,0,2292
344,5,0,7,18,8522940,3721,0,0,2297
345,10,0,9,16,8553000,3721,0,0,2307
346,13,0,10,15,8585700,3716,0,0,2320
347,7,0,12,13,8593620,3712,0,0,2327
348,6,0,9,16,8635860,3715,0,0,2333
349,10,0,6,19,8683140,3715,0,0,2343
350,6,0,7,18,8697360,3713,0,0,2349
351,4,0,7,18,8714640,3714,0,0,2353
352,11,0,10,15,8745120,3715,0,0,2364
353,8,0,11,14,8767860,3713,0,0,2372
354,9,0,7,18,8819640,3715,0,0,2381
355,7,0,5,20,8846880,3712,0,0,2388
356,6,0,5,20,8864220,3710,0,0,2394
357,3,0,5,20,8871660,3708,0,0,2397
358,5,0,5,20,8887140,3707,0,0,2402
359,5,0,5,20,8906760,3708,0,0,2407
360,5,0,5,20,8923560,3707,0,0,2412
361,6,0,5,20,8934900,3702,0,0,2418
362,5,0,6,19,8939100,3698,0,0,2423
363,2,0,1,24,8982420,3705,0,0,2425
364,6,0,3,22,8990820,3702,0,0,2431
365,4,0,3,22,8999940,3700,0,0,2435
366,5,0,3,22,9015360,3699,0,0,2440
367,7,0,6,19,9023640,3696,0,0,2447
368,18,0,15,10,9045840,3692,0,0,2465
369,11,0,14,11,9078000,3687,0,0,2476
370,12,0,14,11,9122100,3687,0,0,2488
371,5,0,9,16,9173820,3693,0,0,2493
372,9,0,9,16,9212280,3695,0,0,2502
373,8,0,6,19,9256560,3696,0,0,2510
374,8,0,10,15,9269340,3695,0,0,2518
375,12,0,13,12,9292800,3692,0,0,2530
376,8,0,10,15,9335340,3692,0,0,2538
377,9,0,7,18,9383100,3694,0,0,2547
378,5,0,9,16,9394440,3694,0,0,2552
379,4,0,3,22,9434580,3695,0,0,2556
380,3,0,2,23,9444780,3693,0,0,2559
381,5,0,2,23,9457560,3691,0,0,2564
382,2,0,3,22,9460380,3691,0,0,2566
383,6,0,4,21,9471840,3688,0,0,2572
384,7,0,6,19,9479700,3684,0,0,2579
385,2,0,4,21,9499620,3686,0,0,2581
386,1,0,0,25,9527640,3690,0,0,2582
387,3,0,2,23,9528240,3688,0,0,2585
388,6,0,6,19,9534600,3688,0,0,2591
389,5,0,5,20,9547140,3684,0,0,2596
390,4,0,2,23,9576660,3686,0,0,2600
391,5,0,5,20,9580800,3684,0,0,2605
392,4,0,4,21,9594420,3683,0,0,2609
393,8,0,6,19,9599760,3676,0,0,2617
394,6,0,6,19,9628860,3679,0,0,2623
395,2,0,4,21,9643500,3679,0,0,2625
396,7,0,2,23,9673560,3678,0,0,2632
397,7,0,5,20,9680160,3675,0,0,2639
398,13,0,8,17,9695640,3667,0,0,2652
399,4,0,6,19,9724620,3669,0,0,2656
400,12,0,10,15,9758280,3671,0,0,2668
401,13,0,14,11,9779220,3666,0,0,2681
402,6,0,8,17,9834720,3671,0,0,2687
403,6,0,7,18,9872760,3675,0,0,2693
404,7,0,5,20,9902640,3674,0,0,2700
405,6,0,4,21,9923940,3672,0,0,2706
406,2,0,1,24,9945300,3673,0,0,2708
407,11,0,8,17,9950220,3670,0,0,2719
408,1,0,4,21,9964020,3668,0,0,2720
409,6,0,5,20,9985860,3669,0,0,2726
410,4,0,4,21,10001640,3668,0,0,2730
411,6,0,6,19,10014240,3668,0,0,2736
412,5,0,6,19,10034160,3668,0,0,2741
413,6,0,7,18,10052400,3668,0,0,2747
414,6,0,10,15,10062720,3668,0,0,2753
415,4,0,6,19,10094040,3669,0,0,2757
416,7,0,6,19,10137960,3675,0,0,2764
417,7,0,5,20,10162440,3674,0,0,2771
418,17,0,13,12,10190160,3672,0,0,2788
419,8,0,7,18,10233900,3669,0,0,2796
420,3,0,7,18,10250940,3671,0,0,2799
421,10,0,11,14,10276020,3672,0,0,2809
422,12,0,12,13,10326720,3676,0,0,2821
423,4,0,7,18,10363260,3677,0,0,2825
424,5,0,3,22,10400520,3678,0,0,2830
425,5,0,2,23,10416000,3676,0,0,2835
426,5,0,3,22,10421700,3673,0,0,2840
427,5,0,5,20,10424100,3670,0,0,2845
428,6,0,7,18,10440720,3671,0,0,2851
429,0,0,2,23,10468980,3674,0,0,2851
430,8,0,10,15,10468980,3674,0,0,2859
431,1,0,4,21,10501200,3676,0,0,2860
432,3,0,3,22,10522260,3679,0,0,2863
433,8,0,7,18,10534500,3678,0,0,2871
434,3,0,5,20,10549980,3677,0,0,2874
435,5,0,7,18,10566420,3679,0,0,2879
436,5,0,7,18,10582860,3678,0,0,2884
437,5,0,7,18,10605720,3679,0,0,2889
438,6,0,6,19,10629360,3679,0,0,2895
439,5,0,5,20,10656540,3681,0,0,2900
440,9,0,10,15,10666560,3679,0,0,2909
441,12,0,10,15,10698540,3675,0,0,2921
442,10,0,11,14,10734540,3676,0,0,2931
443,13,0,16,9,10755240,3673,0,0,2944
444,6,0,9,16,10792260,3669,0,0,2950
445,13,0,12,13,10834380,3671,0,0,2963
446,6,0,7,18,10875720,3671,0,0,2969
447,10,1,13,12,10889400,3672,180,0,2979
448,12,0,16,9,10928820,3673,2040,0,2991
449,10,0,12,13,10989420,3676,2040,0,3001
450,3,0,5,20,11045340,3683,2040,0,3004
451,8,0,8,17,11074200,3686,2040,0,3012
452,5,0,7,18,11100720,3687,2040,0,3017
453,10,0,8,17,11136600,3688,2040,0,3027
454,6,0,6,19,11151660,3684,2040,0,3033
455,7,0,5,20,11188320,3686,2040,0,3040
456,7,0,5,20,11212080,3685,2040,0,3047
457,8,0,7,18,11225520,3682,2040,0,3055
458,8,0,6,19,11249340,3679,2040,0,3063
459,3,0,5,20,11271600,3682,2040,0,3066
460,6,0,7,18,11302800,3687,2040,0,3072
461,7,0,5,20,11333520,3686,2040,0,3079
462,9,0,6,19,11349180,3682,2040,0,3088
463,10,0,6,19,11387400,3682,2040,0,3098
464,13,0,11,14,11401260,3677,2040,0,3111
465,9,0,9,16,11444160,3678,2040,0,3120
466,13,0,12,13,11473980,3676,2040,0,3133
467,11,0,13,12,11502900,3673,2040,0,3144
468,9,0,11,14,11552820,3676,2040,0,3153
469,4,0,5,20,11600160,3680,2040,0,3157
470,6,0,9,16,11611500,3681,2040,0,3163
471,9,0,10,15,11651520,3684,2040,0,3172
472,9,0,8,17,11688300,3683,2040,0,3181
473,11,0,9,16,11712360,3679,2040,0,3192
474,5,0,5,20,11745720,3679,2040,0,3197
475,5,0,6,19,11761980,3680,2040,0,3202
476,6,0,6,19,11776500,3677,2040,0,3208
477,5,0,5,20,11803080,3679,2040,0,3213
478,4,0,4,21,11819160,3678,2040,0,3217
479,9,0,4,21,11838180,3674,2040,0,3226
480,7,0,5,20,11850480,3671,2040,0,3233
481,4,0,3,22,11866440,3669,2040,0,3237
482,2,0,3,22,11879820,3671,2040,0,3239
483,4,0,5,20,11890500,3672,2040,0,3243
484,5,0,6,19,11896380,3669,2040,0,3248
485,7,0,10,15,11914740,3671,2040,0,3255
486,10,0,11,14,11946360,3671,2040,0,3265
487,7,0,7,18,11987100,3671,2040,0,3272
488,5,0,6,19,12008640,3671,2040,0,3277
489,7,0,5,20,12039480,3671,2040,0,3284
490,4,0,3,22,12057480,3670,2040,0,3288
491,7,0,6,19,12071160,3670,2040,0,3295
492,8,0,9,16,12080520,3667,2040,0,3303
493,12,0,11,14,12116400,3667,2040,0,3315
494,7,0,9,16,12156720,3669,2040,0,3322
495,12,0,10,15,12204120,3671,2040,0,3334
496,11,0,14,11,12220140,3668,2040,0,3345
497,4,0,5,20,12287760,3674,2040,0,3349
498,4,0,6,19,12302940,3675,2040,0,3353
499,9,0,8,17,12326880,3675,2040,0,3362
500,6,0,7,18,12345840,3673,2040,0,3368
501,6,0,9,16,12364200,3674,2040,0,3374
502,6,0,10,15,12390300,3676,2040,0,3380
503,3,0,4,21,12422160,3676,2040,0,3383
504,6,0,7,18,12435420,3676,2040,0,3389
505,4,0,6,19,12457200,3677,2040,0,3393
506,2,0,1,24,12487740,3679,2040,0,3395
507,4,0,3,22,12490620,3678,2040,0,3399
508,5,0,7,18,12492180,3677,2040,0,3404
509,7,0,6,19,12522840,3677,2040,0,3411
510,5,0,4,21,12543420,3676,2040,0,3416
511,4,0,4,21,12552300,3674,2040,0,3420
512,4,0,4,21,12566460,3674,2040,0,3424
513,9,0,8,17,12579300,3672,2040,0,3433
514,11,0,12,13,12613800,3675,2040,0,3444
515,8,0,9,16,12647520,3673,2040,0,3452
516,10,0,8,17,12691380,3674,2040,0,3462
517,7,0,12,13,12696720,3672,2040,0,3469
518,13,0,17,8,12735180,3675,2040,0,3482
519,5,0,8,17,12789000,3676,2040,0,3487
520,9,0,10,15,12832620,3681,2040,0,3496
521,4,0,7,18,12858900,3681,2040,0,3500
522,8,0,9,16,12879420,3680,2040,0,3508
523,7,0,7,18,12923580,3684,2040,0,3515
524,5,0,4,21,12954600,3684,2040,0,3520
525,5,0,3,22,12968520,3682,2040,0,3525
526,8,0,8,17,12981360,3682,2040,0,3533
527,3,0,6,19,13003140,3683,2040,0,3536
528,5,0,6,19,13027800,3685,2040,0,3541
529,5,0,5,20,13054260,3686,2040,0,3546
530,3,0,2,23,13074840,3686,2040,0,3549
531,8,0,4,21,13089180,3683,2040,0,3557
532,4,0,4,21,13099620,3682,2040,0,3561
533,9,0,8,17,13122960,3684,2040,0,3570
534,6,0,8,17,13138020,3682,2040,0,3576
535,6,0,7,18,13156920,3680,2040,0,3582
536,5,0,9,16,13179840,3683,2040,0,3587
537,5,0,7,18,13208940,3684,2040,0,3592
538,9,0,7,18,13247340,3685,2040,0,3601
539,6,0,7,18,13269960,3686,2040,0,3607
540,9,0,8,17,13294980,3684,2040,0,3616
541,13,0,13,12,13318860,3683,2040,0,3629
542,16,0,16,9,13351260,3679,2040,0,3645
543,10,0,12,13,13399320,3678,2040,0,3655
544,10,0,12,13,13454640,3683,2040,0,3665
545,5,0,9,16,13490100,3684,2040,0,3670
546,10,0,10,15,13545060,3690,2040,0,3680
547,9,0,11,14,13567980,3688,2040,0,3689
548,7,0,9,16,13609680,3691,2040,0,3696
549,4,0,7,18,13635060,3692,2040,0,3700
550,4,0,3,22,13679700,3696,2040,0,3704
551,3,0,5,20,13681980,3695,2040,0,3707
552,4,0,5,20,13690260,3694,2040,0,3711
553,1,0,2,23,13718400,3697,2040,0,3712
554,4,0,2,23,13732380,3697,2040,0,3716
555,6,0,4,21,13740780,3695,2040,0,3722
556,5,0,7,18,13746120,3695,2040,0,3727
557,7,0,10,15,13757100,3694,2040,0,3734
558,10,0,11,14,13791780,3694,2040,0,3744
559,7,0,10,15,13822380,3694,2040,0,3751
560,4,0,6,19,13857780,3696,2040,0,3755
561,8,0,6,19,13890900,3697,2040,0,3763
562,5,0,4,21,13905360,3694,2040,0,3768
563,10,0,7,18,13920660,3691,2040,0,3778
564,6,0,5,20,13946280,3690,2040,0,3784
565,6,0,5,20,13962300,3688,2040,0,3790
566,7,0,7,18,13981560,3689,2040,0,3797
567,3,0,4,21,14002980,3688,2040,0,3800
568,6,0,5,20,14026920,3690,2040,0,3806
569,5,0,7,18,14034780,3689,2040,0,3811
570,5,0,6,19,14059980,3690,2040,0,3816
571,4,0,4,21,14080980,3689,2040,0,3820
572,10,0,5,20,14100840,3686,2040,0,3830
573,6,0,4,21,14119320,3684,2040,0,3836
574,3,0,4,21,14131080,3684,2040,0,3839
575,3,0,5,20,14139000,3684,2040,0,3842
576,7,0,8,17,14150160,3683,2040,0,3849
577,3,0,4,21,14173860,3683,2040,0,3852
578,4,0,3,22,14199960,3685,2040,0,3856
579,4,0,5,20,14205960,3685,2040,0,3860
580,4,0,2,23,14231340,3684,2040,0,3864
581,10,0,6,19,14243880,3682,2040,0,3874
582,5,0,4,21,14264640,3681,2040,0,3879
583,9,0,11,14,14276820,3682,2040,0,3888
584,8,0,8,17,14313060,3681,2040,0,3896
585,11,0,13,12,14347980,3684,2040,0,3907
586,11,0,13,12,14385720,3683,2040,0,3918
587,17,0,16,9,14442540,3685,2040,0,3935
588,10,0,11,14,14510220,3688,2040,0,3945
589,11,0,8,17,14562360,3688,2040,0,3956
590,10,0,11,14,14581140,3686,2040,0,3966
591,10,0,11,14,14619480,3687,2040,0,3976
592,11,0,10,15,14663280,3687,2040,0,3987
593,8,0,8,17,14696340,3686,2040,0,3995
594,2,0,2,23,14737500,3688,2040,0,3997
595,5,0,4,21,14750340,3689,2040,0,4002
596,5,0,7,18,14755260,3688,2040,0,4007
597,4,0,5,20,14783100,3690,2040,0,4011
598,7,0,8,17,14796840,3689,2040,0,4018
599,4,0,4,21,14828280,3690,2040,0,4022
600,1,0,0,25,14849220,3691,2040,0,4023
601,5,0,4,21,14849940,3690,2040,0,4028
602,3,0,4,21,14861700,3690,2040,0,4031
603,4,0,4,21,14870400,3689,2040,0,4035
604,7,0,7,18,14892540,3690,2040,0,4042
605,7,0,8,17,14909160,3689,2040,0,4049
606,5,0,5,20,14928900,3687,2040,0,4054
607,9,0,9,16,14950020,3687,2040,0,4063
608,7,0,7,18,14968860,3684,2040,0,4070
609,9,0,9,16,14987340,3682,2040,0,4079
610,12,0,15,10,15009480,3682,2040,0,4091
611,13,0,14,11,15070080,3684,2040,0,4104
612,9,0,10,15,15121200,3685,2040,0,4113
613,6,0,6,19,15159720,3685,2040,0,4119
614,2,0,1,24,15191940,3687,2040,0,4121
615,10,0,8,17,15195600,3685,2040,0,4131
616,10,0,12,13,15209580,3683,2040,0,4141
617,3,0,5,20,15253560,3685,2040,0,4144
618,8,0,5,20,15284340,3685,2040,0,4152
619,3,0,4,21,15295020,3684,2040,0,4155
620,0,0,0,25,15319200,3686,2040,0,4155
621,8,0,6,19,15320880,3685,2040,0,4163
622,1,0,3,22,15334800,3685,2040,0,4164
623,5,0,5,20,15355800,3687,2040,0,4169
624,5,0,3,22,15370080,3684,2040,0,4174
625,3,0,4,21,15374640,3684,2040,0,4177
626,6,0,2,23,15393780,3681,2040,0,4183
627,6,0,6,19,15400980,3681,2040,0,4189
628,3,0,6,19,15412200,3681,2040,0,4192
629,5,0,7,18,15437760,3684,2040,0,4197
630,12,0,9,16,15469080,3683,2040,0,4209
631,6,0,7,18,15498900,3683,2040,0,4215
632,7,0,6,19,15520980,3681,2040,0,4222
633,7,0,7,18,15542220,3681,2040,0,4229
634,5,0,8,17,15562920,3682,2040,0,4234
635,7,0,8,17,15600540,3685,2040,0,4241
636,8,0,8,17,15623520,3683,2040,0,4249
637,15,0,17,8,15642000,3683,2040,0,4264
638,8,0,9,16,15705840,3684,2040,0,4272
639,12,0,12,13,15729600,3682,2040,0,4284
640,9,0,10,15,15786000,3685,2040,0,4293
641,5,0,5,20,15826620,3686,2040,0,4298
642,6,0,5,20,15846420,3686,2040,0,4304
643,4,0,6,19,15853080,3685,2040,0,4308
644,5,0,5,20,15877320,3685,2040,0,4313
645,4,0,5,20,15892800,3685,2040,0,4317
646,7,0,7,18,15918300,3687,2040,0,4324
647,5,0,4,21,15949320,3687,2040,0,4329
648,6,0,4,21,15966840,3686,2040,0,4335
649,1,0,2,23,15977040,3686,2040,0,4336
650,4,0,3,22,15986820,3686,2040,0,4340
651,6,0,4,21,15997860,3684,2040,0,4346
652,0,0,2,23,16010460,3685,2040,0,4346
653,6,0,5,20,16024740,3686,2040,0,4352
654,4,0,7,18,16029300,3685,2040,0,4356
655,3,0,4,21,16059600,3687,2040,0,4359
656,8,0,8,17,16067460,3686,2040,0,4367
657,9,0,10,15,16096560,3686,2040,0,4376
658,8,0,10,15,16124280,3686,2040,0,4384
659,8,0,10,15,16165320,3689,2040,0,4392
660,4,0,8,17,16184880,3688,2040,0,4396
661,10,0,9,16,16226640,3690,2040,0,4406
662,11,0,12,13,16261380,3691,2040,0,4417
663,7,0,8,17,16303020,3691,2040,0,4424
664,11,0,7,18,16331100,3688,2040,0,4435
665,7,0,7,18,16367400,3690,2040,0,4442
666,10,0,11,14,16386960,3689,2040,0,4452
667,3,0,8,17,16412400,3690,2040,0,4455
668,5,0,6,19,16461600,3695,2040,0,4460
669,7,0,8,17,16475280,3694,2040,0,4467
670,4,0,5,20,16494180,3693,2040,0,4471
671,2,0,6,19,16501020,3693,2040,0,4473
672,7,0,6,19,16536300,3696,2040,0,4480
673,2,0,7,18,16538700,3695,2040,0,4482
674,1,0,6,19,16546080,3695,2040,0,4483
675,2,0,7,18,16547460,3695,2040,0,4485
676,5,0,10,15,16548840,3693,2040,0,4490
677,7,0,13,12,16565940,3694,2040,0,4497
678,3,0,11,14,16591920,3696,2040,0,4500
679,11,0,15,10,16619340,3696,2040,0,4511
680,10,0,16,9,16648980,3695,2040,0,4521
681,8,0,14,11,16691220,3696,2040,0,4529
682,8,0,15,10,16712520,3695,2040,0,4537
683,10,0,19,6,16739340,3696,2040,0,4547
684,8,0,13,12,16792980,3697,2040,0,4555
685,11,0,15,10,16817280,3695,2040,0,4566
686,13,0,17,8,16858020,3695,2040,0,4579
687,12,0,18,7,16896660,3694,2040,0,4591
688,4,0,11,14,16947660,3697,2040,0,4595
689,6,0,10,15,16974180,3697,2040,0,4601
690,8,0,11,14,16993380,3695,2040,0,4609
691,5,0,7,18,17030520,3696,2040,0,4614
692,3,0,9,16,17036580,3697,2040,0,4617
693,3,0,6,19,17051640,3695,2040,0,4620
694,6,0,8,17,17058900,3694,2040,0,4626
695,5,0,11,14,17063880,3693,2040,0,4631
696,4,0,11,14,17080980,3693,2040,0,4635
697,6,0,9,16,17106600,3693,2040,0,4641
698,5,0,11,14,17115660,3692,2040,0,4646
699,5,0,13,12,17127060,3692,2040,0,4651
700,5,0,7,18,17167320,3692,2040,0,4656
701,2,0,5,20,17180040,3692,2040,0,4658
702,5,0,9,16,17182620,3692,2040,0,4663
703,4,0,8,17,17193780,3690,2040,0,4667
704,8,0,10,15,17208180,3688,2040,0,4675
705,6,0,12,13,17218140,3687,2040,0,4681
706,13,0,17,8,17249820,3688,2040,0,4694
707,5,0,14,11,17282160,3688,2040,0,4699
708,8,0,15,10,17325900,3692,2040,0,4707
709,10,0,19,6,17350380,3693,2040,0,4717
710,9,0,15,10,17409420,3695,2040,0,4726
711,13,0,16,9,17460780,3696,2040,0,4739
712,11,0,15,10,17496360,3695,2040,0,4750
713,6,0,13,12,17528160,3695,2040,0,4756
714,4,0,12,13,17558160,3698,2040,0,4760
715,6,0,11,14,17581800,3697,2040,0,4766
716,6,0,12,13,17603160,3698,2040,0,4772
717,4,0,9,16,17627820,3697,2040,0,4776
718,5,0,10,15,17651640,3699,2040,0,4781
719,4,0,12,13,17656680,3699,2040,0,4785
720,5,0,12,13,17681520,3700,2040,0,4790
721,6,0,12,13,17712720,3702,2040,0,4796
722,6,0,11,14,17739360,3702,2040,0,4802
723,8,0,10,15,17763240,3700,2040,0,4810
724,2,0,9,16,17774520,3700,2040,0,4812
725,3,0,8,17,17799540,3702,2040,0,4815
726,6,0,12,13,17803980,3702,2040,0,4821
727,4,0,9,16,17829000,3702,2040,0,4825
728,6,0,10,15,17851800,3702,2040,0,4831
729,6,0,14,11,17858040,3702,2040,0,4837
730,12,0,16,9,17889060,3701,2040,0,4849
731,6,0,12,13,17926800,3701,2040,0,4855
732,5,0,11,14,17951220,3702,2040,0,4860
733,6,0,11,14,17986020,3704,2040,0,4866
734,12,0,16,9,17997780,3701,2040,0,4878
735,12,0,18,7,18043680,3703,2040,0,4890
736,15,0,19,6,18097260,3703,2640,0,4905
737,6,0,13,12,18140160,3703,2640,0,4911
738,9,0,17,8,18174300,3706,2640,0,4920
739,6,0,14,11,18211920,3707,2640,0,4926
740,7,0,15,10,18245460,3709,2640,0,4933
741,4,0,10,15,18286740,3711,2640,0,4937
742,8,0,12,13,18311100,3711,2640,0,4945
743,3,0,9,16,18337320,3712,2640,0,4948
744,4,0,7,18,18364680,3713,2640,0,4952
745,5,0,9,16,18369120,3712,2640,0,4957
746,5,0,11,14,18379260,3712,2640,0,4962
747,4,0,13,12,18392460,3713,2640,0,4966
748,5,0,13,12,18424020,3716,2640,0,4971
749,4,0,12,13,18456480,3718,2640,0,4975
750,5,0,8,17,18496740,3720,2640,0,4980
751,8,0,12,13,18502920,3718,2640,0,4988
752,7,0,14,11,18517260,3717,2640,0,4995
753,1,0,8,17,18564420,3721,2640,0,4996
754,6,0,10,15,18576840,3721,2640,0,5002
755,3,0,7,18,18594120,3720,2640,0,5005
756,11,0,12,13,18606480,3718,2640,0,5016
757,15,0,19,6,18626580,3716,2640,0,5031
758,12,0,17,8,18663720,3713,2640,0,5043
759,13,0,21,4,18704280,3714,2640,0,5056
760,15,0,19,6,18755940,3712,2640,0,5071
761,7,0,13,12,18805020,3712,2640,0,5078
762,8,0,11,14,18843480,3713,2640,0,5086
763,7,0,14,11,18860940,3713,2640,0,5093
764,7,0,11,14,18890580,3712,2640,0,5100
765,8,0,13,12,18904920,3710,2640,0,5108
766,6,0,15,10,18927120,3711,2640,0,5114
767,3,0,10,15,18969000,3714,2640,0,5117
768,7,0,11,14,18993720,3714,2640,0,5124
769,6,0,12,13,19014660,3715,2640,0,5130
770,9,0,13,12,19035900,3713,2640,0,5139
771,7,0,9,16,19069980,3712,2640,0,5146
772,6,0,11,14,19078920,3711,2640,0,5152
773,6,0,11,14,19097040,3710,2640,0,5158
774,5,0,7,18,19129680,3710,2640,0,5163
775,7,0,10,15,19139160,3709,2640,0,5170
776,11,0,12,13,19162020,3707,2640,0,5181
777,10,0,12,13,19196700,3706,2640,0,5191
778,9,0,14,11,19213860,3704,2640,0,5200
779,4,0,11,14,19241220,3705,2640,0,5204
780,9,0,11,14,19270800,3704,2640,0,5213
781,6,0,9,16,19300320,3704,2640,0,5219
782,6,0,11,14,19308120,3703,2640,0,5225
783,12,0,14,11,19333260,3701,2640,0,5237
784,8,0,14,11,19353060,3699,2640,0,5245
785,8,0,12,13,19388880,3699,2640,0,5253
786,9,0,14,11,19410840,3698,2640,0,5262
787,8,0,11,14,19454580,3699,2640,0,5270
788,10,0,17,8,19466640,3698,2640,0,5280
789,7,0,15,10,19495140,3697,2640,0,5287
790,2,0,9,16,19529880,3698,2640,0,5289
791,8,0,12,13,19550940,3699,2640,0,5297
792,4,0,12,13,19565460,3699,2640,0,5301
793,12,0,15,10,19597500,3699,2640,0,5313
794,5,0,10,15,19639500,3699,2640,0,5318
795,5,0,10,15,19662900,3700,2640,0,5323
796,2,0,10,15,19667340,3700,2640,0,5325
797,8,0,13,12,19686120,3700,2640,0,5333
798,7,0,12,13,19723680,3701,2640,0,5340
799,5,0,12,13,19738260,3701,2640,0,5345
800,5,0,9,16,19771440,3701,2640,0,5350
801,4,0,12,13,19776360,3702,2640,0,5354
802,5,0,9,16,19812600,3703,2640,0,5359
803,7,0,10,15,19828320,3702,2640,0,5366
804,12,0,16,9,19845780,3701,2640,0,5378
805,10,0,13,12,19875480,3697,2640,0,5388
806,8,0,16,9,19891620,3697,2640,0,5396
807,13,0,15,10,19946100,3697,2640,0,5409
808,8,0,14,11,19982880,3698,2640,0,5417
809,16,0,23,2,20000100,3696,2640,0,5433
810,6,0,15,10,20057340,3697,2640,0,5439
811,7,0,14,11,20104800,3701,2640,0,5446
812,5,0,12,13,20131140,3701,2640,0,5451
813,4,0,9,16,20168280,3703,2640,0,5455
814,2,0,8,17,20182680,3703,2640,0,5457
815,4,0,7,18,20194080,3702,2640,0,5461
816,7,0,10,15,20208000,3702,2640,0,5468
817,7,0,12,13,20217420,3700,2640,0,5475
818,4,0,10,15,20244720,3701,2640,0,5479
819,3,0,9,16,20262720,3702,2640,0,5482
820,2,0,7,18,20282460,3703,2640,0,5484
821,6,0,10,15,20296020,3703,2640,0,5490
822,8,0,13,12,20306460,3702,2640,0,5498
823,11,0,16,9,20334540,3701,2640,0,5509
824,7,0,13,12,20349480,3697,2640,0,5516
825,8,0,14,11,20384640,3699,2640,0,5524
826,7,0,9,16,20409660,3696,2640,0,5531
827,8,0,13,12,20426940,3696,2640,0,5539
828,9,0,13,12,20451480,3694,2640,0,5548
829,8,0,11,14,20490600,3695,2640,0,5556
830,11,0,17,8,20510880,3695,2640,0,5567
831,8,0,17,8,20528400,3693,2640,0,5575
832,10,0,16,9,20575620,3694,2640,0,5585
833,6,0,10,15,20626380,3695,2640,0,5591
834,5,0,8,17,20649060,3695,2640,0,5596
835,3,0,9,16,20651040,3694,2640,0,5599
836,5,0,8,17,20669940,3693,2640,0,5604
837,5,0,10,15,20672700,3692,2640,0,5609
838,10,0,15,10,20685000,3691,2640,0,5619
839,5,0,13,12,20720100,3692,2640,0,5624
840,5,0,10,15,20754180,3693,2640,0,5629
841,4,0,10,15,20777400,3695,2640,0,5633
842,2,0,7,18,20800740,3695,2640,0,5635
843,8,0,11,14,20805780,3694,2640,0,5643
844,6,0,9,16,20825760,3692,2640,0,5649
845,9,0,14,11,20845140,3693,2640,0,5658
846,9,0,15,10,20864040,3691,2640,0,5667
847,7,0,14,11,20902020,3692,2640,0,5674
848,7,0,11,14,20942640,3693,2640,0,5681
849,6,0,12,13,20962140,3693,2640,0,5687
850,9,0,17,8,20977680,3693,2640,0,5696
851,9,0,14,11,21033180,3695,2640,0,5705
852,10,0,14,11,21056220,3693,2640,0,5715
853,3,0,12,13,21081120,3694,2640,0,5718
854,12,0,15,10,21129900,3697,2640,0,5730
855,5,0,14,11,21160020,3698,2640,0,5735
856,9,0,13,12,21193920,3698,2640,0,5744
857,3,0,9,16,21221580,3698,2640,0,5747
858,12,0,14,11,21246180,3698,2640,0,5759
859,9,0,17,8,21261360,3696,2640,0,5768
860,9,0,15,10,21301380,3696,2640,0,5777
861,5,0,14,11,21332040,3698,2640,0,5782
862,7,0,10,15,21371400,3698,2640,0,5789
863,7,0,12,13,21384420,3697,2640,0,5796
864,4,0,12,13,21404760,3698,2640,0,5800
865,7,0,11,14,21436860,3698,2640,0,5807
866,3,0,11,14,21456000,3699,2640,0,5810
867,6,0,13,12,21484740,3702,2640,0,5816
868,3,0,8,17,21509880,3701,2640,0,5819
869,2,0,6,19,21528900,3702,2640,0,5821
870,3,0,8,17,21529740,3701,2640,0,5824
871,6,0,6,19,21546720,3699,2640,0,5830
872,7,0,10,15,21552720,3698,2640,0,5837
873,13,0,17,8,21560460,3696,2640,0,5850
874,16,0,21,4,21612180,3697,2640,0,5866
875,12,0,20,5,21655200,3696,2640,0,5878
876,6,0,16,9,21695100,3697,2640,0,5884
877,7,0,12,13,21744060,3698,2640,0,5891
878,5,0,10,15,21769680,3698,2640,0,5896
879,12,0,15,10,21784680,3696,2640,0,5908
880,18,0,21,4,21825000,3696,2640,0,5926
881,6,0,17,8,21851340,3694,2640,0,5932
882,10,0,13,12,21912120,3695,2640,0,5942
883,3,0,8,17,21949080,3696,2640,0,5945
884,6,0,12,13,21959880,3697,2640,0,5951
885,2,0,8,17,21987660,3698,2640,0,5953
886,2,0,7,18,22004520,3699,2640,0,5955
887,7,0,11,14,22009200,3698,2640,0,5962
888,8,0,12,13,22020360,3695,2640,0,5970
889,8,0,14,11,22050420,3697,2640,0,5978
890,4,0,10,15,22072500,3695,2640,0,5982
891,4,0,11,14,22081380,3695,2640,0,5986
892,6,0,12,13,22103640,3696,2640,0,5992
893,7,0,11,14,22126860,3695,2640,0,5999
894,6,0,11,14,22151640,3695,2640,0,6005
895,6,0,12,13,22166340,3695,2640,0,6011
896,7,0,17,8,22176300,3695,2640,0,6018
897,7,0,12,13,22220040,3695,2640,0,6025
898,7,0,10,15,22251000,3694,2640,0,6032
899,10,0,11,14,22267080,3692,2640,0,6042
900,9,0,15,10,22281540,3691,2640,0,6051
901,10,0,16,9,22298700,3688,2640,0,6061
902,5,0,12,13,22346880,3691,2640,0,6066
903,7,0,11,14,22373640,3690,2640,0,6073
904,8,0,12,13,22401540,3691,2640,0,6081
905,11,0,14,11,22425480,3689,2640,0,6092
906,11,0,13,12,22468020,3689,2640,0,6103
907,7,0,13,12,22493340,3689,2640,0,6110
908,5,0,9,16,22532700,3690,2640,0,6115
909,4,0,11,14,22541520,3690,2640,0,6119
910,4,0,8,17,22559520,3689,2640,0,6123
911,5,0,10,15,22578660,3690,2640,0,6128
912,3,0,8,17,22595400,3690,2640,0,6131
913,6,0,8,17,22611600,3689,2640,0,6137
914,4,0,10,15,22618740,3689,2640,0,6141
915,4,0,8,17,22644480,3689,2640,0,6145
916,5,0,9,16,22653300,3688,2640,0,6150
917,4,0,13,12,22653300,3688,2640,0,6154
918,8,0,10,15,22689540,3688,2640,0,6162
919,6,0,10,15,22699020,3686,2640,0,6168
920,4,0,9,16,22715520,3685,2640,0,6172
921,8,0,9,16,22737780,3684,2640,0,6180
922,13,0,13,12,22757040,3682,2640,0,6193
923,9,0,15,10,22782120,3682,2640,0,6202
924,10,0,16,9,22811400,3681,2640,0,6212
925,8,0,16,9,22840620,3681,2640,0,6220
926,6,0,14,11,22876260,3682,2640,0,6226
927,13,0,15,10,22926540,3683,2640,0,6239
928,6,0,13,12,22949520,3682,2640,0,6245
929,7,0,16,9,22967280,3683,2640,0,6252
930,6,0,11,14,23021040,3685,2640,0,6258
931,10,0,18,7,23027760,3684,2640,0,6268
932,3,0,10,15,23089740,3687,2640,0,6271
933,8,0,13,12,23110260,3688,2640,0,6279
934,7,0,12,13,23137800,3687,2640,0,6286
935,4,0,8,17,23163540,3687,2640,0,6290
936,4,0,7,18,23180640,3687,2640,0,6294
937,4,0,10,15,23181360,3686,2640,0,6298
938,4,0,8,17,23197560,3685,2640,0,6302
939,4,0,8,17,23210640,3685,2640,0,6306
940,7,0,11,14,23220300,3684,2640,0,6313
941,5,0,15,10,23221080,3684,2640,0,6318
942,7,0,13,12,23264280,3685,2640,0,6325
943,5,0,11,14,23289000,3685,2640,0,6330
944,8,0,12,13,23309580,3684,2640,0,6338
945,5,0,12,13,23317140,3683,2640,0,6343
946,5,0,12,13,23341080,3683,2640,0,6348
947,7,0,11,14,23371980,3684,2640,0,6355
948,9,0,14,11,23393880,3684,2640,0,6364
949,7,0,14,11,23419500,3684,2640,0,6371
950,10,0,13,12,23470020,3685,2640,0,6381
951,7,0,14,11,23493180,3685,2640,0,6388
952,9,0,14,11,23529960,3686,2640,0,6397
953,10,0,17,8,23552880,3685,2640,0,6407
954,11,0,16,9,23591760,3685,2640,0,6418
955,3,0,9,16,23640660,3686,2640,0,6421
956,8,0,12,13,23656740,3686,2640,0,6429
957,4,0,10,15,23684220,3687,2640,0,6433
958,6,0,11,14,23696700,3686,2640,0,6439
959,1,0,9,16,23719500,3688,2640,0,6440
960,4,0,9,16,23747280,3690,2640,0,6444
961,5,0,9,16,23770320,3691,2640,0,6449
962,3,0,10,15,23779080,3691,2640,0,6452
963,3,0,7,18,23814840,3693,2640,0,6455
964,5,0,11,14,23816700,3693,2640,0,6460
965,5,0,10,15,23842140,3693,2640,0,6465
966,6,0,10,15,23857920,3692,2640,0,6471
967,3,0,11,14,23871660,3693,2640,0,6474
968,8,0,14,11,23898720,3694,2640,0,6482
969,2,0,8,17,23934060,3695,2640,0,6484
970,11,0,17,8,23940060,3695,2640,0,6495
971,9,0,18,7,23967480,3695,2640,0,6504
972,10,0,16,9,24014400,3695,2640,0,6514
973,7,0,11,14,24057900,3695,2640,0,6521
974,8,0,12,13,24089160,3696,2640,0,6529
975,4,0,9,16,24111660,3695,2640,0,6533
976,6,0,10,15,24129720,3695,2640,0,6539
977,10,0,14,11,24151320,3695,2640,0,6549
978,7,0,14,11,24170340,3694,2640,0,6556
979,10,0,17,8,24204600,3695,2640,0,6566
980,9,0,17,8,24252600,3698,2640,0,6575
981,10,0,14,11,24311160,3699,2640,0,6585
982,4,0,10,15,24332760,3698,2640,0,6589
983,5,0,9,16,24358740,3699,2640,0,6594
984,6,0,10,15,24374760,3698,2640,0,6600
985,5,0,10,15,24390060,3698,2640,0,6605
986,3,0,8,17,24406620,3697,2640,0,6608
987,3,0,7,18,24432600,3699,2640,0,6611
988,5,0,10,15,24437580,3699,2640,0,6616
989,5,0,11,14,24446100,3698,2640,0,6621
990,5,0,6,19,24477420,3697,2640,0,6626
991,11,0,14,11,24479580,3696,2640,0,6637
992,8,0,14,11,24500220,3694,2640,0,6645
993,6,0,15,10,24528900,3696,2640,0,6651
994,8,0,11,14,24579180,3697,2640,0,6659
995,6,0,11,14,24595020,3696,2640,0,6665
996,11,0,16,9,24612540,3695,2640,0,6676
997,11,0,18,7,24644820,3695,2640,0,6687
998,14,0,17,8,24705180,3696,2640,0,6701
999,10,0,18,7,24737460,3696,2640,0,6711
1000,5,0,11,14,24783840,3696,2640,0,6716
1001,12,0,15,10,24817920,3696,2640,0,6728
1002,8,0,13,12,24846600,3695,2640,0,6736
1003,8,0,14,11,24870180,3695,2640,0,6744
1004,7,0,9,16,24913980,3695,2640,0,6751
1005,6,0,10,15,24925140,3694,2640,0,6757
1006,3,0,9,16,24940200,3694,2640,0,6760
1007,1,0,7,18,24952260,3694,2640,0,6761
1008,4,0,9,16,24964680,3695,2640,0,6765
1009,4,0,9,16,24975420,3694,2640,0,6769
1010,4,0,8,17,24991200,3694,2640,0,6773
1011,6,0,12,13,24998820,3694,2640,0,6779
1012,3,0,11,14,25016160,3694,2640,0,6782
1013,4,0,8,17,25047120,3695,2640,0,6786
1014,4,0,7,18,25068540,3695,2640,0,6790
1015,2,0,7,18,25074660,3695,2640,0,6792
1016,5,0,9,16,25080060,3694,2640,0,6797
1017,4,0,12,13,25082040,3694,2640,0,6801
1018,7,0,11,14,25120140,3695,2640,0,6808
1019,3,0,10,15,25136160,3695,2640,0,6811
1020,10,0,12,13,25170000,3696,2640,0,6821
1021,9,0,11,14,25186320,3693,2640,0,6830
1022,5,0,12,13,25204860,3694,2640,0,6835
1023,6,0,10,15,25223400,3692,2640,0,6841
1024,9,0,15,10,25239060,3692,2640,0,6850
1025,5,0,9,16,25288200,3693,2640,0,6855
1026,7,0,11,14,25303500,3693,2640,0,6862
1027,4,0,12,13,25312140,3693,2640,0,6866
1028,1,0,7,18,25344480,3694,2640,0,6867
1029,5,0,9,16,25354080,3694,2640,0,6872
1030,7,0,13,12,25358820,3693,2640,0,6879
1031,3,0,13,12,25378200,3694,2640,0,6882
1032,3,0,9,16,25418580,3696,2640,0,6885
1033,6,0,7,18,25440060,3695,2640,0,6891
1034,7,0,10,15,25443600,3693,2640,0,6898
1035,10,0,12,13,25462380,3692,2640,0,6908
1036,3,0,9,16,25483740,3692,2640,0,6911
1037,3,0,9,16,25494540,3692,2640,0,6914
1038,4,0,9,16,25511880,3692,2640,0,6918
1039,7,0,12,13,25523340,3692,2640,0,6925
1040,6,0,12,13,25540860,3691,2640,0,6931
1041,8,0,13,12,25562280,3690,2640,0,6939
1042,6,0,12,13,25598460,3692,2640,0,6945
1043,12,0,15,10,25627200,3691,2640,0,6957
1044,8,0,15,10,25654500,3691,2640,0,6965
1045,11,0,15,10,25697220,3691,2640,0,6976
1046,5,0,13,12,25725180,3691,2640,0,6981
1047,7,0,13,12,25749000,3691,2640,0,6988
1048,5,0,8,17,25791600,3692,2640,0,6993
1049,7,0,13,12,25801140,3692,2640,0,7000
1050,7,0,11,14,25834680,3692,2640,0,7007
1051,11,0,14,11,25860420,3692,2640,0,7018
1052,4,0,10,15,25888140,3691,2640,0,7022
1053,10,0,13,12,25911900,3691,2640,0,7032
1054,6,0,13,12,25938780,3692,2640,0,7038
1055,2,0,10,15,25963980,3693,2640,0,7040
1056,5,0,9,16,25985040,3693,2640,0,7045
1057,5,0,8,17,26008620,3693,2640,0,7050
1058,6,0,10,15,26021160,3693,2640,0,7056
1059,3,0,11,14,26029860,3693,2640,0,7059
1060,4,0,10,15,26060820,3694,2640,0,7063
1061,1,0,10,15,26064120,3694,2640,0,7064
1062,1,0,7,18,26083020,3695,2640,0,7065
1063,6,0,10,15,26097600,3696,2640,0,7071
1064,11,0,12,13,26116680,3694,2640,0,7082
1065,5,0,12,13,26136900,3694,2640,0,7087
1066,8,0,13,12,26164500,3694,2640,0,7095
1067,10,0,14,11,26193780,3693,2640,0,7105
1068,2,0,9,16,26224740,3694,2640,0,7107
1069,6,0,8,17,26247780,3694,2640,0,7113
1070,5,0,11,14,26249520,3693,2640,0,7118
1071,9,0,14,11,26270400,3693,2640,0,7127
1072,14,0,18,7,26305740,3693,2640,0,7141
1073,4,0,12,13,26342460,3693,2640,0,7145
1074,8,0,12,13,26389980,3695,2640,0,7153
1075,7,0,11,14,26418300,3695,2640,0,7160
1076,7,0,10,15,26439000,3694,2640,0,7167
1077,9,0,12,13,26458740,3693,2640,0,7176
1078,6,0,8,17,26487420,3692,2640,0,7182
1079,6,0,11,14,26497500,3692,2640,0,7188
1080,5,0,11,14,26506920,3690,2640,0,7193
1081,6,0,11,14,26533200,3691,2640,0,7199
1082,3,0,9,16,26553240,3691,2640,0,7202
1083,6,0,10,15,26571420,3691,2640,0,7208
1084,2,0,7,18,26597640,3692,2640,0,7210
1085,2,0,6,19,26609100,3692,2640,0,7212
1086,4,0,9,16,26609880,3692,2640,0,7216
1087,4,0,9,16,26617380,3691,2640,0,7220
1088,6,0,11,14,26637060,3691,2640,0,7226
1089,10,0,15,10,26647080,3690,2640,0,7236
1090,12,0,15,10,26680020,3688,2640,0,7248
1091,7,0,12,13,26726400,3689,2640,0,7255
1092,3,0,10,15,26752080,3690,2640,0,7258
1093,3,0,9,16,26779020,3692,2640,0,7261
1094,11,0,17,8,26785560,3692,2640,0,7272
1095,7,0,13,12,26840340,3693,2640,0,7279
1096,10,0,13,12,26875860,3693,2640,0,7289
1097,5,0,13,12,26894280,3693,2640,0,7294
1098,8,0,17,8,26917200,3694,2640,0,7302
1099,4,0,9,16,26975940,3696,2640,0,7306
1100,8,0,11,14,26996220,3696,2640,0,7314
1101,5,0,11,14,27010320,3695,2640,0,7319
1102,6,0,13,12,27029160,3696,2640,0,7325
1103,5,0,12,13,27059460,3697,2640,0,7330
1104,8,0,10,15,27091980,3697,2640,0,7338
1105,4,0,9,16,27105120,3696,2640,0,7342
1106,2,0,8,17,27116400,3696,2640,0,7344
1107,9,0,9,16,27147540,3696,2640,0,7353
1108,5,0,11,14,27153540,3695,2640,0,7358
1109,1,0,8,17,27173880,3696,2640,0,7359
1110,3,0,8,17,27191880,3697,2640,0,7362
1111,9,0,13,12,27203100,3697,2640,0,7371
1112,7,0,14,11,27221940,3696,2640,0,7378
1113,8,0,12,13,27269460,3698,2640,0,7386
1114,8,0,11,14,27295980,3697,2640,0,7394
1115,9,0,14,11,27314160,3696,2640,0,7403
1116,8,0,16,9,27344940,3697,2640,0,7411
1117,9,0,14,11,27387480,3698,2640,0,7420
1118,6,0,11,14,27416340,3697,2640,0,7426
1119,7,0,14,11,27431640,3697,2640,0,7433
1120,11,0,15,10,27469020,3697,2640,0,7444
1121,7,0,15,10,27497760,3697,2640,0,7451
1122,5,0,12,13,27541500,3699,2640,0,7456
1123,9,0,15,10,27566400,3700,2640,0,7465
1124,1,0,11,14,27591120,3701,2640,0,7466
1125,6,0,14,11,27609180,3701,2640,0,7472
1126,8,0,17,8,27642960,3704,2640,0,7480
1127,5,0,11,14,27691680,3705,2640,0,7485
1128,9,0,12,13,27708240,3703,2640,0,7494
1129,9,0,13,12,27731820,3702,2640,0,7503
1130,4,0,11,14,27750480,3702,2640,0,7507
1131,4,0,8,17,27780060,3702,2640,0,7511
1132,4,0,9,16,27787440,3702,2640,0,7515
1133,6,0,12,13,27798300,3701,2640,0,7521
1134,10,0,16,9,27819540,3701,2640,0,7531
1135,6,0,14,11,27854700,3702,2640,0,7537
1136,8,0,10,15,27901140,3702,2640,0,7545
1137,10,0,12,13,27928680,3702,2640,0,7555
1138,7,0,16,9,27943020,3703,2640,0,7562
1139,12,0,16,9,27988500,3703,2640,0,7574
1140,10,0,14,11,28031760,3703,2640,0,7584
1141,10,0,16,9,28055880,3702,2640,0,7594
1142,7,0,14,11,28088640,3702,2640,0,7601
1143,7,0,8,17,28142520,3702,2640,0,7608
1144,8,0,16,9,28142520,3702,2640,0,7616
1145,7,0,14,11,28184100,3704,2640,0,7623
1146,8,0,14,11,28218780,3704,2640,0,7631
1147,8,0,14,11,28255320,3705,2640,0,7639
1148,9,0,18,7,28265760,3704,2640,0,7648
1149,6,0,13,12,28311600,3705,2640,0,7654
1150,4,0,12,13,28341300,3706,2640,0,7658
1151,4,0,10,15,28367160,3707,2640,0,7662
1152,5,0,10,15,28391520,3707,2640,0,7667
1153,7,0,9,16,28415280,3707,2640,0,7674
1154,4,0,5,20,28434180,3705,2640,0,7678
1155,2,0,7,18,28434180,3705,2640,0,7680
1156,4,0,10,15,28436160,3705,2640,0,7684
1157,4,0,9,16,28456140,3705,2640,0,7688
1158,4,0,11,14,28464300,3705,2640,0,7692
1159,3,0,8,17,28488480,3706,2640,0,7695
1160,3,0,10,15,28495140,3706,2640,0,7698
1161,4,0,9,16,28515120,3706,2640,0,7702
1162,3,0,5,20,28536420,3706,2640,0,7705
1163,6,0,9,16,28537860,3705,2640,0,7711
1164,10,0,14,11,28546380,3703,2640,0,7721
1165,8,0,12,13,28581660,3703,2640,0,7729
1166,10,0,14,11,28613100,3703,2640,0,7739
1167,6,0,13,12,28633140,3703,2640,0,7745
1168,14,1,20,5,28655880,3703,2640,0,7759
1169,7,0,15,10,28714380,3704,3480,0,7766
1170,6,0,16,9,28743540,3705,3480,0,7772
1171,8,0,14,11,28785780,3706,3480,0,7780
1172,4,0,10,15,28825320,3707,3480,0,7784
1173,11,0,13,12,28852440,3707,3480,0,7795
1174,3,0,8,17,28875480,3706,3480,0,7798
1175,10,0,10,15,28902240,3706,3480,0,7808
1176,5,0,11,14,28915740,3706,3480,0,7813
1177,2,0,9,16,28936500,3706,3480,0,7815
1178,7,0,13,12,28947900,3706,3480,0,7822
1179,5,0,9,16,28974960,3706,3480,0,7827
1180,7,0,13,12,28984500,3705,3480,0,7834
1181,12,0,18,7,29012040,3706,3480,0,7846
1182,6,0,14,11,29049660,3706,3480,0,7852
1183,4,0,13,12,29074140,3707,3480,0,7856
1184,7,0,14,11,29105640,3708,3480,0,7863
1185,11,0,17,8,29139600,3708,3480,0,7874
1186,6,1,14,11,29165340,3708,3480,0,7880
1187,4,0,12,13,29219940,3711,4560,0,7884
1188,9,0,13,12,29254440,3712,4560,0,7893
1189,10,0,14,11,29281380,3711,4560,0,7903
1190,15,0,20,5,29317440,3712,4560,0,7918
1191,10,0,17,8,29359740,3711,4560,0,7928
1192,7,0,16,9,29391060,3711,4560,0,7935
1193,9,0,16,9,29432940,3712,4560,0,7944
1194,11,0,17,8,29465460,3711,4560,0,7955
1195,10,0,18,7,29498100,3711,5820,0,7965
1196,6,0,18,7,29542920,3714,6000,0,7971
1197,9,0,16,9,29592240,3715,6000,0,7980
1198,4,0,11,14,29646180,3718,6000,0,7984
1199,6,0,9,16,29674800,3718,6000,0,7990
1200,4,0,9,16,29689920,3718,6000,0,7994
1201,1,0,9,16,29695440,3718,6000,0,7995
1202,4,0,10,15,29704440,3718,6000,0,7999
1203,5,0,11,14,29728800,3719,6000,0,8004
1204,2,0,8,17,29740860,3718,6000,0,8006
1205,4,0,8,17,29756340,3718,6000,0,8010
1206,2,0,9,16,29759400,3718,6000,0,8012
1207,9,0,15,10,29777400,3719,6000,0,8021
1208,1,0,8,17,29804580,3719,6000,0,8022
1209,7,0,13,12,29811180,3718,6000,0,8029
1210,9,0,12,13,29846940,3718,6000,0,8038
1211,9,0,16,9,29857860,3717,6000,0,8047
1212,6,0,11,14,29911860,3719,6000,0,8053
1213,13,0,15,10,29946540,3719,6000,0,8066
1214,11,0,15,10,29972700,3717,6000,0,8077
1215,3,0,11,14,29989740,3716,6000,0,8080
1216,8,0,11,14,30021960,3716,6000,0,8088
1217,7,0,13,12,30040140,3716,6000,0,8095
1218,5,0,8,17,30072180,3716,6000,0,8100
1219,5,0,10,15,30078360,3715,6000,0,8105
1220,6,0,10,15,30098280,3715,6000,0,8111
1221,4,0,10,15,30115800,3715,6000,0,8115
1222,6,0,11,14,30130200,3715,6000,0,8121
1223,5,0,10,15,30160260,3716,6000,0,8126
1224,3,0,11,14,30164460,3715,6000,0,8129
1225,1,0,6,19,30197640,3717,6000,0,8130
1226,5,0,10,15,30201660,3717,6000,0,8135
1227,3,0,10,15,30211080,3716,6000,0,8138
1228,6,0,12,13,30234960,3718,6000,0,8144
1229,5,0,11,14,30257100,3718,6000,0,8149
1230,11,0,16,9,30279180,3717,6000,0,8160
1231,8,0,17,8,30296760,3716,6000,0,8168
1232,6,0,11,14,30362640,3719,6000,0,8174
1233,6,0,13,12,30377280,3719,6000,0,8180
1234,9,0,17,8,30395040,3719,6000,0,8189
1235,8,0,16,9,30439740,3720,6000,0,8197
1236,11,0,18,7,30478080,3721,6000,0,8208
1237,15,0,20,5,30519960,3720,6000,0,8223
1238,11,0,15,10,30578760,3720,6000,0,8234
1239,13,0,16,9,30625680,3720,6000,0,8247
1240,12,0,15,10,30675900,3720,6000,0,8259
1241,8,0,11,14,30709560,3719,6000,0,8267
1242,8,0,13,12,30736920,3720,6000,0,8275
1243,5,0,11,14,30761340,3720,6000,0,8280
1244,5,0,8,17,30785760,3719,6000,0,8285
1245,4,0,7,18,30806100,3719,6000,0,8289
1246,5,0,9,16,30816420,3719,6000,0,8294
1247,5,0,12,13,30822360,3719,6000,0,8299
1248,4,0,11,14,30833880,3718,6000,0,8303
1249,6,0,12,13,30865680,3720,6000,0,8309
1250,3,0,8,17,30888600,3719,6000,0,8312
1251,5,0,9,16,30907800,3720,6000,0,8317
1252,3,0,7,18,30921240,3719,6000,0,8320
1253,2,0,5,20,30931680,3719,6000,0,8322
1254,6,0,10,15,30932340,3718,6000,0,8328
1255,13,0,14,11,30949200,3716,6000,0,8341
1256,6,0,11,14,30983160,3716,6000,0,8347
1257,9,0,13,12,31010040,3716,6000,0,8356
1258,10,0,15,10,31032300,3715,6000,0,8366
1259,10,0,13,12,31069680,3715,6000,0,8376
1260,8,0,14,11,31096380,3715,6000,0,8384
1261,8,0,12,13,31132440,3715,6000,0,8392
1262,7,0,13,12,31152720,3714,6000,0,8399
1263,11,0,14,11,31183800,3714,6000,0,8410
1264,5,0,11,14,31210440,3713,6000,0,8415
1265,11,0,17,8,31233420,3714,6000,0,8426
1266,8,0,12,13,31288020,3715,6000,0,8434
1267,3,0,9,16,31322580,3716,6000,0,8437
1268,9,0,13,12,31337940,3716,6000,0,8446
1269,4,0,9,16,31360080,3715,6000,0,8450
1270,5,0,10,15,31376280,3715,6000,0,8455
1271,5,0,11,14,31394400,3715,6000,0,8460
1272,3,0,9,16,31418640,3716,6000,0,8463
1273,4,0,7,18,31445820,3717,6000,0,8467
1274,3,0,9,16,31446600,3716,6000,0,8470
1275,4,0,9,16,31460160,3716,6000,0,8474
1276,3,0,6,19,31480320,3716,6000,0,8477
1277,4,0,8,17,31490880,3716,6000,0,8481
1278,9,0,11,14,31498740,3714,6000,0,8490
1279,9,0,12,13,31520040,3713,6000,0,8499
1280,6,0,9,16,31553460,3713,6000,0,8505
1281,8,0,13,12,31562880,3713,6000,0,8513
1282,12,0,15,10,31594320,3712,6000,0,8525
1283,7,0,12,13,31634340,3712,6000,0,8532
1284,6,0,12,13,31657740,3713,6000,0,8538
1285,12,0,15,10,31691700,3713,6000,0,8550
1286,9,0,14,11,31721460,3712,6000,0,8559
1287,6,0,13,12,31754880,3713,6000,0,8565
1288,9,0,18,7,31766460,3712,6000,0,8574
1289,11,0,20,5,31806000,3713,6000,0,8585
1290,4,0,12,13,31878300,3716,6000,0,8589
1291,7,0,12,13,31908720,3717,6000,0,8596
1292,8,0,15,10,31924980,3716,6000,0,8604
1293,5,0,12,13,31959120,3717,6000,0,8609
1294,7,0,11,14,32004120,3719,6000,0,8616
1295,8,0,11,14,32021280,3717,6000,0,8624
1296,6,0,10,15,32043480,3717,6000,0,8630
1297,6,0,13,12,32054280,3717,6000,0,8636
1298,9,0,14,11,32084040,3717,6000,0,8645
1299,10,0,11,14,32114640,3715,6000,0,8655
1300,3,0,10,15,32121000,3714,6000,0,8658
1301,6,0,9,16,32150640,3714,6000,0,8664
1302,10,0,15,10,32165760,3714,6000,0,8674
1303,7,0,12,13,32199120,3714,6000,0,8681
1304,9,0,14,11,32227800,3714,6000,0,8690
1305,10,0,17,8,32248260,3713,6000,0,8700
1306,7,0,11,14,32307060,3715,6000,0,8707
1307,5,0,11,14,32323680,3714,6000,0,8712
1308,5,0,12,13,32332260,3714,6000,0,8717
1309,5,0,10,15,32372760,3715,6000,0,8722
1310,5,0,12,13,32392560,3716,6000,0,8727
1311,7,0,14,11,32415360,3717,6000,0,8734
1312,12,0,13,12,32465100,3717,6000,0,8746
1313,6,0,14,11,32493600,3718,6000,0,8752
1314,6,0,12,13,32517540,3717,6000,0,8758
1315,5,0,13,12,32538420,3718,6000,0,8763
1316,10,0,13,12,32577480,3718,6000,0,8773
1317,6,0,14,11,32600820,3719,6000,0,8779
1318,2,0,5,20,32644500,3719,6000,0,8781
1319,7,0,9,16,32646660,3718,6000,0,8788
1320,8,0,11,14,32655660,3717,6000,0,8796
1321,6,0,9,16,32684700,3717,6000,0,8802
1322,3,0,10,15,32696400,3717,6000,0,8805
1323,0,0,7,18,32711640,3718,6000,0,8805
1324,4,0,8,17,32737260,3719,6000,0,8809
1325,6,0,9,16,32744880,3718,6000,0,8815
1326,5,0,10,15,32754420,3717,6000,0,8820
1327,5,0,11,14,32776980,3718,6000,0,8825
1328,7,0,11,14,32795700,3717,6000,0,8832
1329,5,0,11,14,32812740,3717,6000,0,8837
1330,11,0,16,9,32838900,3718,6000,0,8848
1331,13,0,20,5,32873640,3718,6000,0,8861
1332,7,0,14,11,32920560,3718,6000,0,8868
1333,5,0,11,14,32977860,3721,6000,0,8873
1334,10,0,15,10,32992980,3720,6000,0,8883
1335,3,0,9,16,33018360,3719,6000,0,8886
1336,9,0,14,11,33040020,3720,6000,0,8895
1337,6,0,10,15,33067800,3719,6000,0,8901
1338,6,0,12,13,33084540,3719,6000,0,8907
1339,5,0,9,16,33109620,3718,6000,0,8912
1340,5,0,9,16,33120240,3718,6000,0,8917
1341,7,0,10,15,33141840,3717,6000,0,8924
1342,5,0,9,16,33161760,3717,6000,0,8929
1343,2,0,7,18,33173460,3717,6000,0,8931
1344,2,0,8,17,33175080,3717,6000,0,8933
1345,5,0,10,15,33181320,3716,6000,0,8938
1346,5,0,13,12,33186660,3716,6000,0,8943
1347,3,0,9,16,33217200,3716,6000,0,8946
1348,8,0,16,9,33218220,3716,6000,0,8954
1349,8,0,17,8,33244740,3716,6000,0,8962
1350,8,0,13,12,33286020,3716,6000,0,8970
1351,12,0,20,5,33294360,3715,6000,0,8982
1352,7,0,15,10,33346500,3715,6000,0,8989
1353,6,0,14,11,33384780,3717,6000,0,8995
1354,10,0,14,11,33417000,3716,6000,0,9005
1355,9,0,12,13,33448020,3715,6000,0,9014
1356,9,0,18,7,33456360,3715,6000,0,9023
1357,9,0,16,9,33492900,3714,6000,0,9032
1358,9,0,16,9,33529380,3715,6000,0,9041
1359,4,0,14,11,33558780,3715,6000,0,9045
1360,4,0,11,14,33581400,3715,6000,0,9049
1361,7,0,13,12,33609000,3716,6000,0,9056
1362,10,0,16,9,33622260,3715,6000,0,9066
1363,8,0,15,10,33656220,3715,6000,0,9074
1364,7,0,15,10,33679260,3714,6000,0,9081
1365,1,0,10,15,33714600,3716,6000,0,9082
1366,5,0,11,14,33733080,3716,6000,0,9087
1367,4,0,12,13,33745260,3716,6000,0,9091
1368,6,0,12,13,33760020,3716,6000,0,9097
1369,8,0,16,9,33774540,3715,6000,0,9105
1370,4,0,11,14,33802860,3715,6000,0,9109
1371,2,0,9,16,33822300,3715,6000,0,9111
1372,6,0,13,12,33830700,3716,6000,0,9117
1373,8,0,13,12,33858360,3715,6000,0,9125
1374,7,0,17,8,33868800,3715,6000,0,9132
1375,7,0,17,8,33899220,3716,6000,0,9139
1376,8,0,17,8,33939420,3717,6180,0,9147
1377,15,6,19,6,33975780,3718,14580,1,9162
1378,5,3,22,3,34002240,3719,31080,3,9167
1379,15,0,21,4,34060620,3718,42960,4,9182
1380,10,0,15,10,34129800,3719,42960,4,9192
1381,5,0,11,14,34149600,3717,42960,4,9197
1382,9,0,13,12,34173060,3717,42960,4,9206
1383,8,0,13,12,34196940,3716,42960,4,9214
1384,8,0,14,11,34224840,3716,42960,4,9222
1385,8,0,16,9,34238400,3715,42960,4,9230
1386,10,0,18,7,34273920,3716,42960,4,9240
1387,6,0,14,11,34307520,3716,42960,4,9246
1388,8,0,15,10,34329000,3715,42960,4,9254
1389,7,0,15,10,34361940,3716,42960,4,9261
1390,2,0,9,16,34390680,3716,42960,4,9263
1391,3,0,11,14,34391760,3716,42960,4,9266
1392,2,0,9,16,34412340,3716,42960,4,9268
1393,2,0,8,17,34420620,3716,42960,4,9270
1394,1,0,7,18,34424760,3715,42960,4,9271
1395,3,0,10,15,34424760,3715,42960,4,9274
1396,7,0,13,12,34432140,3715,42960,4,9281
1397,3,0,11,14,34450380,3715,42960,4,9284
1398,5,0,13,12,34459920,3714,42960,4,9289
1399,8,0,14,11,34485780,3714,42960,4,9297
1400,6,0,14,11,34513920,3715,42960,4,9303
1401,10,0,13,12,34546860,3714,42960,4,9313
1402,0,0,7,18,34572180,3715,42960,4,9313
1403,7,0,14,11,34572180,3715,42960,4,9320
1404,11,0,16,9,34594200,3713,42960,4,9331
1405,10,0,19,6,34619520,3713,43080,4,9341
1406,8,0,15,10,34663800,3713,43080,4,9349
1407,6,0,17,8,34684560,3714,43080,4,9355
1408,13,0,18,7,34724220,3713,43080,4,9368
1409,7,0,14,11,34762740,3713,43080,4,9375
1410,6,0,14,11,34801020,3715,43080,4,9381
1411,5,0,13,12,34818480,3714,43080,4,9386
1412,12,0,17,8,34834500,3713,43080,4,9398
1413,8,0,13,12,34869900,3712,43080,4,9406
1414,7,0,12,13,34896060,3711,43080,4,9413
1415,4,0,12,13,34914960,3712,43080,4,9417
1416,6,0,12,13,34934340,3712,43080,4,9423
1417,5,0,12,13,34944300,3711,43080,4,9428
1418,5,0,12,13,34968420,3711,43080,4,9433
1419,8,0,13,12,34996860,3712,43080,4,9441
1420,6,0,12,13,35013420,3711,43080,4,9447
1421,10,0,15,10,35040240,3711,43080,4,9457
1422,5,0,13,12,35067840,3711,43080,4,9462
1423,7,0,13,12,35088540,3710,43080,4,9469
1424,5,0,15,10,35092680,3709,43080,4,9474
1425,6,0,15,10,35114640,3709,43080,4,9480
1426,8,0,16,9,35148480,3710,43080,4,9488
1427,13,0,19,6,35188560,3711,43080,4,9501
1428,4,0,14,11,35227080,3711,43080,4,9505
1429,10,0,17,8,35259060,3712,43080,4,9515
1430,15,0,19,6,35292960,3710,43080,4,9530
1431,6,0,15,10,35324040,3710,43080,4,9536
1432,10,0,13,12,35368140,3710,43080,4,9546
1433,4,0,11,14,35385240,3709,43080,4,9550
1434,5,0,13,12,35396040,3709,43080,4,9555
1435,8,0,16,9,35419200,3709,43080,4,9563
1436,10,0,19,6,35435760,3708,43080,4,9573
1437,2,0,11,14,35483160,3710,43080,4,9575
1438,8,0,17,8,35498820,3710,43080,4,9583
1439,4,0,15,10,35528700,3711,43080,4,9587
1440,5,0,15,10,35555100,3712,43080,4,9592
1441,6,0,18,7,35566320,3712,43080,4,9598
1442,4,0,13,12,35618520,3714,43080,4,9602
1443,13,0,17,8,35652120,3714,43080,4,9615
1444,5,0,18,7,35662200,3714,43080,4,9620
1445,6,0,12,13,35709420,3714,43080,4,9626
1446,11,0,17,8,35731080,3714,43080,4,9637
1447,7,0,15,10,35759400,3713,43080,4,9644
1448,6,0,14,11,35780940,3713,43080,4,9650
1449,5,0,12,13,35807760,3713,43080,4,9655
1450,4,0,8,17,35845200,3714,43080,4,9659
1451,1,0,9,16,35845200,3714,43080,4,9660
1452,10,0,13,12,35854740,3712,43080,4,9670
1453,12,0,15,10,35888940,3712,43080,4,9682
1454,6,0,14,11,35917500,3712,43080,4,9688
1455,9,0,18,7,35936460,3712,43080,4,9697
1456,4,0,12,13,35980020,3713,43080,4,9701
1457,8,0,12,13,36004980,3713,43080,4,9709
1458,7,0,13,12,36020040,3712,43080,4,9716
1459,5,0,11,14,36040140,3711,43080,4,9721
1460,10,0,14,11,36060120,3711,43080,4,9731
1461,8,0,14,11,36081120,3710,43080,4,9739
1462,6,0,13,12,36113160,3710,43080,4,9745
1463,3,0,11,14,36131040,3710,43080,4,9748
1464,2,0,11,14,36145020,3711,43080,4,9750
1465,4,0,11,14,36156960,3711,43080,4,9754
1466,7,0,13,12,36171780,3710,43080,4,9761
1467,5,0,12,13,36197340,3711,43080,4,9766
1468,5,0,13,12,36210660,3710,43080,4,9771
1469,5,0,11,14,36244140,3711,43080,4,9776
1470,3,0,12,13,36245940,3711,43080,4,9779
1471,10,0,15,10,36273900,3711,43080,4,9789
1472,6,0,16,9,36293040,3711,43080,4,9795
1473,8,0,15,10,36331260,3711,43080,4,9803
1474,9,0,15,10,36365520,3711,43080,4,9812
1475,4,0,13,12,36384180,3711,43080,4,9816
1476,9,0,10,15,36432180,3711,43080,4,9825
1477,1,0,11,14,36432180,3711,43080,4,9826
1478,6,0,14,11,36450540,3712,43080,4,9832
1479,10,0,20,5,36466140,3712,43080,4,9842
1480,10,0,18,7,36509400,3712,43080,4,9852
1481,5,0,16,9,36541140,3713,43080,4,9857
1482,11,0,18,7,36579780,3713,43080,4,9868
1483,14,0,20,5,36615060,3712,43080,4,9882
1484,10,0,16,9,36660480,3712,43080,4,9892
1485,11,0,18,7,36700380,3712,43080,4,9903
1486,6,0,13,12,36742500,3712,43080,4,9909
1487,8,0,12,13,36778980,3713,43080,4,9917
1488,6,0,13,12,36797700,3713,43080,4,9923
1489,3,0,11,14,36822600,3713,43080,4,9926
1490,5,0,11,14,36841080,3713,43080,4,9931
1491,7,0,16,9,36847020,3713,43080,4,9938
1492,6,0,13,12,36883800,3714,43080,4,9944
1493,4,0,12,13,36902400,3714,43080,4,9948
1494,9,0,16,9,36924900,3714,43080,4,9957
1495,5,0,13,12,36950340,3713,43080,4,9962
1496,7,0,14,11,36962580,3712,43080,4,9969
1497,8,0,14,11,36996060,3713,43080,4,9977
1498,7,0,15,10,37014840,3712,43080,4,9984
1499,10,0,19,6,37039380,3713,43080,4,9994
1500,8,0,12,13,37077660,3711,43080,4,10002
1501,13,0,14,11,37104360,3710,43080,4,10015
1502,15,0,23,2,37117620,3709,43080,4,10030
1503,7,0,15,10,37182960,3710,43140,4,10037
1504,7,0,13,12,37216320,3710,43140,4,10044
1505,6,0,12,13,37249620,3710,43140,4,10050
1506,10,0,14,11,37269420,3709,43140,4,10060
1507,5,0,14,11,37290540,3710,43140,4,10065
1508,2,0,11,14,37316940,3710,43140,4,10067
1509,5,0,11,14,37337580,3711,43140,4,10072
1510,6,0,11,14,37361040,3711,43140,4,10078
1511,3,0,13,12,37365600,3711,43140,4,10081
1512,2,0,13,12,37377600,3711,43140,4,10083
1513,5,0,10,15,37405620,3711,43140,4,10088
1514,2,0,11,14,37406580,3711,43140,4,10090
1515,3,0,8,17,37444320,3712,43140,4,10093
1516,5,0,13,12,37444320,3712,43140,4,10098
1517,4,0,11,14,37453980,3711,43140,4,10102
1518,9,0,14,11,37472100,3711,43140,4,10111
1519,6,0,14,11,37497600,3711,43140,4,10117
1520,7,0,19,6,37504740,3711,43140,4,10124
1521,5,0,14,11,37548300,3712,43140,4,10129
1522,10,0,18,7,37564080,3711,43140,4,10139
1523,12,0,18,7,37609560,3711,43980,4,10151
1524,10,1,19,6,37633140,3710,43980,4,10161
1525,15,0,21,4,37702020,3712,44580,4,10176
1526,9,0,18,7,37743480,3712,44580,4,10185
1527,3,0,13,12,37790040,3714,44580,4,10188
1528,9,0,15,10,37821960,3714,44580,4,10197
1529,6,0,16,9,37845060,3715,44580,4,10203
1530,7,0,14,11,37873380,3714,44580,4,10210
1531,10,0,16,9,37913220,3715,44580,4,10220
1532,10,0,20,5,37932720,3715,44580,4,10230
1533,5,0,14,11,37978260,3715,44580,4,10235
1534,8,0,13,12,38019840,3716,44580,4,10243
1535,3,0,12,13,38038380,3716,44580,4,10246
1536,4,0,13,12,38051820,3717,44580,4,10250
1537,1,0,9,16,38075700,3717,44580,4,10251
1538,6,0,14,11,38076240,3717,44580,4,10257
1539,6,0,13,12,38102880,3717,44580,4,10263
1540,3,0,10,15,38130960,3717,44580,4,10266
1541,2,0,10,15,38137440,3717,44580,4,10268
1542,3,0,8,17,38157660,3717,44580,4,10271
1543,4,0,10,15,38159340,3717,44580,4,10275
1544,10,0,16,9,38168520,3716,44580,4,10285
1545,1,0,9,16,38203020,3717,44580,4,10286
1546,15,0,16,9,38224860,3716,44580,4,10301
1547,10,0,18,7,38247600,3715,44580,4,10311
1548,3,0,11,14,38280960,3715,44580,4,10314
1549,8,0,13,12,38299740,3715,44580,4,10322
1550,6,0,15,10,38314740,3715,44580,4,10328
1551,7,0,13,12,38345580,3714,44580,4,10335
1552,6,0,14,11,38364840,3715,44580,4,10341
1553,6,0,14,11,38394480,3715,44580,4,10347
1554,7,0,16,9,38414700,3715,44580,4,10354
1555,6,0,12,13,38450940,3715,44580,4,10360
1556,5,0,12,13,38471520,3715,44580,4,10365
1557,9,0,17,8,38482860,3715,44580,4,10374
1558,5,0,12,13,38517480,3715,44580,4,10379
1559,8,0,15,10,38538720,3715,44580,4,10387
1560,7,0,15,10,38558940,3715,44580,4,10394
1561,3,0,10,15,38587080,3714,44580,4,10397
1562,6,0,13,12,38603520,3715,44580,4,10403
1563,3,0,14,11,38615040,3715,44580,4,10406
1564,2,0,12,13,38634540,3716,44580,4,10408
1565,7,0,13,12,38669220,3717,44580,4,10415
1566,5,0,15,10,38681400,3717,44580,4,10420
1567,8,0,18,7,38702520,3717,44580,4,10428
1568,9,0,17,8,38742480,3718,44580,4,10437
1569,6,0,15,10,38766840,3717,44580,4,10443
1570,4,0,10,15,38811720,3718,44580,4,10447
1571,7,0,15,10,38822520,3718,44580,4,10454
1572,7,0,15,10,38848800,3719,44580,4,10461
1573,8,0,17,8,38874660,3719,44580,4,10469
1574,12,0,24,1,38897040,3719,44580,4,10481
1575,9,0,13,12,38967300,3719,44580,4,10490
1576,12,0,19,6,38996640,3719,44580,4,10502
1577,8,0,17,8,39024660,3719,44580,4,10510
1578,7,0,12,13,39070140,3719,44580,4,10517
1579,7,0,14,11,39100560,3720,44580,4,10524
1580,6,0,14,11,39108900,3718,44580,4,10530
1581,9,3,17,8,39133920,3720,47280,4,10539
1582,9,0,20,5,39178860,3721,53040,5,10548
1583,6,0,17,8,39219660,3722,53040,5,10554
1584,5,0,13,12,39252720,3722,53040,5,10559
1585,2,0,9,16,39291600,3723,53040,5,10561
1586,4,0,10,15,39305880,3723,53040,5,10565
1587,4,0,12,13,39311280,3723,53040,5,10569
1588,5,0,14,11,39322380,3723,53040,5,10574
1589,8,0,10,15,39351420,3722,53040,5,10582
1590,3,0,11,14,39363240,3722,53040,5,10585
1591,7,0,14,11,39376980,3722,53040,5,10592
1592,1,0,10,15,39396240,3722,53040,5,10593
1593,10,0,14,11,39423540,3723,53040,5,10603
1594,6,0,17,8,39430800,3722,53040,4,10609
1595,11,0,19,6,39474000,3723,53040,4,10620
1596,7,0,14,11,39518640,3723,53040,4,10627
1597,12,0,16,9,39543900,3722,53040,4,10639
1598,9,0,17,8,39564480,3721,53040,4,10648
1599,13,0,20,5,39602640,3721,53040,4,10661
1600,13,0,20,5,39660240,3722,53220,4,10674
1601,10,0,18,7,39703380,3722,53220,4,10684
1602,8,0,15,10,39755400,3723,53220,4,10692
1603,7,0,14,11,39780120,3722,53220,4,10699
1604,2,0,9,16,39811320,3723,53220,4,10701
1605,8,0,10,15,39822780,3722,53220,4,10709
1606,5,0,15,10,39822780,3722,53220,4,10714
1607,2,0,11,14,39849180,3722,53220,4,10716
1608,7,0,15,10,39862320,3722,53220,4,10723
1609,11,0,18,7,39886920,3722,53220,4,10734
1610,3,0,11,14,39932640,3722,53220,4,10737
1611,6,0,12,13,39946020,3722,53220,4,10743
1612,7,0,15,10,39960120,3722,53220,4,10750
1613,5,0,12,13,39988680,3722,53220,4,10755
1614,1,0,10,15,40010340,3723,53220,4,10756
1615,10,0,14,11,40027680,3722,53220,4,10766
1616,10,0,17,8,40040760,3721,53220,4,10776
1617,11,0,21,4,40060380,3721,53220,4,10787
1618,11,0,18,7,40120560,3721,53220,4,10798
1619,11,0,15,10,40170780,3721,53220,4,10809
1620,12,0,17,8,40199280,3720,53220,4,10821
1621,3,0,13,12,40225920,3720,53220,4,10824
1622,6,0,13,12,40254600,3721,53220,4,10830
1623,6,0,13,12,40272480,3721,53220,4,10836
1624,5,0,10,15,40304880,3721,53220,4,10841
1625,14,0,18,7,40314000,3720,53220,4,10855
1626,8,0,20,5,40327080,3719,53220,4,10863
1627,4,0,12,13,40391940,3721,53220,4,10867
1628,6,0,11,14,40423560,3721,53220,4,10873
1629,7,0,13,12,40436160,3721,53220,4,10880
1630,4,0,14,11,40443600,3720,53220,4,10884
1631,5,0,12,13,40472160,3720,53220,4,10889
1632,5,0,13,12,40489020,3721,53220,4,10894
1633,2,0,10,15,40507200,3721,53220,4,10896
1634,3,0,7,18,40531620,3721,53220,4,10899
1635,5,0,12,13,40531620,3721,53220,4,10904
1636,4,0,11,14,40547520,3720,53220,4,10908
1637,7,0,13,12,40561020,3720,53220,4,10915
1638,5,0,13,12,40574700,3720,53220,4,10920
1639,7,0,12,13,40601460,3719,53220,4,10927
1640,8,0,16,9,40618920,3720,53220,4,10935
1641,10,0,19,6,40643640,3719,53220,4,10945
1642,8,0,14,11,40682100,3718,53220,4,10953
1643,11,0,16,9,40725840,3719,53220,4,10964
1644,7,0,17,8,40742400,3719,53220,4,10971
1645,11,0,15,10,40786380,3719,53220,4,10982
1646,9,0,15,10,40817220,3718,53220,4,10991
1647,9,0,14,11,40848240,3718,53220,4,11000
1648,10,2,16,9,40870860,3718,53880,4,11010
1649,12,13,15,10,40881540,3718,54240,4,11022
1650,3,12,13,12,40931640,3721,69960,6,11025
1651,7,15,16,9,40943640,3721,86160,7,11032
1652,8,8,24,1,40980000,3722,157020,14,11040
1653,7,0,16,9,41040480,3720,225720,20,11047
1654,4,0,13,12,41073480,3721,225720,20,11051
1655,5,0,10,15,41101020,3720,225720,20,11056
1656,4,0,10,15,41106660,3720,225720,20,11060
1657,2,0,9,16,41120880,3720,225720,20,11062
1658,6,0,12,13,41133000,3720,225720,20,11068
1659,6,0,13,12,41146440,3719,225720,20,11074
1660,4,0,8,17,41179740,3719,225720,20,11078
1661,3,0,10,15,41180400,3719,225720,20,11081
1662,5,0,13,12,41191020,3719,225720,20,11086
1663,3,0,9,16,41211600,3719,225720,20,11089
1664,5,0,10,15,41219220,3718,225720,20,11094
1665,4,0,13,12,41220120,3718,225720,20,11098
1666,12,0,15,10,41253420,3718,225720,20,11110
1667,6,0,14,11,41280420,3718,225720,20,11116
1668,12,0,14,11,41316960,3717,225720,20,11128
1669,8,0,14,11,41342460,3717,225720,20,11136
1670,8,0,15,10,41357760,3716,225720,20,11144
1671,7,0,15,10,41375700,3715,225720,20,11151
1672,5,0,12,13,41417040,3716,225720,20,11156
1673,3,0,11,14,41437200,3717,225720,20,11159
1674,5,0,14,11,41447940,3717,225720,20,11164
1675,11,0,17,8,41479680,3717,225720,20,11175
1676,3,0,13,12,41496960,3716,225720,20,11178
1677,8,0,12,13,41530920,3716,225720,20,11186
1678,5,0,10,15,41550120,3716,225720,20,11191
1679,7,0,15,10,41560500,3716,225720,20,11198
1680,5,0,11,14,41587380,3715,225720,20,11203
1681,8,0,15,10,41601960,3715,225720,20,11211
1682,5,0,16,9,41617860,3715,225720,20,11216
1683,7,0,18,7,41649060,3717,225720,20,11223
1684,5,0,14,11,41686080,3717,225720,20,11228
1685,4,0,13,12,41715060,3718,225720,20,11232
1686,7,0,13,12,41739960,3718,225720,20,11239
1687,4,0,12,13,41759700,3718,225720,20,11243
1688,5,0,13,12,41769660,3717,225720,20,11248
1689,8,0,14,11,41790360,3717,225720,20,11256
1690,9,0,11,14,41824740,3716,225720,20,11265
1691,7,0,15,10,41829960,3715,225720,20,11272
1692,12,0,23,2,41844060,3715,225720,20,11284
1693,10,0,20,5,41901240,3716,225720,19,11294
1694,10,0,15,10,41964600,3717,225720,19,11304
1695,11,0,13,12,41996700,3715,225720,19,11315
1696,9,0,13,12,42023940,3715,225720,19,11324
1697,7,0,13,12,42044640,3714,225720,19,11331
1698,4,0,13,12,42060060,3714,225720,19,11335
1699,6,0,10,15,42092160,3714,225720,19,11341
1700,3,0,11,14,42094560,3714,225720,19,11344
1701,6,0,12,13,42118080,3714,225720,19,11350
1702,3,0,13,12,42121800,3714,225720,19,11353
1703,3,0,13,12,42138660,3714,225720,19,11356
1704,3,0,13,12,42165840,3716,225720,19,11359
1705,2,0,10,15,42189900,3716,225720,19,11361
1706,6,0,13,12,42199380,3716,225720,19,11367
1707,6,0,13,12,42219120,3716,225720,19,11373
1708,4,0,10,15,42244680,3716,225720,19,11377
1709,6,0,14,11,42246720,3715,225720,19,11383
1710,6,0,17,8,42263040,3716,225720,19,11389
1711,8,0,17,8,42290520,3716,225720,19,11397
1712,6,0,14,11,42334620,3717,225720,19,11403
1713,3,0,11,14,42368700,3718,225720,19,11406
1714,9,0,16,9,42389520,3718,225720,19,11415
1715,11,0,17,8,42415320,3717,225720,19,11426
1716,9,0,20,5,42433020,3717,225720,19,11435
1717,10,0,12,13,42499860,3717,225720,19,11445
1718,10,0,19,6,42503640,3716,225720,19,11455
1719,11,0,18,7,42551940,3716,225720,19,11466
1720,7,0,18,7,42577500,3716,225720,19,11473
1721,8,0,17,8,42622980,3717,225720,19,11481
1722,6,0,14,11,42647640,3717,225720,19,11487
1723,5,0,11,14,42687480,3718,225720,19,11492
1724,8,0,13,12,42708600,3717,225720,19,11500
1725,4,0,12,13,42737100,3718,225720,19,11504
1726,6,0,15,10,42753180,3719,225720,19,11510
1727,1,0,8,17,42791160,3720,225720,19,11511
1728,7,0,13,12,42798900,3720,225720,19,11518
1729,5,0,13,12,42808980,3719,225720,19,11523
1730,3,0,11,14,42833460,3719,225720,19,11526
1731,2,0,11,14,42840180,3719,225720,19,11528
1732,4,0,11,14,42859380,3720,225720,19,11532
1733,8,0,16,9,42871020,3720,225720,19,11540
1734,4,0,13,12,42897420,3720,225720,19,11544
1735,8,0,13,12,42931800,3720,225720,19,11552
1736,7,0,14,11,42951240,3720,225720,19,11559
1737,11,0,16,9,42979380,3719,225720,19,11570
1738,2,0,12,13,43000080,3719,225720,19,11572
1739,6,0,11,14,43022520,3719,225720,19,11578
1740,9,0,15,10,43043400,3719,225720,19,11587
1741,15,0,21,4,43078800,3719,225720,19,11602
1742,11,0,21,4,43118820,3719,225720,19,11613
1743,10,0,17,8,43167240,3719,225720,19,11623
1744,7,0,15,10,43203120,3719,225720,19,11630
1745,11,0,16,9,43232880,3718,225720,19,11641
1746,6,0,15,10,43259880,3719,225720,19,11647
1747,4,0,12,13,43291440,3719,225720,19,11651
1748,8,0,14,11,43317240,3719,225720,19,11659
1749,8,0,15,10,43340400,3719,225720,19,11667
1750,11,0,17,8,43373640,3719,225720,19,11678
1751,2,0,9,16,43409760,3719,225720,19,11680
1752,5,0,10,15,43418700,3718,225720,19,11685
1753,4,0,11,14,43431180,3719,225720,19,11689
1754,12,0,17,8,43445820,3718,225720,19,11701
1755,10,0,18,7,43474260,3717,225720,19,11711
1756,4,0,14,11,43507560,3718,225720,19,11715
1757,6,0,13,12,43541820,3718,225720,19,11721
1758,4,0,10,15,43567800,3718,225720,19,11725
1759,6,0,10,15,43588080,3718,225720,19,11731
1760,7,0,12,13,43599000,3718,225720,19,11738
1761,7,0,12,13,43613760,3717,225720,19,11745
1762,8,0,12,13,43640220,3716,225720,19,11753
1763,9,0,15,10,43652940,3716,225720,19,11762
1764,14,0,16,9,43679460,3714,225720,19,11776
1765,11,0,16,9,43717740,3714,225720,19,11787
1766,13,0,19,6,43744620,3713,225720,19,11800
1767,9,0,12,13,43798500,3712,225720,19,11809
1768,13,0,19,6,43814580,3712,225720,19,11822
1769,11,0,19,6,43854660,3712,225720,19,11833
1770,9,0,18,7,43895700,3712,225720,19,11842
1771,10,0,20,5,43920120,3711,225720,19,11852
1772,7,0,13,12,43978980,3712,225720,19,11859
1773,10,0,17,8,44005140,3712,225720,19,11869
1774,2,0,13,12,44034780,3713,225720,19,11871
1775,4,0,10,15,44074500,3714,225720,19,11875
1776,3,0,11,14,44082540,3714,225720,19,11878
1777,4,0,10,15,44105400,3715,225720,18,11882
1778,2,0,10,15,44106960,3714,225720,18,11884
1779,3,0,10,15,44115000,3714,225720,18,11887
1780,5,0,8,17,44130960,3713,225720,18,11892
1781,5,0,12,13,44131140,3713,225720,18,11897
1782,4,0,12,13,44144820,3713,225720,18,11901
1783,7,0,13,12,44167200,3713,225720,18,11908
1784,8,0,16,9,44183460,3712,225720,18,11916
1785,5,0,15,10,44216880,3713,225720,18,11921
1786,4,0,12,13,44246640,3714,225720,18,11925
1787,5,0,13,12,44261700,3714,225720,18,11930
1788,8,0,17,8,44271420,3713,225720,18,11938
1789,10,0,19,6,44312880,3714,225720,18,11948
1790,11,0,15,10,44361900,3714,225720,18,11959
1791,5,0,13,12,44390160,3714,225720,18,11964
1792,10,0,16,9,44412780,3714,225720,18,11974
1793,6,0,13,12,44448780,3714,225720,18,11980
1794,14,0,19,6,44473440,3713,225720,18,11994
1795,7,0,15,10,44513220,3713,225720,18,12001
1796,7,0,14,11,44545380,3713,225720,18,12008
1797,3,0,12,13,44559960,3713,225720,18,12011
1798,4,0,13,12,44575200,3713,225720,18,12015
1799,2,0,11,14,44600640,3714,225720,18,12017
1800,3,0,12,13,44608860,3714,225720,18,12020
1801,6,0,13,12,44629440,3715,225720,18,12026
1802,2,0,12,13,44647560,3715,225720,18,12028
1803,7,0,13,12,44655960,3714,225720,18,12035
1804,5,0,12,13,44688300,3715,225720,18,12040
1805,8,0,12,13,44712840,3714,225720,18,12048
1806,7,0,10,15,44737800,3714,225720,18,12055
1807,3,0,10,15,44744700,3713,225720,18,12058
1808,5,0,11,14,44768700,3714,225720,18,12063
1809,2,0,10,15,44778060,3714,225720,18,12065
1810,7,0,11,14,44792580,3713,225720,18,12072
1811,15,0,22,3,44801400,3713,225720,18,12087
1812,11,0,20,5,44841960,3712,225720,18,12098
1813,9,0,18,7,44890440,3713,225720,18,12107
1814,10,0,17,8,44934660,3713,225720,18,12117
1815,7,0,15,10,44973540,3714,225720,18,12124
1816,13,0,21,4,44994720,3713,225720,18,12137
1817,8,0,15,10,45049680,3713,225720,18,12145
1818,7,0,15,10,45075960,3713,225720,18,12152
1819,9,0,18,7,45108120,3714,225720,18,12161
1820,6,0,12,13,45157140,3715,225720,18,12167
1821,3,0,11,14,45171300,3715,225720,18,12170
1822,5,0,11,14,45189000,3714,225720,18,12175
1823,3,0,10,15,45215520,3715,225720,18,12178
1824,5,0,12,13,45219900,3715,225720,18,12183
1825,2,0,11,14,45227640,3715,225720,18,12185
1826,3,0,10,15,45256440,3716,225720,18,12188
1827,8,0,14,11,45262740,3715,225720,18,12196
1828,4,0,10,15,45287460,3715,225720,18,12200
1829,6,0,12,13,45303360,3715,225720,18,12206
1830,10,0,17,8,45317880,3714,225720,18,12216
1831,10,0,19,6,45343800,3714,225720,18,12226
1832,6,0,15,10,45379500,3714,225720,18,12232
1833,5,0,10,15,45421680,3714,225720,18,12237
1834,6,0,12,13,45428760,3714,225720,18,12243
1835,7,0,12,13,45456300,3714,225720,18,12250
1836,13,0,15,10,45473640,3712,225720,18,12263
1837,9,0,16,9,45494760,3712,225720,18,12272
1838,8,0,18,7,45521700,3712,225720,18,12280
1839,6,0,10,15,45574500,3712,225720,18,12286
1840,3,0,10,15,45593100,3713,225720,18,12289
1841,11,0,14,11,45606900,3712,225720,18,12300
1842,5,0,14,11,45620880,3711,225720,18,12305
1843,8,0,15,10,45650400,3712,225720,18,12313
1844,9,0,19,6,45668640,3711,225720,18,12322
1845,9,0,14,11,45716640,3711,225720,18,12331
1846,1,0,9,16,45741960,3711,225720,18,12332
1847,3,0,9,16,45753540,3711,225720,18,12335
1848,4,0,9,16,45762000,3711,225720,18,12339
1849,4,0,9,16,45772080,3711,225720,18,12343
1850,3,0,8,17,45784560,3710,225720,18,12346
1851,4,0,8,17,45792660,3710,225720,18,12350
1852,2,0,9,16,45799920,3710,225720,18,12352
1853,5,0,9,16,45809880,3709,225720,18,12357
1854,9,0,14,11,45822900,3709,225720,18,12366
1855,5,0,11,14,45849000,3709,225720,18,12371
1856,13,0,15,10,45871620,3708,225720,18,12384
1857,9,0,17,8,45891420,3708,225720,18,12393
1858,12,0,20,5,45926820,3708,225720,18,12405
1859,7,0,16,9,45965760,3708,225720,18,12412
1860,7,0,15,10,45993000,3707,225720,18,12419
1861,9,0,17,8,46030200,3708,225720,18,12428
1862,5,0,15,10,46062600,3709,225720,18,12433
1863,3,0,12,13,46098480,3710,225720,18,12436
1864,6,0,12,13,46123440,3710,225720,18,12442
1865,6,0,10,15,46153260,3710,225720,18,12448
1866,9,0,15,10,46162500,3710,225720,18,12457
1867,8,0,14,11,46185060,3709,225720,18,12465
1868,7,0,13,12,46207140,3708,225720,18,12472
1869,6,0,13,12,46245120,3709,225720,18,12478
1870,2,0,8,17,46269480,3709,225720,18,12480
1871,9,0,13,12,46277700,3709,225720,18,12489
1872,3,0,13,12,46286760,3709,225720,18,12492
1873,2,0,11,14,46302960,3709,225720,18,12494
1874,6,0,12,13,46325760,3709,225720,18,12500
1875,3,0,9,16,46343760,3709,225720,18,12503
1876,8,0,14,11,46356240,3709,225720,18,12511
1877,6,0,15,10,46368420,3708,225720,18,12517
1878,7,0,12,13,46409460,3709,225720,18,12524
1879,3,0,11,14,46422540,3709,225720,18,12527
1880,6,0,14,11,46435260,3709,225720,18,12533
1881,8,0,17,8,46456080,3709,225720,17,12541
1882,10,0,17,8,46485240,3708,225720,17,12551
1883,5,0,13,12,46523280,3709,225720,17,12556
1884,9,0,18,7,46543020,3709,225720,17,12565
1885,15,0,20,5,46593540,3709,225720,17,12580
1886,8,0,18,7,46622100,3708,225720,17,12588
1887,14,1,20,5,46666500,3709,226800,17,12602
1888,11,1,22,3,46701180,3709,232740,18,12613
1889,5,0,20,5,46735740,3709,234480,18,12618
1890,9,0,18,7,46806300,3712,234960,18,12627
1891,7,0,16,9,46843920,3712,234960,18,12634
1892,5,0,9,16,46890360,3712,234960,18,12639
1893,8,0,16,9,46891080,3712,234960,18,12647
1894,6,0,13,12,46923240,3712,234960,18,12653
1895,6,0,14,11,46936020,3711,234960,18,12659
1896,5,0,8,17,46980600,3712,234960,18,12664
1897,4,0,11,14,46981320,3711,234960,18,12668
1898,1,0,9,16,46988280,3711,234960,18,12669
1899,5,0,11,14,47006760,3712,234960,18,12674
1900,3,0,11,14,47012280,3711,234960,18,12677
1901,4,0,12,13,47026500,3711,234960,18,12681
1902,4,0,12,13,47048220,3712,234960,18,12685
1903,4,0,10,15,47070180,3712,234960,18,12689
1904,9,0,14,11,47078460,3711,234960,18,12698
1905,16,0,24,1,47098740,3711,236040,18,12714
1906,8,0,20,5,47152500,3712,236040,18,12722
1907,10,0,20,5,47204040,3713,236880,18,12732
1908,7,0,14,11,47251680,3713,236880,18,12739
1909,11,0,19,6,47284620,3714,236880,18,12750
1910,10,0,21,4,47325720,3715,237180,18,12760
1911,5,0,13,12,47380680,3715,237180,18,12765
1912,8,0,16,9,47402760,3715,237180,18,12773
1913,6,0,15,10,47443560,3716,237180,18,12779
1914,8,0,14,11,47467620,3716,237180,18,12787
1915,9,0,14,11,47497260,3715,237180,18,12796
1916,5,0,17,8,47511360,3716,237180,18,12801
1917,8,0,15,10,47549880,3716,237180,18,12809
1918,3,0,11,14,47593980,3717,237180,18,12812
1919,7,0,15,10,47603880,3717,237180,18,12819
1920,2,0,12,13,47623740,3717,237180,18,12821
1921,9,0,16,9,47651820,3718,237180,18,12830
1922,7,0,17,8,47674800,3718,237180,18,12837
1923,5,0,12,13,47707920,3718,237180,18,12842
1924,8,0,12,13,47729460,3717,237180,18,12850
1925,4,0,13,12,47742780,3717,237180,18,12854
1926,6,0,13,12,47771340,3718,237180,18,12860
1927,5,0,14,11,47777940,3717,237180,18,12865
1928,15,0,19,6,47814780,3717,237180,18,12880
1929,5,0,13,12,47855580,3717,237180,18,12885
1930,7,0,12,13,47881320,3717,237180,18,12892
1931,8,0,14,11,47898480,3717,237180,18,12900
1932,10,0,18,7,47924160,3717,237180,18,12910
1933,9,0,17,8,47949180,3716,237180,18,12919
1934,4,0,13,12,47979600,3716,237180,18,12923
1935,6,0,12,13,48017280,3717,237180,18,12929
1936,6,0,16,9,48018540,3716,237180,18,12935
1937,6,0,12,13,48059880,3717,237180,18,12941
1938,7,0,13,12,48079740,3717,237180,18,12948
1939,7,0,11,14,48097920,3715,237180,18,12955
1940,6,0,17,8,48097920,3715,237180,18,12961
1941,4,0,15,10,48119640,3715,237180,18,12965
1942,3,0,16,9,48138120,3716,237180,18,12968
1943,7,0,13,12,48187140,3717,237180,18,12975
1944,6,0,12,13,48205320,3716,237180,18,12981
1945,5,0,12,13,48213000,3716,237180,18,12986
1946,6,0,10,15,48248760,3716,237180,18,12992
1947,5,0,12,13,48252900,3716,237180,18,12997
1948,6,0,12,13,48276600,3716,237180,18,13003
1949,4,0,11,14,48296880,3716,237180,18,13007
1950,6,0,14,11,48311040,3716,237180,18,13013
1951,8,0,17,8,48334920,3716,237180,18,13021
1952,8,0,16,9,48365460,3716,237180,18,13029
1953,8,0,15,10,48397140,3716,237180,18,13037
1954,12,0,19,6,48425280,3716,237180,18,13049
1955,8,0,17,8,48459360,3716,237180,18,13057
1956,11,0,18,7,48492540,3715,237180,18,13068
1957,15,0,20,5,48536040,3715,237180,18,13083
1958,6,0,19,6,48560460,3715,237180,18,13089
1959,12,0,16,9,48629040,3716,237180,18,13101
1960,7,0,12,13,48657840,3715,237180,18,13108
1961,6,0,13,12,48673080,3715,237180,18,13114
1962,5,0,12,13,48696900,3715,237180,18,13119
1963,4,0,12,13,48714000,3715,237180,18,13123
1964,7,0,12,13,48737520,3715,237180,18,13130
1965,5,0,11,14,48759600,3715,237180,18,13135
1966,9,0,15,10,48770760,3714,237180,18,13144
1967,3,0,12,13,48790920,3714,237180,18,13147
1968,2,0,12,13,48799740,3714,237180,18,13149
1969,5,0,14,11,48822000,3715,237180,18,13154
1970,2,0,10,15,48854640,3716,237180,18,13156
1971,10,0,15,10,48871260,3716,237180,18,13166
1972,1,0,9,16,48900960,3716,237180,18,13167
1973,6,0,11,14,48914280,3716,237180,18,13173
1974,4,0,10,15,48926220,3715,237180,17,13177
1975,3,0,9,16,48940140,3715,237180,17,13180
1976,4,0,10,15,48944040,3715,237180,17,13184
1977,6,0,13,12,48955740,3715,237180,17,13190
1978,9,0,17,8,48962760,3714,237180,17,13199
1979,5,0,11,14,48990900,3713,237180,17,13204
1980,9,0,16,9,49008000,3713,237180,17,13213
1981,15,0,19,6,49043700,3712,237180,17,13228
1982,14,0,22,3,49079820,3712,237180,17,13242
1983,7,0,19,6,49120860,3712,237180,17,13249
1984,4,0,13,12,49163280,3713,237180,17,13253
1985,8,0,14,11,49197060,3713,237180,17,13261
1986,3,0,11,14,49221360,3713,237180,17,13264
1987,7,0,12,13,49243680,3713,237180,17,13271
1988,5,0,12,13,49261980,3713,237180,17,13276
1989,3,0,11,14,49271580,3713,237180,17,13279
1990,6,0,13,12,49292460,3714,237180,17,13285
1991,4,0,14,11,49304280,3714,237180,17,13289
1992,7,0,16,9,49318620,3713,237180,17,13296
1993,4,0,11,14,49360260,3714,237180,17,13300
1994,7,0,11,14,49385940,3714,237180,17,13307
1995,7,0,13,12,49394220,3713,237180,17,13314
1996,3,0,12,13,49417800,3714,237180,17,13317
1997,9,0,15,10,49437480,3714,237180,17,13326
1998,4,0,13,12,49470840,3714,237180,17,13330
1999,10,0,16,9,49501320,3715,237180,17,13340
2000,5,0,13,12,49518960,3714,237180,17,13345
2001,10,0,14,11,49555860,3714,237180,17,13355
2002,5,0,12,13,49577820,3714,237180,17,13360
2003,5,0,10,15,49600080,3713,237180,17,13365
2004,8,0,15,10,49615020,3714,237180,17,13373
2005,13,0,19,6,49639800,3713,237180,17,13386
2006,8,0,16,9,49673340,3713,237180,17,13394
2007,10,0,18,7,49706820,3713,237180,17,13404
2008,12,0,19,6,49748160,3713,237180,17,13416
2009,10,0,19,6,49773000,3712,237180,17,13426
2010,10,0,19,6,49818420,3713,237180,17,13436
2011,5,0,14,11,49878660,3714,237180,17,13441
2012,8,0,16,9,49902120,3714,237180,17,13449
2013,3,0,12,13,49924380,3714,237180,17,13452
2014,6,0,12,13,49942920,3714,237180,17,13458
2015,4,0,10,15,49963260,3714,237180,17,13462
2016,8,0,13,12,49972320,3713,237180,17,13470
2017,3,0,14,11,49976580,3713,237180,17,13473
2018,5,0,16,9,49982340,3712,237180,17,13478
2019,3,0,15,10,49995540,3712,237180,17,13481
2020,4,0,17,8,49997040,3712,237180,17,13485
2021,8,0,17,8,50023440,3712,237180,17,13493
2022,7,0,19,6,50044920,3712,237180,17,13500
2023,6,0,19,6,50063700,3711,237180,17,13506
2024,3,0,14,11,50099520,3712,237180,17,13509
2025,4,0,15,10,50109120,3712,237180,17,13513
2026,9,0,19,6,50120160,3711,237180,17,13522
2027,6,0,18,7,50141220,3711,237180,17,13528
2028,5,0,19,6,50157180,3711,237180,17,13533
2029,7,0,19,6,50175000,3710,237180,17,13540
2030,5,0,15,10,50214180,3711,237180,17,13545
2031,11,0,19,6,50229900,3710,237180,17,13556
2032,10,0,21,4,50247180,3709,237180,17,13566
2033,5,0,16,9,50291460,3710,237180,17,13571
2034,9,0,19,6,50304060,3709,237180,17,13580
2035,8,0,21,4,50318760,3708,237180,17,13588
2036,7,0,19,6,50352120,3708,237180,17,13595
2037,6,0,19,6,50369040,3708,237180,17,13601
2038,6,0,19,6,50400720,3709,237180,17,13607
2039,6,0,19,6,50427480,3709,237180,17,13613
2040,7,0,20,5,50439900,3708,237180,17,13620
2041,5,0,18,7,50468940,3709,237180,17,13625
2042,4,0,17,8,50486820,3708,237180,17,13629
2043,5,0,18,7,50513940,3709,237180,17,13634
2044,5,0,17,8,50529480,3709,237180,17,13639
2045,5,0,17,8,50541360,3708,237180,17,13644
2046,3,0,13,12,50573940,3709,237180,17,13647
2047,10,0,20,5,50580120,3709,237180,17,13657
2048,8,0,20,5,50599920,3708,237180,17,13665
2049,16,0,25,0,50636280,3707,237180,17,13681
2050,2,0,18,7,50667480,3707,237180,17,13683
2051,6,0,18,7,50697060,3708,237180,17,13689
2052,13,0,21,4,50722320,3707,237180,17,13702
2053,4,0,19,6,50732340,3706,237180,17,13706
2054,7,0,21,4,50758920,3707,237180,17,13713
2055,6,0,23,2,50776860,3707,238200,17,13719
2056,6,0,16,9,50819280,3707,238200,17,13725
2057,7,0,18,7,50846700,3707,238200,17,13732
2058,5,0,18,7,50859300,3707,238200,17,13737
2059,4,0,16,9,50889840,3707,238200,17,13741
2060,5,0,18,7,50894580,3707,238200,17,13746
2061,6,0,20,5,50910840,3707,238200,17,13752
2062,7,0,19,6,50939880,3707,238200,17,13759
2063,7,0,15,10,50969040,3706,238200,17,13766
2064,5,0,17,8,50974680,3706,238200,17,13771
2065,4,0,15,10,50996880,3706,238200,17,13775
2066,4,0,15,10,51007500,3705,238200,17,13779
2067,3,0,18,7,51007500,3705,238200,17,13782
2068,5,0,17,8,51036180,3706,238200,17,13787
2069,3,0,15,10,51047820,3705,238200,17,13790
2070,4,0,15,10,51059640,3705,238200,17,13794
2071,5,0,19,6,51060300,3705,238200,17,13799
2072,13,1,25,0,51084300,3705,238740,17,13812
2073,10,4,25,0,51112920,3705,243420,17,13822
2074,6,0,20,5,51169620,3705,254820,18,13828
2075,10,0,23,2,51203880,3706,254820,18,13838
2076,13,0,24,1,51250020,3706,255660,18,13851
2077,11,0,20,5,51301920,3706,255780,18,13862
2078,6,0,21,4,51319680,3706,255780,18,13868
2079,8,0,18,7,51362400,3706,255780,18,13876
2080,11,0,18,7,51387060,3705,255780,18,13887
2081,7,0,19,6,51410160,3705,255780,18,13894
2082,9,0,23,2,51427320,3705,255780,18,13903
2083,6,0,21,4,51454140,3704,255780,18,13909
2084,7,0,18,7,51487800,3704,255780,18,13916
2085,3,0,16,9,51518100,3705,255780,18,13919
2086,3,0,15,10,51535980,3705,255780,18,13922
2087,9,0,19,6,51546780,3705,255780,18,13931
2088,4,0,18,7,51570720,3705,255780,18,13935
2089,4,0,16,9,51596760,3705,255780,18,13939
2090,5,0,16,9,51613620,3705,255780,18,13944
2091,5,0,16,9,51621240,3704,255780,18,13949
2092,3,0,16,9,51635700,3705,255780,18,13952
2093,1,0,13,12,51654480,3705,255780,18,13953
2094,6,0,17,8,51661680,3705,255780,18,13959
2095,6,0,17,8,51667200,3704,255780,18,13965
2096,8,0,19,6,51696660,3704,255780,18,13973
2097,11,0,23,2,51718260,3704,255780,18,13984
2098,8,1,25,0,51734400,3704,255960,18,13992
2099,13,0,24,1,51791640,3704,257580,18,14005
2100,6,0,21,4,51831900,3704,257580,18,14011
2101,6,0,22,3,51854280,3705,257580,18,14017
2102,9,0,21,4,51902220,3705,257580,18,14026
2103,5,0,19,6,51935700,3706,257580,18,14031
2104,9,0,21,4,51959460,3706,257880,18,14040
2105,10,0,25,0,51980640,3706,257940,18,14050
2106,3,0,20,5,52023600,3707,257940,18,14053
2107,4,0,17,8,52064700,3708,257940,18,14057
2108,10,0,20,5,52081740,3707,257940,18,14067
2109,5,0,18,7,52107540,3707,257940,18,14072
2110,7,0,18,7,52139400,3708,257940,18,14079
2111,4,0,16,9,52160580,3708,257940,18,14083
2112,6,0,17,8,52175700,3707,257940,18,14089
2113,3,0,14,11,52198140,3707,257940,18,14092
2114,2,0,14,11,52203360,3707,257940,18,14094
2115,6,0,19,6,52204200,3707,257940,18,14100
2116,5,0,15,10,52224480,3706,257940,18,14105
2117,3,0,15,10,52239960,3706,257940,18,14108
2118,8,0,21,4,52245900,3706,257940,18,14116
2119,8,0,19,6,52273200,3706,257940,18,14124
2120,5,0,16,9,52301220,3705,257940,18,14129
2121,3,0,14,11,52320960,3705,257940,18,14132
2122,9,0,19,6,52327260,3705,257940,18,14141
2123,15,1,25,0,52351680,3705,258900,18,14156
2124,14,0,25,0,52384980,3703,261480,18,14170
2125,11,0,25,0,52435680,3704,263160,18,14181
2126,6,0,20,5,52473840,3703,263160,18,14187
2127,9,0,21,4,52515600,3704,263580,18,14196
2128,9,3,20,5,52537620,3704,263640,18,14205
2129,4,0,22,3,52564620,3705,272580,19,14209
2130,6,0,21,4,52587000,3704,272580,19,14215
2131,9,0,17,8,52649580,3705,272700,19,14224
2132,4,0,19,6,52659300,3706,272700,19,14228
2133,7,0,17,8,52694520,3706,272700,19,14235
2134,5,0,19,6,52704720,3706,272700,19,14240
2135,5,0,21,4,52720080,3706,272700,19,14245
2136,5,0,18,7,52764360,3707,272700,19,14250
2137,8,0,24,1,52776120,3707,273300,19,14258
2138,5,0,20,5,52819140,3708,273300,19,14263
2139,6,0,20,5,52835760,3708,273300,19,14269
2140,7,0,19,6,52875960,3708,273300,19,14276
2141,2,0,15,10,52891860,3708,273300,19,14278
2142,3,0,14,11,52903140,3708,273300,19,14281
2143,9,0,17,8,52919580,3707,273300,19,14290
2144,8,0,20,5,52930560,3707,273300,19,14298
2145,10,1,23,2,52947480,3706,273540,19,14308
2146,9,1,25,0,52988580,3707,280440,19,14317
2147,7,0,19,6,53035260,3707,281220,19,14324
2148,12,0,22,3,53058420,3706,281220,19,14336
2149,13,1,23,2,53089860,3706,282360,19,14349
2150,11,1,25,0,53128380,3706,283200,19,14360
2151,8,0,22,3,53174940,3706,285240,19,14368
2152,10,0,19,6,53220600,3706,285240,19,14378
2153,8,0,19,6,53244180,3706,285240,19,14386
2154,7,0,18,7,53272140,3705,285240,19,14393
2155,8,0,20,5,53289120,3705,285240,19,14401
2156,6,0,20,5,53318940,3706,285240,19,14407
2157,5,0,21,4,53336340,3706,285240,19,14412
2158,7,0,18,7,53373060,3706,285240,19,14419
2159,3,0,15,10,53394120,3706,285240,19,14422
2160,4,0,15,10,53409360,3706,285240,19,14426
2161,4,0,14,11,53424480,3705,285240,19,14430
2162,4,0,15,10,53432640,3705,285240,19,14434
2163,3,0,13,12,53448120,3705,285240,19,14437
2164,7,0,16,9,53452860,3704,285240,19,14444
2165,6,0,16,9,53463540,3704,285240,19,14450
2166,5,0,19,6,53476320,3704,285240,19,14455
2167,10,0,21,4,53499120,3703,285240,19,14465
2168,6,0,21,4,53525700,3704,285240,19,14471
2169,4,0,19,6,53556660,3704,285240,19,14475
2170,12,0,22,3,53586240,3704,285240,19,14487
2171,9,0,22,3,53621820,3704,285240,19,14496
2172,10,2,25,0,53641560,3704,285720,19,14506
2173,14,5,21,4,53706660,3705,288720,19,14520
2174,18,18,20,5,53735820,3705,290880,20,14538
2175,7,22,17,8,53778420,3707,296280,20,14545
2176,12,23,25,0,53793600,3707,321360,22,14557
2177,10,26,24,1,53823780,3707,345120,23,14567
2178,10,24,25,0,53875560,3708,386400,26,14577
2179,7,13,25,0,53933820,3707,529140,36,14584
2180,4,0,18,7,53974320,3704,738120,50,14588
2181,4,0,16,9,54004140,3705,738120,50,14592
2182,3,0,16,9,54020700,3705,738120,50,14595
2183,6,0,16,9,54039060,3705,738120,50,14601
2184,7,0,19,6,54055920,3705,738120,50,14608
2185,7,0,18,7,54068400,3704,738120,50,14615
2186,2,0,14,11,54099900,3704,738120,50,14617
2187,6,0,15,10,54116280,3704,738120,50,14623
2188,3,0,17,8,54119520,3704,738120,50,14626
2189,5,0,16,9,54145800,3704,738120,50,14631
2190,7,0,19,6,54160800,3704,738120,50,14638
2191,5,0,19,6,54172320,3704,738120,50,14643
2192,7,0,21,4,54190860,3704,738120,50,14650
2193,9,0,21,4,54233580,3704,738120,50,14659
2194,12,0,23,2,54263580,3704,738120,50,14671
2195,11,0,23,2,54295140,3703,738120,50,14682
2196,11,4,21,4,54331800,3704,740460,50,14693
2197,7,0,22,3,54367200,3703,751980,51,14700
2198,10,0,21,4,54410820,3704,751980,51,14710
2199,7,0,20,5,54432420,3703,751980,51,14717
2200,9,0,20,5,54470160,3703,751980,51,14726
2201,5,0,18,7,54492060,3703,751980,51,14731
2202,7,0,20,5,54512460,3703,751980,51,14738
2203,7,0,20,5,54537720,3703,751980,50,14745
2204,6,0,19,6,54564000,3703,751980,50,14751
2205,3,0,14,11,54597180,3704,751980,50,14754
2206,6,0,18,7,54605040,3704,751980,50,14760
2207,6,0,19,6,54617580,3703,751980,50,14766
2208,7,0,18,7,54637380,3702,751980,50,14773
2209,8,0,20,5,54664680,3703,751980,50,14781
2210,3,0,13,12,54690840,3702,751980,50,14784
2211,6,0,16,9,54700260,3702,751980,50,14790
2212,4,0,18,7,54704820,3702,751980,50,14794
2213,6,0,19,6,54720600,3702,751980,50,14800
2214,6,0,18,7,54751320,3702,751980,50,14806
2215,6,0,18,7,54769380,3702,751980,50,14812
2216,14,2,25,0,54783300,3701,751980,50,14826
2217,4,0,20,5,54818160,3701,753000,50,14830
2218,3,0,15,10,54865200,3702,753000,50,14833
2219,14,0,22,3,54877080,3701,753000,50,14847
2220,8,0,21,4,54902280,3701,753000,50,14855
2221,8,0,20,5,54927780,3700,753000,50,14863
2222,6,0,19,6,54968280,3701,753000,50,14869
2223,12,0,23,2,54994500,3701,753000,50,14881
2224,6,0,22,3,55018380,3701,753000,50,14887
2225,5,0,17,8,55068540,3702,753000,50,14892
2226,3,0,16,9,55081560,3701,753000,50,14895
2227,5,0,16,9,55103160,3702,753000,50,14900
2228,6,0,17,8,55117020,3701,753000,50,14906
2229,8,0,23,2,55129380,3702,753000,50,14914
2230,6,0,20,5,55158720,3701,753000,50,14920
2231,5,0,19,6,55186800,3702,753000,50,14925
2232,3,0,13,12,55219740,3702,753000,50,14928
2233,3,0,14,11,55225620,3702,753000,50,14931
2234,2,0,15,10,55228260,3702,753000,50,14933
2235,6,0,16,9,55238760,3701,753000,50,14939
2236,7,0,17,8,55258380,3701,753000,50,14946
2237,5,0,16,9,55276860,3701,753000,50,14951
2238,6,0,19,6,55289400,3701,753000,50,14957
2239,7,0,19,6,55317300,3701,753000,50,14964
2240,8,0,22,3,55338540,3701,753000,50,14972
2241,5,0,18,7,55368960,3701,753000,50,14977
2242,12,1,24,1,55396680,3701,753240,50,14989
2243,4,0,23,2,55419720,3702,755640,50,14993
2244,13,0,22,3,55477560,3702,755640,50,15006
2245,6,0,18,7,55510320,3702,755640,50,15012
2246,3,0,17,8,55526520,3702,755640,50,15015
2247,2,0,13,12,55553940,3702,755640,50,15017
2248,8,0,16,9,55559160,3701,755640,50,15025
2249,11,0,24,1,55570620,3701,755640,50,15036
2250,15,12,21,4,55591560,3701,756180,50,15051
2251,9,15,19,6,55639260,3702,770580,51,15060
2252,5,12,23,2,55659300,3703,793140,52,15065
2253,9,4,25,0,55709700,3702,882300,58,15074
2254,3,0,17,8,55746660,3701,908820,60,15077
2255,3,0,14,11,55777500,3702,908820,60,15080
2256,6,0,16,9,55788960,3701,908820,60,15086
2257,5,0,16,9,55803180,3701,908820,60,15091
2258,3,0,16,9,55813860,3701,908820,60,15094
2259,2,0,14,11,55832580,3701,908820,60,15096
2260,8,0,17,8,55840200,3701,908820,60,15104
2261,8,0,22,3,55844760,3700,908820,60,15112
2262,8,0,21,4,55882020,3701,908820,60,15120
2263,6,0,20,5,55905480,3700,908820,60,15126
2264,12,0,23,2,55947540,3701,915300,60,15138
2265,6,0,22,3,55963500,3700,915300,60,15144
2266,8,0,20,5,56012040,3701,915300,60,15152
2267,20,4,25,0,56043360,3700,916080,60,15172
2268,9,6,25,0,56076840,3701,926820,61,15181
2269,13,11,25,0,56124960,3702,937080,61,15194
2270,11,11,25,0,56176200,3703,960420,63,15205
2271,10,5,25,0,56232600,3703,1009500,66,15215
2272,14,0,24,1,56272380,3700,1050600,68,15229
2273,8,6,20,5,56290560,3700,1050900,68,15237
2274,9,9,22,3,56318700,3701,1068180,70,15246
2275,6,0,21,4,56383680,3701,1118220,73,15252
2276,7,0,15,10,56416620,3700,1118220,73,15259
2277,3,0,16,9,56424120,3700,1118220,73,15262
2278,12,0,18,7,56452440,3700,1118220,73,15274
2279,2,0,16,9,56466660,3700,1118220,73,15276
2280,4,0,14,11,56487480,3700,1118220,73,15280
2281,9,0,17,8,56503440,3699,1118220,73,15289
2282,6,0,17,8,56517660,3699,1118220,73,15295
2283,4,0,16,9,56532660,3699,1118220,73,15299
2284,5,0,17,8,56546100,3698,1118220,73,15304
2285,7,0,19,6,56561220,3698,1118220,73,15311
2286,4,0,18,7,56577540,3698,1118220,73,15315
2287,6,0,19,6,56597820,3698,1118220,72,15321
2288,7,0,18,7,56623380,3698,1118220,72,15328
2289,3,0,15,10,56647320,3698,1118220,72,15331
2290,5,0,16,9,56664300,3698,1118220,72,15336
2291,14,0,24,1,56669820,3697,1118460,72,15350
2292,12,0,23,2,56709360,3697,1118820,72,15362
2293,2,0,15,10,56757840,3697,1118820,72,15364
2294,12,0,20,5,56770980,3696,1118820,72,15376
2295,9,0,24,1,56786220,3696,1118820,72,15385
2296,8,0,21,4,56828640,3696,1119600,72,15393
2297,3,0,17,8,56859600,3697,1121100,72,15396
2298,10,0,23,2,56871960,3697,1121100,72,15406
2299,10,0,21,4,56914440,3696,1121100,72,15416
2300,6,0,17,8,56959800,3697,1121100,72,15422
2301,6,0,21,4,56972220,3697,1121100,72,15428
2302,9,0,23,2,57006120,3698,1121100,72,15437
2303,6,0,19,6,57041700,3698,1121100,72,15443
2304,3,0,17,8,57064620,3698,1121100,72,15446
2305,3,0,16,9,57094140,3699,1121100,72,15449
2306,6,0,17,8,57104940,3698,1121100,72,15455
2307,5,0,18,7,57120000,3699,1121100,72,15460
2308,2,0,16,9,57132780,3698,1121100,72,15462
2309,3,0,16,9,57158340,3699,1121100,72,15465
2310,11,0,18,7,57178920,3698,1121100,72,15476
2311,8,0,18,7,57200340,3698,1121100,72,15484
2312,5,0,19,6,57217500,3698,1121100,72,15489
2313,11,0,22,3,57250380,3698,1121100,72,15500
2314,6,0,18,7,57283740,3698,1121100,72,15506
2315,9,0,18,7,57309660,3698,1121100,72,15515
2316,8,0,20,5,57332700,3698,1121100,72,15523
2317,10,0,23,2,57348900,3697,1121100,72,15533
2318,9,0,19,6,57405480,3698,1121100,72,15542
2319,5,0,16,9,57428400,3697,1121100,72,15547
2320,9,0,22,3,57441900,3697,1121100,72,15556
2321,6,0,21,4,57462480,3697,1121100,72,15562
2322,3,0,16,9,57498480,3697,1121100,72,15565
2323,5,0,19,6,57510240,3698,1121100,72,15570
2324,7,0,19,6,57534180,3698,1121100,71,15577
2325,10,0,23,2,57550860,3697,1122000,71,15587
2326,5,0,18,7,57596880,3698,1122000,71,15592
2327,7,0,20,5,57625080,3698,1122000,71,15599
2328,4,0,18,7,57644280,3698,1122000,71,15603
2329,3,0,14,11,57672240,3698,1122000,71,15606
2330,6,0,17,8,57685860,3698,1122000,71,15612
2331,7,0,19,6,57702720,3698,1122000,71,15619
2332,7,0,19,6,57721860,3698,1122000,71,15626
2333,5,0,19,6,57737340,3698,1122000,71,15631
2334,10,0,19,6,57778620,3698,1122120,71,15641
2335,5,0,17,8,57799920,3698,1122120,71,15646
2336,5,0,17,8,57824460,3698,1122120,71,15651
2337,6,0,18,7,57844020,3698,1122120,71,15657
2338,7,0,17,8,57855000,3697,1122120,71,15664
2339,6,0,18,7,57876600,3697,1122120,71,15670
2340,9,0,22,3,57896700,3697,1122120,71,15679
2341,9,2,20,5,57929100,3697,1123200,71,15688
2342,7,4,20,5,57954720,3698,1129380,71,15695
2343,5,0,25,0,57974760,3698,1146660,73,15700
2344,9,0,20,5,58027080,3698,1146660,72,15709
2345,3,0,16,9,58050600,3698,1146660,72,15712
2346,8,0,16,9,58081920,3698,1146660,72,15720
2347,4,0,17,8,58091040,3698,1146660,72,15724
2348,4,0,16,9,58115940,3698,1146660,72,15728
2349,7,0,18,7,58127280,3698,1146660,72,15735
2350,4,0,16,9,58153140,3698,1146660,72,15739
2351,3,0,16,9,58166220,3698,1146660,72,15742
2352,8,0,20,5,58171980,3698,1146660,72,15750
2353,5,0,15,10,58210140,3698,1146660,72,15755
2354,0,0,12,13,58235640,3699,1146660,72,15755
2355,1,0,13,12,58235640,3699,1146660,72,15756
2356,7,0,18,7,58237440,3698,1146660,72,15763
2357,5,0,17,8,58247700,3698,1146660,72,15768
2358,9,0,23,2,58258140,3697,1146660,72,15777
2359,6,0,20,5,58299720,3698,1147260,72,15783
2360,10,0,21,4,58350420,3699,1147260,72,15793
2361,10,0,21,4,58384500,3699,1147260,72,15803
2362,8,0,17,8,58423140,3699,1147260,72,15811
2363,6,0,18,7,58447860,3699,1147260,72,15817
2364,10,0,19,6,58467720,3698,1147260,72,15827
2365,8,0,21,4,58481940,3698,1147260,72,15835
2366,9,0,16,9,58528020,3697,1147260,72,15844
2367,4,0,16,9,58552680,3698,1147260,72,15848
2368,11,0,24,1,58560000,3698,1147260,72,15859
2369,5,0,17,8,58600140,3697,1147260,72,15864
2370,6,0,18,7,58622940,3698,1147260,72,15870
2371,7,0,18,7,58640880,3697,1147260,72,15877
2372,4,0,17,8,58666980,3698,1147260,72,15881
2373,3,1,18,7,58668480,3697,1147260,72,15884
2374,4,0,18,7,58703460,3699,1149120,72,15888
2375,4,0,16,9,58719540,3698,1149120,72,15892
2376,2,0,14,11,58743060,3699,1149120,72,15894
2377,8,0,17,8,58756680,3698,1149120,72,15902
2378,4,0,15,10,58769400,3698,1149120,72,15906
2379,4,0,14,11,58790700,3698,1149120,72,15910
2380,6,0,19,6,58791660,3698,1149120,72,15916
2381,8,0,19,6,58818360,3698,1150440,72,15924
2382,3,0,15,10,58850760,3698,1150440,72,15927
2383,8,0,17,8,58867080,3698,1150440,72,15935
2384,5,0,17,8,58884300,3698,1150440,72,15940
2385,8,0,19,6,58902180,3697,1150440,72,15948
2386,4,0,17,8,58924020,3697,1150440,72,15952
2387,8,0,19,6,58950240,3698,1150440,72,15960
2388,6,0,19,6,58972740,3698,1150440,72,15966
2389,14,0,22,3,59006820,3697,1150560,72,15980
2390,7,0,20,5,59031840,3697,1150560,71,15987
2391,10,0,19,6,59068800,3696,1150560,71,15997
2392,15,0,24,1,59095680,3696,1150560,71,16012
2393,6,0,20,5,59134500,3696,1150560,71,16018
2394,13,1,25,0,59150640,3695,1151820,71,16031
2395,7,0,18,7,59225700,3696,1152180,71,16038
2396,7,0,22,3,59230020,3696,1152180,71,16045
2397,5,0,18,7,59275140,3697,1152180,71,16050
2398,4,0,17,8,59292720,3697,1152180,71,16054
2399,7,0,18,7,59314500,3697,1152180,71,16061
2400,6,0,21,4,59327940,3697,1152180,71,16067
2401,8,3,21,4,59358540,3698,1154700,71,16075
2402,2,3,19,6,59380680,3698,1155240,71,16077
2403,7,0,23,2,59404260,3698,1177860,73,16084
2404,11,0,23,2,59451540,3699,1177980,73,16095
2405,7,2,21,4,59483700,3699,1181520,73,16102
2406,3,0,19,6,59520000,3700,1187280,73,16105
2407,9,0,20,5,59555040,3700,1187280,73,16114
2408,6,0,18,7,59586720,3700,1187280,73,16120
2409,9,0,23,2,59593920,3700,1187280,73,16129
2410,4,0,19,6,59637720,3700,1187280,73,16133
2411,10,0,20,5,59665440,3700,1187280,73,16143
2412,7,0,17,8,59706120,3700,1187280,73,16150
2413,9,0,22,3,59714340,3700,1187280,73,16159
2414,10,0,22,3,59753520,3700,1187280,73,16169
2415,3,0,17,8,59783040,3700,1187280,73,16172
2416,9,0,21,4,59804580,3700,1187280,73,16181
2417,3,0,18,7,59833560,3701,1187280,73,16184
2418,6,0,18,7,59854440,3701,1187280,73,16190
2419,6,0,17,8,59868360,3700,1187280,73,16196
2420,10,0,21,4,59887320,3700,1187280,73,16206
2421,4,2,19,6,59903400,3700,1190400,73,16210
2422,6,0,21,4,59930940,3700,1197060,73,16216
2423,4,0,17,8,59959980,3700,1197060,73,16220
2424,3,0,16,9,59986920,3701,1197060,73,16223
2425,4,0,15,10,60002280,3701,1197060,73,16227
2426,5,0,15,10,60017760,3700,1197060,73,16232
2427,7,0,20,5,60025200,3700,1197060,73,16239
2428,6,0,18,7,60050940,3700,1197060,73,16245
2429,2,0,16,9,60076020,3701,1197060,73,16247
2430,4,0,17,8,60090660,3701,1197060,73,16251
2431,11,0,22,3,60109260,3701,1197060,73,16262
2432,1,0,16,9,60135540,3701,1197060,73,16263
2433,6,0,17,8,60162600,3701,1197060,73,16269
2434,11,0,23,2,60170040,3701,1197060,73,16280
2435,9,0,19,6,60207000,3700,1197180,73,16289
2436,5,0,20,5,60230520,3701,1197180,73,16294
2437,10,0,22,3,60264000,3701,1197180,73,16304
2438,9,0,24,1,60292380,3701,1197180,73,16313
2439,8,3,25,0,60308760,3701,1199160,73,16321
2440,12,0,22,3,60395700,3702,1205700,73,16333
2441,5,0,19,6,60421860,3702,1205700,73,16338
2442,3,0,14,11,60448920,3702,1205700,73,16341
2443,11,0,17,8,60464400,3701,1205700,73,16352
2444,6,0,18,7,60474360,3701,1205700,73,16358
2445,7,0,19,6,60492000,3700,1205700,73,16365
2446,7,0,20,5,60515100,3700,1205700,73,16372
2447,3,0,16,9,60553320,3701,1205700,73,16375
2448,3,0,17,8,60571380,3702,1205700,73,16378
2449,6,0,19,6,60591780,3702,1205700,73,16384
2450,7,0,18,7,60616260,3702,1205700,73,16391
2451,0,0,15,10,60628260,3702,1205700,73,16391
2452,4,0,16,9,60651900,3703,1205700,73,16395
2453,10,0,21,4,60663540,3702,1205700,73,16405
2454,8,0,20,5,60695220,3702,1205700,73,16413
2455,8,0,19,6,60727140,3702,1205700,73,16421
2456,8,0,17,8,60754260,3701,1205700,73,16429
2457,9,0,19,6,60777060,3701,1205700,73,16438
2458,3,0,15,10,60804000,3701,1205700,73,16441
2459,5,0,18,7,60817320,3702,1205700,73,16446
2460,9,0,19,6,60835740,3701,1205700,73,16455
2461,5,0,21,4,60855300,3701,1205700,73,16460
2462,12,0,22,3,60895860,3701,1205700,73,16472
2463,9,0,23,2,60915900,3701,1205700,73,16481
2464,10,0,21,4,60960000,3701,1205700,73,16491
2465,6,0,21,4,60978240,3701,1205700,73,16497
2466,8,0,21,4,61029480,3702,1205700,73,16505
2467,5,0,17,8,61056900,3701,1205700,73,16510
2468,5,0,19,6,61063860,3701,1205700,73,16515
2469,3,0,15,10,61093500,3701,1205700,72,16518
2470,9,0,21,4,61099860,3701,1205700,72,16527
2471,3,0,19,6,61116900,3701,1205700,72,16530
2472,8,0,17,8,61168920,3702,1205700,72,16538
2473,4,0,15,10,61187400,3702,1205700,72,16542
2474,2,0,14,11,61204260,3702,1205700,72,16544
2475,2,0,14,11,61211520,3702,1205700,72,16546
2476,7,0,17,8,61216920,3702,1205700,72,16553
2477,4,0,18,7,61225560,3701,1205700,72,16557
2478,10,1,20,5,61242960,3701,1205700,72,16567
2479,10,0,22,3,61278060,3701,1207260,72,16577
2480,8,0,22,3,61310040,3701,1207260,72,16585
2481,9,0,20,5,61348080,3701,1207260,72,16594
2482,12,0,22,3,61397340,3702,1207260,72,16606
2483,9,1,25,0,61419840,3702,1208160,72,16615
2484,10,5,21,4,61462320,3702,1210080,72,16625
2485,7,0,21,4,61513680,3703,1220760,73,16632
2486,5,0,18,7,61545120,3703,1220760,73,16637
2487,11,0,20,5,61575900,3703,1220760,73,16648
2488,8,0,21,4,61599660,3703,1220760,73,16656
2489,2,0,14,11,61645620,3703,1220760,73,16658
2490,5,0,17,8,61655880,3703,1220760,73,16663
2491,12,0,24,1,61663080,3703,1220760,73,16675
2492,8,0,20,5,61687920,3702,1220760,73,16683
2493,10,0,23,2,61723020,3702,1220760,73,16693
2494,3,0,15,10,61760400,3702,1220760,73,16696
2495,3,0,15,10,61770960,3702,1220760,73,16699
2496,5,0,19,6,61773360,3702,1220760,73,16704
2497,5,0,19,6,61790760,3702,1220760,73,16709
2498,1,0,15,10,61820400,3702,1220760,73,16710
2499,6,0,19,6,61832100,3703,1220760,73,16716
2500,3,0,16,9,61847340,3702,1220760,73,16719
2501,8,0,21,4,61856520,3702,1220760,72,16727
2502,4,0,18,7,61886700,3702,1220760,72,16731
2503,9,0,17,8,61923120,3702,1220760,72,16740
2504,7,0,16,9,61946820,3702,1220760,72,16747
2505,7,0,17,8,61960500,3702,1220760,72,16754
2506,9,0,21,4,61969740,3701,1220760,72,16763
2507,2,0,16,9,61999380,3701,1220760,72,16765
2508,6,0,19,6,62022360,3702,1220760,72,16771
2509,9,0,19,6,62043000,3701,1220760,72,16780
2510,9,0,21,4,62069100,3701,1220760,72,16789
2511,7,0,20,5,62094960,3701,1220760,72,16796
2512,11,0,22,3,62122620,3701,1220760,72,16807
2513,9,0,22,3,62157480,3701,1221780,72,16816
2514,10,1,25,0,62180760,3701,1223520,72,16826
2515,6,0,23,2,62221680,3701,1225620,72,16832
2516,2,0,16,9,62269080,3702,1225620,72,16834
2517,6,0,17,8,62295720,3703,1225620,72,16840
2518,7,0,20,5,62298420,3702,1225620,72,16847
2519,8,3,20,5,62320260,3702,1225740,72,16855
2520,7,2,23,2,62354820,3703,1237200,73,16862
2521,2,0,16,9,62395440,3703,1242720,73,16864
2522,5,0,17,8,62413080,3703,1242720,73,16869
2523,3,0,16,9,62430480,3703,1242720,73,16872
2524,4,0,16,9,62441700,3703,1242720,73,16876
2525,8,0,16,9,62466120,3703,1242720,73,16884
2526,5,0,18,7,62471100,3702,1242720,73,16889
2527,7,0,19,6,62497800,3703,1242720,73,16896
2528,12,0,21,4,62525100,3702,1242720,73,16908
2529,5,0,19,6,62548560,3702,1242720,73,16913
2530,11,0,23,2,62574480,3702,1242720,73,16924
2531,12,2,25,0,62605980,3702,1242720,73,16936
2532,10,0,24,1,62651400,3702,1247520,73,16946
2533,9,0,20,5,62697300,3702,1247520,73,16955
2534,13,1,25,0,62721720,3702,1247520,73,16968
2535,13,3,25,0,62775300,3702,1256340,73,16981
2536,9,9,20,5,62799120,3702,1263780,74,16990
2537,7,7,22,3,62849820,3704,1269480,74,16997
2538,2,0,21,4,62880540,3703,1318680,77,16999
2539,10,0,19,6,62923080,3703,1318680,77,17009
2540,6,0,18,7,62941140,3703,1318680,77,17015
2541,6,0,18,7,62952000,3702,1318680,77,17021
2542,5,0,16,9,62980020,3702,1318680,77,17026
2543,7,3,18,7,62990160,3702,1321620,77,17033
2544,2,2,19,6,63005820,3703,1331040,78,17035
2545,6,0,19,6,63034620,3703,1334460,78,17041
2546,6,0,19,6,63053940,3702,1334460,78,17047
2547,4,0,17,8,63080760,3703,1334460,78,17051
2548,1,0,12,13,63111120,3703,1334460,78,17052
2549,7,0,17,8,63113160,3703,1334460,78,17059
2550,5,0,17,8,63123780,3702,1334460,78,17064
2551,10,0,22,3,63131580,3702,1334460,78,17074
2552,12,4,23,2,63162120,3702,1338420,78,17086
2553,7,0,25,0,63200700,3702,1352940,79,17093
2554,9,0,20,5,63263160,3703,1353000,79,17102
2555,8,0,22,3,63278280,3703,1353000,79,17110
2556,12,0,23,2,63318840,3703,1354080,79,17122
2557,10,0,23,2,63356520,3703,1354080,79,17132
2558,7,0,19,6,63402480,3703,1354080,79,17139
2559,14,0,22,3,63435300,3702,1354560,78,17153
2560,9,0,24,1,63457020,3702,1354560,78,17162
2561,7,0,19,6,63503100,3702,1355220,78,17169
2562,4,0,19,6,63529620,3703,1356480,78,17173
2563,6,0,21,4,63552900,3703,1356480,78,17179
2564,8,0,23,2,63573660,3703,1356480,78,17187
2565,4,0,17,8,63617160,3704,1356480,78,17191
2566,7,0,19,6,63643620,3704,1356480,78,17198
2567,2,0,12,13,63680880,3704,1356480,78,17200
2568,5,0,16,9,63682800,3704,1356480,78,17205
2569,6,0,20,5,63684780,3704,1356480,78,17211
2570,4,0,18,7,63707940,3704,1356480,78,17215
2571,5,0,16,9,63739140,3704,1356480,78,17220
2572,8,0,21,4,63751140,3704,1356480,78,17228
2573,4,0,18,7,63786480,3705,1356480,78,17232
2574,3,0,17,8,63804120,3705,1356480,78,17235
2575,7,0,19,6,63818760,3705,1356480,78,17242
2576,8,0,16,9,63843900,3704,1356480,78,17250
2577,4,0,18,7,63845400,3704,1356480,78,17254
2578,9,0,17,8,63883920,3704,1356480,78,17263
2579,9,0,23,2,63893820,3704,1356480,78,17272
2580,11,3,24,1,63918180,3704,1358820,78,17283
2581,9,0,22,3,63969000,3704,1361880,78,17292
2582,11,0,23,2,64005480,3704,1361940,78,17303
2583,8,0,20,5,64049580,3704,1361940,78,17311
2584,11,0,19,6,64084200,3703,1361940,78,17322
2585,10,0,18,7,64111860,3702,1361940,78,17332
2586,4,0,19,6,64123920,3702,1361940,78,17336
2587,7,0,18,7,64170240,3703,1361940,78,17343
2588,10,0,22,3,64186680,3703,1361940,78,17353
2589,4,0,18,7,64220580,3703,1361940,78,17357
2590,10,2,22,3,64237740,3703,1362480,78,17367
2591,7,0,20,5,64275900,3703,1365600,78,17374
2592,5,0,19,6,64311060,3704,1365600,78,17379
2593,5,0,15,10,64342020,3704,1365600,78,17384
2594,3,0,13,12,64359240,3704,1365600,78,17387
2595,8,0,17,8,64368120,3704,1365600,78,17395
2596,5,0,18,7,64385700,3704,1365600,78,17400
2597,5,0,18,7,64396860,3703,1365600,78,17405
2598,9,0,19,6,64429260,3703,1365600,78,17414
2599,4,0,17,8,64439820,3703,1365600,78,17418
2600,9,0,22,3,64462260,3703,1365600,78,17427
2601,3,0,16,9,64489920,3703,1365600,78,17430
2602,13,0,24,1,64501800,3702,1367820,78,17443
2603,11,0,19,6,64548780,3702,1371180,78,17454
2604,6,0,19,6,64579440,3702,1371180,78,17460
2605,13,0,24,1,64606440,3702,1371240,78,17473
2606,2,0,18,7,64632600,3702,1371240,78,17475
2607,8,0,21,4,64654800,3702,1371240,78,17483
2608,11,0,24,1,64693860,3703,1372500,78,17494
2609,6,0,23,2,64717980,3703,1375440,78,17500
2610,8,0,22,3,64761840,3703,1377960,78,17508
2611,8,0,20,5,64800660,3703,1377960,78,17516
2612,6,0,20,5,64827900,3704,1377960,78,17522
2613,8,0,14,11,64875300,3703,1377960,78,17530
2614,8,0,19,6,64883940,3703,1377960,78,17538
2615,4,0,19,6,64896360,3703,1377960,78,17542
2616,5,0,17,8,64922880,3703,1377960,78,17547
2617,4,0,16,9,64935540,3703,1377960,78,17551
2618,7,0,17,8,64956600,3703,1377960,78,17558
2619,5,0,18,7,64966500,3702,1377960,78,17563
2620,9,0,22,3,64983900,3702,1377960,78,17572
2621,6,0,19,6,65014860,3702,1377960,78,17578
2622,7,0,18,7,65043060,3702,1377960,78,17585
2623,6,0,18,7,65058720,3702,1377960,78,17591
2624,7,0,21,4,65079900,3702,1377960,78,17598
2625,12,1,25,0,65109660,3702,1381860,78,17610
2626,14,10,20,5,65156160,3703,1388700,78,17624
2627,6,14,21,4,65163240,3703,1390980,78,17630
2628,13,17,25,0,65213160,3705,1418760,80,17643
2629,3,13,25,0,65246760,3705,1446000,81,17646
2630,4,0,16,9,65322900,3704,1577100,89,17650
2631,9,0,19,6,65346360,3704,1577100,89,17659
2632,5,0,17,8,65362320,3703,1577100,89,17664
2633,10,0,23,2,65377920,3703,1577100,89,17674
2634,4,0,18,7,65414520,3704,1577100,89,17678
2635,6,0,15,10,65452920,3704,1577100,89,17684
2636,9,0,21,4,65462400,3704,1577100,89,17693
2637,4,0,19,6,65476200,3703,1577100,89,17697
2638,7,0,19,6,65500200,3703,1577100,89,17704
2639,3,0,15,10,65524320,3703,1577100,89,17707
2640,3,0,14,11,65544060,3703,1577100,89,17710
2641,1,0,12,13,65553720,3703,1577100,89,17711
2642,5,0,16,9,65554500,3703,1577100,89,17716
2643,3,0,18,7,65557440,3703,1577100,89,17719
2644,7,0,18,7,65578500,3703,1577100,88,17726
2645,4,0,18,7,65586600,3702,1577100,88,17730
2646,9,0,20,5,65606880,3702,1577100,88,17739
2647,8,0,22,3,65625240,3702,1577100,88,17747
2648,10,0,25,0,65654640,3702,1577220,88,17757
2649,6,0,21,4,65691000,3702,1578240,88,17763
2650,8,0,18,7,65740320,3703,1578240,88,17771
2651,7,0,19,6,65758680,3702,1578240,88,17778
2652,9,0,21,4,65779380,3702,1578240,88,17787
2653,10,0,21,4,65810940,3702,1578240,88,17797
2654,11,0,24,1,65838480,3702,1578240,88,17808
2655,4,0,19,6,65872200,3702,1578240,88,17812
2656,6,0,19,6,65903340,3702,1578240,88,17818
2657,17,5,25,0,65929320,3702,1579740,88,17835
2658,13,13,22,3,65964120,3703,1585980,88,17848
2659,7,9,25,0,66015240,3704,1619460,90,17855
2660,2,0,23,2,66071340,3704,1680300,94,17857
2661,9,0,17,8,66108480,3703,1680300,94,17866
2662,6,0,18,7,66123300,3703,1680300,94,17872
2663,3,0,15,10,66149220,3703,1680300,94,17875
2664,3,0,14,11,66163860,3703,1680300,93,17878
2665,9,0,19,6,66169740,3703,1680300,93,17887
2666,2,0,15,10,66191640,3703,1680300,93,17889
2667,3,0,15,10,66196380,3702,1680300,93,17892
2668,6,0,17,8,66211680,3702,1680300,93,17898
2669,4,0,18,7,66226200,3703,1680300,93,17902
2670,5,0,16,9,66256440,3703,1680300,93,17907
2671,10,0,17,8,66272040,3702,1680300,93,17917
2672,9,0,20,5,66291180,3702,1680300,93,17926
2673,7,0,22,3,66314940,3702,1680360,93,17933
2674,8,3,20,5,66340380,3702,1680780,93,17941
2675,9,6,20,5,66381120,3703,1691460,94,17950
2676,9,10,19,6,66411840,3703,1698720,94,17959
2677,12,19,18,7,66433860,3704,1702440,94,17971
2678,7,15,25,0,66462300,3705,1733580,96,17978
2679,11,14,25,0,66512820,3705,1779120,98,17989
2680,5,0,17,8,66567480,3702,1933020,107,17994
2681,7,0,18,7,66587040,3702,1933020,107,18001
2682,6,0,19,6,66601920,3702,1933020,107,18007
2683,9,0,20,5,66638700,3702,1933020,107,18016
2684,7,0,19,6,66664500,3702,1933020,107,18023
2685,4,0,15,10,66700380,3703,1933020,107,18027
2686,5,0,18,7,66702360,3702,1933020,107,18032
2687,4,0,16,9,66721860,3702,1933020,107,18036

