Hour,Arrivals,Waiting,Treating,Available Rooms,Total Treatment Time,Average Treatment Time,Total Wait Time,Average Wait Time,Total Arrivals
1,8,0,4,21,5340,1335,0,0,8
2,1,0,1,24,20340,2542,0,0,9
3,3,0,2,23,24720,2472,0,0,12
4,3,0,3,22,26160,2180,0,0,15
5,5,0,4,21,31980,1998,0,0,20
6,9,0,10,15,35400,1863,0,0,29
7,8,0,11,14,64380,2476,0,0,37
8,7,0,6,19,115320,3034,0,0,44
9,11,0,7,18,141000,2937,0,0,55
10,14,0,11,14,167880,2894,0,0,69
11,6,0,8,17,212340,3169,0,0,75
12,5,0,8,17,232620,3230,0,0,80
13,8,0,7,18,270660,3341,0,0,88
14,10,0,11,14,289020,3322,0,0,98
15,8,0,5,20,315120,3120,0,0,106
16,4,0,5,20,332100,3162,0,0,110
17,11,0,10,15,347760,3132,0,0,121
18,7,0,9,16,380520,3197,0,0,128
19,10,0,9,16,423900,3286,0,0,138
20,6,0,8,17,444480,3268,0,0,144
21,7,0,7,18,476280,3307,0,0,151
22,6,0,8,17,487500,3271,0,0,157
23,3,0,1,24,529380,3329,0,0,160
24,8,0,4,21,537600,3278,0,0,168
25,8,0,7,18,549660,3252,0,0,176
26,4,0,3,22,568440,3211,0,0,180
27,7,0,8,17,582180,3252,0,0,187
28,7,0,10,15,598500,3252,0,0,194
29,2,0,1,24,629460,3228,0,0,196
30,10,0,9,16,630540,3200,0,0,206
31,9,0,10,15,651600,3178,0,0,215
32,7,0,10,15,682260,3218,0,0,222
33,9,0,10,15,726000,3285,0,0,231
34,9,0,11,14,753180,3288,0,0,240
35,7,0,13,12,772980,3303,0,0,247
36,10,0,10,15,837060,3388,0,0,257
37,6,0,9,16,877140,3453,0,0,263
38,9,0,4,21,922620,3442,0,0,272
39,9,0,5,20,941100,3409,0,0,281
40,14,0,10,15,963780,3381,0,0,295
41,6,0,6,19,993780,3368,0,0,301
42,8,0,6,19,1019280,3363,0,0,309
43,8,0,8,17,1036860,3355,0,0,317
44,10,0,9,16,1059900,3333,0,0,327
45,3,0,5,20,1092000,3360,0,0,330
46,5,0,6,19,1113540,3384,0,0,335
47,5,0,4,21,1136280,3381,0,0,340
48,2,0,4,21,1141680,3377,0,0,342
49,5,0,6,19,1157100,3393,0,0,347
50,2,0,2,23,1186620,3419,0,0,349
51,8,0,8,17,1190280,3410,0,0,357
52,3,0,6,19,1205160,3404,0,0,360
53,6,0,6,19,1239300,3442,0,0,366
54,6,0,7,18,1255080,3438,0,0,372
55,5,0,5,20,1282140,3446,0,0,377
56,5,0,6,19,1286940,3422,0,0,382
57,5,0,6,19,1319700,3463,0,0,387
58,11,0,12,13,1339320,3469,0,0,398
59,11,0,17,8,1356240,3459,0,0,409
60,8,0,10,15,1428180,3509,0,0,417
61,13,0,10,15,1469040,3497,0,0,430
62,9,0,13,12,1489980,3497,0,0,439
63,11,0,12,13,1526220,3484,0,0,450
64,13,0,9,16,1581300,3483,0,0,463
65,9,0,11,14,1603980,3479,0,0,472
66,9,0,9,16,1641540,3477,0,0,481
67,3,0,6,19,1687380,3530,0,0,484
68,8,0,5,20,1723740,3539,0,0,492
69,9,0,7,18,1742220,3526,0,0,501
70,6,0,8,17,1759980,3527,0,0,507
71,6,0,8,17,1788360,3541,0,0,513
72,10,0,8,17,1801620,3498,0,0,523
73,1,0,2,23,1843140,3530,0,0,524
74,2,0,2,23,1851540,3533,0,0,526
75,2,0,2,23,1854300,3525,0,0,528
76,4,0,3,22,1865340,3526,0,0,532
77,5,0,5,20,1870200,3515,0,0,537
78,5,0,6,19,1888380,3523,0,0,542
79,4,0,6,19,1906860,3531,0,0,546
80,6,0,6,19,1927860,3530,0,0,552
81,6,0,7,18,1940940,3522,0,0,558
82,6,0,8,17,1963560,3531,0,0,564
83,12,0,10,15,1997100,3528,0,0,576
84,9,0,10,15,2030580,3531,0,0,585
85,6,0,8,17,2069940,3550,0,0,591
86,13,0,15,10,2095980,3558,0,0,604
87,6,0,7,18,2145360,3557,0,0,610
88,8,0,9,16,2165580,3555,0,0,618
89,9,0,13,12,2195400,3575,0,0,627
90,8,0,14,11,2221020,3576,0,0,635
91,11,0,7,18,2284200,3574,0,0,646
92,8,0,10,15,2306760,3581,0,0,654
93,6,0,6,19,2362500,3612,0,0,660
94,7,0,7,18,2378040,3603,0,0,667
95,7,0,8,17,2397000,3599,0,0,674
96,4,0,1,24,2433540,3594,0,0,678
97,4,0,3,22,2445120,3601,0,0,682
98,3,0,2,23,2456760,3597,0,0,685
99,7,0,3,22,2472060,3587,0,0,692
100,3,0,5,20,2476380,3588,0,0,695
101,9,0,9,16,2498160,3594,0,0,704
102,5,0,6,19,2533080,3603,0,0,709
103,7,0,8,17,2551920,3604,0,0,716
104,3,0,4,21,2591760,3624,0,0,719
105,7,0,6,19,2602860,3615,0,0,726
106,5,0,6,19,2617320,3610,0,0,731
107,6,0,7,18,2632320,3605,0,0,737
108,11,0,8,17,2669280,3607,0,0,748
109,7,0,6,19,2703540,3609,0,0,755
110,5,0,7,18,2720640,3613,0,0,760
111,8,0,6,19,2758560,3620,0,0,768
112,10,0,9,16,2775300,3608,0,0,778
113,6,0,5,20,2817540,3616,0,0,784
114,8,0,7,18,2843220,3621,0,0,792
115,10,0,9,16,2865180,3613,0,0,802
116,4,0,3,22,2897640,3608,0,0,806
117,7,0,5,20,2904600,3594,0,0,813
118,7,0,6,19,2923380,3591,0,0,820
119,1,0,4,21,2940900,3599,0,0,821
120,7,0,10,15,2950800,3607,0,0,828
121,2,0,3,22,2986740,3611,0,0,830
122,5,0,7,18,2996280,3618,0,0,835
123,7,0,7,18,3013380,3608,0,0,842
124,2,0,5,20,3046140,3630,0,0,844
125,5,0,4,21,3071520,3634,0,0,849
126,9,0,7,18,3082740,3622,0,0,858
127,6,0,6,19,3103260,3616,0,0,864
128,4,0,4,21,3119340,3610,0,0,868
129,9,0,10,15,3123180,3602,0,0,877
130,8,0,7,18,3153180,3591,0,0,885
131,9,0,8,17,3177240,3586,0,0,894
132,10,0,9,16,3206340,3582,0,0,904
133,8,0,9,16,3234960,3582,0,0,912
134,13,0,14,11,3275460,3595,0,0,925
135,5,0,8,17,3325080,3606,0,0,930
136,8,0,10,15,3351960,3612,0,0,938
137,11,0,13,12,3389460,3621,0,0,949
138,9,0,10,15,3434640,3623,0,0,958
139,7,0,9,16,3466980,3626,0,0,965
140,4,0,7,18,3500580,3638,0,0,969
141,5,0,7,18,3520920,3641,0,0,974
142,4,0,4,21,3552060,3646,0,0,978
143,4,0,6,19,3565980,3653,0,0,982
144,2,0,2,23,3592020,3657,0,0,984
145,3,0,2,23,3596880,3651,0,0,987
146,4,0,4,21,3606420,3653,0,0,991
147,4,0,4,21,3625920,3658,0,0,995
148,8,0,10,15,3629400,3654,0,0,1003
149,6,0,8,17,3670740,3667,0,0,1009
150,12,0,9,16,3703020,3659,0,0,1021
151,11,0,11,14,3734400,3657,0,0,1032
152,8,0,10,15,3763500,3653,0,0,1040
153,14,0,13,12,3803940,3654,0,0,1054
154,11,0,14,11,3849120,3662,0,0,1065
155,7,0,7,18,3902100,3663,0,0,1072
156,5,0,4,21,3942720,3674,0,0,1077
157,9,0,10,15,3947460,3668,0,0,1086
158,11,0,9,16,3984060,3661,0,0,1097
159,7,0,10,15,4009440,3664,0,0,1104
160,13,0,13,12,4044060,3663,0,0,1117
161,10,0,11,14,4087140,3662,0,0,1127
162,12,0,10,15,4150800,3676,0,0,1139
163,5,0,5,20,4179120,3669,0,0,1144
164,3,0,5,20,4184160,3663,0,0,1147
165,6,0,8,17,4202940,3670,0,0,1153
166,9,0,6,19,4252140,3678,0,0,1162
167,7,0,7,18,4276380,3680,0,0,1169
168,8,0,9,16,4296060,3678,0,0,1177
169,4,0,7,18,4318620,3678,0,0,1181
170,6,0,9,16,4344360,3687,0,0,1187
171,6,0,8,17,4377840,3694,0,0,1193
172,6,0,8,17,4396320,3691,0,0,1199
173,2,0,4,21,4427820,3699,0,0,1201
174,6,0,3,22,4452540,3698,0,0,1207
175,6,0,7,18,4459020,3697,0,0,1213
176,13,0,9,16,4487580,3687,0,0,1226
177,7,0,10,15,4505760,3684,0,0,1233
178,9,0,12,13,4537020,3688,0,0,1242
179,10,0,6,19,4591620,3685,0,0,1252
180,4,0,5,20,4611300,3686,0,0,1256
181,7,0,6,19,4637340,3689,0,0,1263
182,9,0,9,16,4648800,3680,0,0,1272
183,3,0,4,21,4683120,3684,0,0,1275
184,7,0,10,15,4683840,3682,0,0,1282
185,3,0,6,19,4714860,3686,0,0,1285
186,8,0,6,19,4748160,3689,0,0,1293
187,9,0,9,16,4771200,3690,0,0,1302
188,3,0,4,21,4809180,3696,0,0,1305
189,7,0,6,19,4821660,3691,0,0,1312
190,3,0,6,19,4833060,3692,0,0,1315
191,4,0,5,20,4858080,3697,0,0,1319
192,2,0,4,21,4871100,3698,0,0,1321
193,8,0,6,19,4896480,3701,0,0,1329
194,5,0,4,21,4916160,3696,0,0,1334
195,3,0,3,22,4932180,3697,0,0,1337
196,2,0,2,23,4942980,3697,0,0,1339
197,7,0,6,19,4955700,3698,0,0,1346
198,7,0,8,17,4963020,3689,0,0,1353
199,6,0,4,21,4996860,3687,0,0,1359
200,5,0,7,18,5001000,3685,0,0,1364
201,6,0,5,20,5031060,3685,0,0,1370
202,11,0,10,15,5043180,3678,0,0,1381
203,7,0,8,17,5073420,3676,0,0,1388
204,6,0,9,16,5095080,3678,0,0,1394
205,6,0,8,17,5130720,3685,0,0,1400
206,4,0,7,18,5149980,3686,0,0,1404
207,9,0,10,15,5168220,3683,0,0,1413
208,15,0,13,12,5211660,3683,0,0,1428
209,8,0,12,13,5240220,3679,0,0,1436
210,6,0,7,18,5300940,3694,0,0,1442
211,4,0,5,20,5325540,3695,0,0,1446
212,4,0,3,22,5346540,3694,0,0,1450
213,6,0,6,19,5353080,3691,0,0,1456
214,3,0,3,22,5374260,3691,0,0,1459
215,3,0,3,22,5390580,3694,0,0,1462
216,3,0,4,21,5401980,3697,0,0,1465
217,3,0,6,19,5403060,3695,0,0,1468
218,8,0,8,17,5423040,3694,0,0,1476
219,2,0,4,21,5451720,3698,0,0,1478
220,5,0,3,22,5475600,3699,0,0,1483
221,8,0,9,16,5482740,3699,0,0,1491
222,9,0,9,16,5507100,3693,0,0,1500
223,4,0,5,20,5539500,3695,0,0,1504
224,6,0,7,18,5555460,3696,0,0,1510
225,11,0,8,17,5592600,3696,0,0,1521
226,3,0,2,23,5619840,3692,0,0,1524
227,10,0,6,19,5627760,3683,0,0,1534
228,6,0,7,18,5653320,3687,0,0,1540
229,11,0,8,17,5687040,3685,0,0,1551
230,7,0,7,18,5716740,3685,0,0,1558
231,12,0,8,17,5745540,3678,0,0,1570
232,9,0,10,15,5768280,3676,0,0,1579
233,9,0,9,16,5811720,3680,0,0,1588
234,6,0,11,14,5821680,3677,0,0,1594
235,7,0,6,19,5890560,3693,0,0,1601
236,7,0,9,16,5914260,3698,0,0,1608
237,5,0,5,20,5946960,3698,0,0,1613
238,7,0,4,21,5969160,3693,0,0,1620
239,6,0,7,18,5979480,3693,0,0,1626
240,4,0,4,21,6009600,3695,0,0,1630
241,2,0,1,24,6029040,3696,0,0,1632
242,7,0,4,21,6033900,3690,0,0,1639
243,4,0,4,21,6044580,3687,0,0,1643
244,6,0,6,19,6061680,3689,0,0,1649
245,6,0,7,18,6081240,3690,0,0,1655
246,8,0,7,18,6099420,3683,0,0,1663
247,2,0,4,21,6126540,3688,0,0,1665
248,6,0,4,21,6154500,3691,0,0,1671
249,4,0,5,20,6166260,3692,0,0,1675
250,6,0,6,19,6189240,3695,0,0,1681
251,9,0,10,15,6202380,3691,0,0,1690
252,8,0,9,16,6234360,3691,0,0,1698
253,5,0,5,20,6276120,3696,0,0,1703
254,9,0,10,15,6290400,3695,0,0,1712
255,14,0,14,11,6330000,3697,0,0,1726
256,10,0,11,14,6372600,3694,0,0,1736
257,5,0,4,21,6418740,3695,0,0,1741
258,7,0,6,19,6442260,3698,0,0,1748
259,4,0,5,20,6456060,3695,0,0,1752
260,7,0,7,18,6483600,3700,0,0,1759
261,2,0,3,22,6514560,3705,0,0,1761
262,6,0,4,21,6528840,3703,0,0,1767
263,4,0,3,22,6539400,3698,0,0,1771
264,3,0,2,23,6551700,3697,0,0,1774
265,3,0,3,22,6557280,3696,0,0,1777
266,4,0,4,21,6563460,3693,0,0,1781
267,7,0,7,18,6576300,3692,0,0,1788
268,6,0,7,18,6592020,3688,0,0,1794
269,6,0,6,19,6615540,3687,0,0,1800
270,6,0,6,19,6644040,3691,0,0,1806
271,9,0,11,14,6655020,3689,0,0,1815
272,3,0,4,21,6700920,3694,0,0,1818
273,8,0,4,21,6722040,3689,0,0,1826
274,8,0,6,19,6737280,3685,0,0,1834
275,11,0,14,11,6748860,3685,0,0,1845
276,7,0,13,12,6783240,3688,0,0,1852
277,7,0,9,16,6835200,3694,0,0,1859
278,10,0,9,16,6871860,3694,0,0,1869
279,5,0,5,20,6908400,3696,0,0,1874
280,13,0,9,16,6937440,3694,0,0,1887
281,4,0,7,18,6960660,3694,0,0,1891
282,9,0,7,18,7004040,3699,0,0,1900
283,5,0,5,20,7026540,3698,0,0,1905
284,9,0,6,19,7043460,3691,0,0,1914
285,3,0,4,21,7057080,3689,0,0,1917
286,6,0,7,18,7072740,3691,0,0,1923
287,14,0,14,11,7089000,3686,0,0,1937
288,3,0,9,16,7117620,3685,0,0,1940
289,4,0,7,18,7156860,3694,0,0,1944
290,4,0,5,20,7187040,3698,0,0,1948
291,3,0,4,21,7201080,3698,0,0,1951
292,5,0,5,20,7210620,3695,0,0,1956
293,6,0,5,20,7228140,3693,0,0,1962
294,11,0,9,16,7252200,3692,0,0,1973
295,9,0,11,14,7271400,3689,0,0,1982
296,7,0,5,20,7312500,3685,0,0,1989
297,10,0,9,16,7328520,3682,0,0,1999
298,11,0,11,14,7353060,3678,0,0,2010
299,6,0,6,19,7393320,3678,0,0,2016
300,10,0,10,15,7412340,3676,0,0,2026
301,13,0,14,11,7447620,3677,0,0,2039
302,13,0,13,12,7485060,3670,0,0,2052
303,12,0,10,15,7542720,3672,0,0,2064
304,8,0,10,15,7574220,3673,0,0,2072
305,10,0,7,18,7618260,3671,0,0,2082
306,9,0,10,15,7634340,3668,0,0,2091
307,3,0,3,22,7669200,3667,0,0,2094
308,4,0,4,21,7684200,3669,0,0,2098
309,7,0,6,19,7703760,3670,0,0,2105
310,8,0,6,19,7724580,3666,0,0,2113
311,5,0,6,19,7749000,3669,0,0,2118
312,6,0,5,20,7778580,3670,0,0,2124
313,4,0,5,20,7791420,3670,0,0,2128
314,7,0,9,16,7801020,3669,0,0,2135
315,4,0,6,19,7830660,3671,0,0,2139
316,6,0,8,17,7850280,3673,0,0,2145
317,6,0,8,17,7873320,3673,0,0,2151
318,4,0,4,21,7910100,3677,0,0,2155
319,2,0,3,22,7922340,3677,0,0,2157
320,11,0,6,19,7943280,3674,0,0,2168
321,8,0,8,17,7959180,3671,0,0,2176
322,10,0,9,16,7994040,3672,0,0,2186
323,13,0,10,15,8035980,3671,0,0,2199
324,10,0,10,15,8072760,3671,0,0,2209
325,8,0,8,17,8111280,3671,0,0,2217
326,10,0,6,19,8152920,3670,0,0,2227
327,3,0,4,21,8179560,3674,0,0,2230
328,6,0,5,20,8188320,3670,0,0,2236
329,6,0,7,18,8205780,3671,0,0,2242
330,8,0,8,17,8242620,3676,0,0,2250
331,5,0,5,20,8261040,3671,0,0,2255
332,6,0,5,20,8286180,3672,0,0,2261
333,4,0,4,21,8296920,3669,0,0,2265
334,4,0,1,24,8326800,3671,0,0,2269
335,7,0,6,19,8332140,3670,0,0,2276
336,2,0,4,21,8347500,3670,0,0,2278
337,3,0,4,21,8361600,3672,0,0,2281
338,7,0,6,19,8382420,3673,0,0,2288
339,6,0,5,20,8391660,3666,0,0,2294
340,5,0,6,19,8414100,3669,0,0,2299
341,5,0,9,16,8425380,3671,0,0,2304
342,7,0,6,19,8460480,3670,0,0,2311
343,12,0,11,14,8484600,3669,0,0,2323
344,10,0,9,16,8521260,3666,0,0,2333
345,8,0,9,16,8548200,3665,0,0,2341
346,12,0,15,10,8573280,3666,0,0,2353
347,10,0,10,15,8628720,3667,0,0,2363
348,8,0,10,15,8655660,3666,0,0,2371
349,7,0,5,20,8709120,3670,0,0,2378
350,5,0,4,21,8728020,3668,0,0,2383
351,8,0,7,18,8744520,3668,0,0,2391
352,7,0,10,15,8754240,3665,0,0,2398
353,6,0,7,18,8799960,3671,0,0,2404
354,12,0,11,14,8830860,3671,0,0,2416
355,8,0,9,16,8858460,3668,0,0,2424
356,3,0,5,20,8890260,3670,0,0,2427
357,7,0,7,18,8912520,3672,0,0,2434
358,3,0,2,23,8937300,3670,0,0,2437
359,3,0,2,23,8946900,3669,0,0,2440
360,3,0,4,21,8947920,3668,0,0,2443
361,3,0,4,21,8956080,3667,0,0,2446
362,2,0,3,22,8974920,3670,0,0,2448
363,7,0,5,20,8986560,3667,0,0,2455
364,7,0,4,21,9004500,3663,0,0,2462
365,7,0,7,18,9021900,3664,0,0,2469
366,5,0,9,16,9037020,3666,0,0,2474
367,8,0,10,15,9068520,3668,0,0,2482
368,6,0,6,19,9121440,3675,0,0,2488
369,9,0,9,16,9140700,3673,0,0,2497
370,7,0,9,16,9174840,3677,0,0,2504
371,10,0,12,13,9196140,3675,0,0,2514
372,7,0,8,17,9239100,3676,0,0,2521
373,9,0,13,12,9262020,3679,0,0,2530
374,7,0,9,16,9302520,3679,0,0,2537
375,11,0,9,16,9337320,3677,0,0,2548
376,8,0,10,15,9358560,3675,0,0,2556
377,6,0,7,18,9397020,3677,0,0,2562
378,10,0,8,17,9437160,3680,0,0,2572
379,6,0,4,21,9461940,3675,0,0,2578
380,9,0,6,19,9487980,3676,0,0,2587
381,4,0,5,20,9501480,3674,0,0,2591
382,5,0,5,20,9526500,3676,0,0,2596
383,5,0,6,19,9533400,3673,0,0,2601
384,3,0,4,21,9574740,3682,0,0,2604
385,2,0,3,22,9592620,3685,0,0,2606
386,5,0,4,21,9608220,3685,0,0,2611
387,5,0,5,20,9616200,3682,0,0,2616
388,6,0,7,18,9631620,3683,0,0,2622
389,4,0,4,21,9656400,3682,0,0,2626
390,1,0,1,24,9679800,3686,0,0,2627
391,5,0,4,21,9683460,3684,0,0,2632
392,12,0,14,11,9685800,3682,0,0,2644
393,8,0,16,9,9718140,3686,0,0,2652
394,4,0,7,18,9768060,3687,0,0,2656
395,6,0,7,18,9804360,3692,0,0,2662
396,13,0,13,12,9838380,3695,0,0,2675
397,10,0,13,12,9873660,3695,0,0,2685
398,12,0,14,11,9925740,3699,0,0,2697
399,5,0,9,16,9969060,3701,0,0,2702
400,8,0,4,21,10017480,3701,0,0,2710
401,6,0,5,20,10026060,3698,0,0,2716
402,5,0,2,23,10047600,3695,0,0,2721
403,9,0,7,18,10062540,3695,0,0,2730
404,11,0,11,14,10087800,3695,0,0,2741
405,5,0,6,19,10122180,3694,0,0,2746
406,4,0,4,21,10144800,3694,0,0,2750
407,2,0,1,24,10163580,3694,0,0,2752
408,5,0,6,19,10163580,3694,0,0,2757
409,3,0,4,21,10178040,3693,0,0,2760
410,3,0,5,20,10185360,3693,0,0,2763
411,1,0,2,23,10203120,3694,0,0,2764
412,6,0,6,19,10214220,3695,0,0,2770
413,4,0,6,19,10229400,3695,0,0,2774
414,5,0,5,20,10251120,3695,0,0,2779
415,8,0,4,21,10278240,3693,0,0,2787
416,5,0,6,19,10286460,3692,0,0,2792
417,5,0,5,20,10321260,3696,0,0,2797
418,9,0,10,15,10327560,3693,0,0,2806
419,6,0,6,19,10357800,3691,0,0,2812
420,6,0,7,18,10382760,3693,0,0,2818
421,7,0,6,19,10412340,3693,0,0,2825
422,11,0,12,13,10433160,3694,0,0,2836
423,5,0,7,18,10466580,3693,0,0,2841
424,3,0,4,21,10490340,3693,0,0,2844
425,7,0,7,18,10513320,3696,0,0,2851
426,8,0,11,14,10524000,3695,0,0,2859
427,4,0,8,17,10554180,3696,0,0,2863
428,2,0,1,24,10595460,3699,0,0,2865
429,7,0,5,20,10605300,3699,0,0,2872
430,8,0,9,16,10611600,3696,0,0,2880
431,2,0,6,19,10626000,3694,0,0,2882
432,7,0,6,19,10663140,3698,0,0,2889
433,5,0,7,18,10676940,3698,0,0,2894
434,2,0,5,20,10694640,3699,0,0,2896
435,4,0,4,21,10731960,3705,0,0,2900
436,6,0,4,21,10747980,3703,0,0,2906
437,8,0,7,18,10761180,3701,0,0,2914
438,6,0,4,21,10789860,3700,0,0,2920
439,9,0,5,20,10813140,3698,0,0,2929
440,5,0,6,19,10825440,3697,0,0,2934
441,4,0,4,21,10841820,3695,0,0,2938
442,6,0,6,19,10866840,3698,0,0,2944
443,10,0,11,14,10881480,3697,0,0,2954
444,10,0,12,13,10918200,3698,0,0,2964
445,7,0,6,19,10975560,3701,0,0,2971
446,13,0,11,14,10999500,3699,0,0,2984
447,9,0,10,15,11032320,3698,0,0,2993
448,9,0,9,16,11065920,3697,0,0,3002
449,7,0,6,19,11100600,3696,0,0,3009
450,4,0,3,22,11120040,3694,0,0,3013
451,8,0,7,18,11140080,3696,0,0,3021
452,5,0,5,20,11157720,3693,0,0,3026
453,3,0,5,20,11173620,3694,0,0,3029
454,7,0,5,20,11204460,3696,0,0,3036
455,6,0,7,18,11212500,3694,0,0,3042
456,2,0,2,23,11236920,3693,0,0,3044
457,2,0,2,23,11253240,3696,0,0,3046
458,3,0,3,22,11260320,3696,0,0,3049
459,3,0,3,22,11264400,3694,0,0,3052
460,6,0,5,20,11277960,3694,0,0,3058
461,5,0,6,19,11293680,3694,0,0,3063
462,10,0,9,16,11319300,3694,0,0,3073
463,4,0,5,20,11341380,3691,0,0,3077
464,6,0,7,18,11364480,3694,0,0,3083
465,10,0,13,12,11385840,3696,0,0,3093
466,9,0,13,12,11416200,3695,0,0,3102
467,13,0,13,12,11463840,3695,0,0,3115
468,10,0,8,17,11515620,3694,0,0,3125
469,7,0,8,17,11544300,3695,0,0,3132
470,6,0,9,16,11566380,3696,0,0,3138
471,9,0,9,16,11594760,3694,0,0,3147
472,13,0,12,13,11625540,3692,0,0,3160
473,8,0,8,17,11665800,3691,0,0,3168
474,13,0,11,14,11692740,3688,0,0,3181
475,6,0,8,17,11736300,3691,0,0,3187
476,4,0,5,20,11763000,3692,0,0,3191
477,6,0,4,21,11791980,3693,0,0,3197
478,6,0,6,19,11800860,3691,0,0,3203
479,2,0,2,23,11827500,3692,0,0,3205
480,5,0,4,21,11835480,3691,0,0,3210
481,3,0,3,22,11854860,3693,0,0,3213
482,3,0,2,23,11862060,3690,0,0,3216
483,3,0,0,25,11872560,3688,0,0,3219
484,7,0,5,20,11874300,3686,0,0,3226
485,4,0,5,20,11883420,3684,0,0,3230
486,4,0,2,23,11904180,3683,0,0,3234
487,2,0,1,24,11914740,3683,0,0,3236
488,4,0,5,20,11914740,3683,0,0,3240
489,8,0,10,15,11921760,3681,0,0,3248
490,3,0,3,22,11959380,3682,0,0,3251
491,8,0,4,21,11972640,3678,0,0,3259
492,8,0,8,17,11988420,3678,0,0,3267
493,6,0,7,18,12013980,3678,0,0,3273
494,6,0,8,17,12032280,3678,0,0,3279
495,10,0,7,18,12069600,3677,0,0,3289
496,6,0,7,18,12094560,3678,0,0,3295
497,15,0,10,15,12130080,3675,0,0,3310
498,6,0,6,19,12155160,3672,0,0,3316
499,8,0,8,17,12178020,3672,0,0,3324
500,3,0,4,21,12208740,3674,0,0,3327
501,2,0,1,24,12231660,3675,0,0,3329
502,5,0,5,20,12232440,3674,0,0,3334
503,7,0,9,16,12241800,3674,0,0,3341
504,4,0,7,18,12264240,3674,0,0,3345
505,6,0,3,22,12310980,3677,0,0,3351
506,2,0,3,22,12318540,3677,0,0,3353
507,5,0,5,20,12332280,3677,0,0,3358
508,6,0,6,19,12349020,3677,0,0,3364
509,7,0,10,15,12366720,3679,0,0,3371
510,3,0,7,18,12382020,3677,0,0,3374
511,8,0,5,20,12435060,3682,0,0,3382
512,6,0,3,22,12454440,3679,0,0,3388
513,9,0,8,17,12464220,3677,0,0,3397
514,8,0,9,16,12492840,3678,0,0,3405
515,6,0,7,18,12518820,3677,0,0,3411
516,10,0,8,17,12545760,3675,0,0,3421
517,9,0,10,15,12571560,3675,0,0,3430
518,12,0,11,14,12604200,3673,0,0,3442
519,14,0,13,12,12645540,3672,0,0,3456
520,8,0,10,15,12691380,3674,0,0,3464
521,6,0,8,17,12731160,3677,0,0,3470
522,10,0,10,15,12758040,3676,0,0,3480
523,10,0,4,21,12803220,3672,0,0,3490
524,8,0,7,18,12812880,3670,0,0,3498
525,6,0,6,19,12841020,3670,0,0,3504
526,5,0,7,18,12857160,3671,0,0,3509
527,2,0,3,22,12884520,3672,0,0,3511
528,5,0,4,21,12894780,3671,0,0,3516
529,7,0,4,21,12911760,3669,0,0,3523
530,3,0,5,20,12921600,3669,0,0,3526
531,4,0,4,21,12950520,3672,0,0,3530
532,6,0,7,18,12956700,3671,0,0,3536
533,1,0,2,23,12990180,3674,0,0,3537
534,3,0,3,22,12998940,3675,0,0,3540
535,6,0,7,18,13004880,3674,0,0,3546
536,6,0,7,18,13027440,3674,0,0,3552
537,8,0,9,16,13049220,3674,0,0,3560
538,5,0,4,21,13089300,3675,0,0,3565
539,7,0,5,20,13107600,3674,0,0,3572
540,13,0,10,15,13119000,3669,0,0,3585
541,3,0,4,21,13155960,3670,0,0,3588
542,11,0,10,15,13166880,3668,0,0,3599
543,4,0,5,20,13198200,3668,0,0,3603
544,10,0,9,16,13226880,3670,0,0,3613
545,9,0,8,17,13258980,3668,0,0,3622
546,9,0,8,17,13290600,3668,0,0,3631
547,4,0,5,20,13318260,3668,0,0,3635
548,6,0,8,17,13328040,3668,0,0,3641
549,4,0,3,22,13359480,3668,0,0,3645
550,4,0,3,22,13374540,3668,0,0,3649
551,7,0,8,17,13379520,3667,0,0,3656
552,5,0,6,19,13408620,3668,0,0,3661
553,3,0,4,21,13427400,3668,0,0,3664
554,5,0,5,20,13440660,3668,0,0,3669
555,5,0,6,19,13454700,3668,0,0,3674
556,6,0,6,19,13483800,3670,0,0,3680
557,6,0,8,17,13498320,3670,0,0,3686
558,8,0,7,18,13536120,3671,0,0,3694
559,2,0,3,22,13560480,3671,0,0,3696
560,6,0,4,21,13579080,3672,0,0,3702
561,14,0,12,13,13588140,3668,0,0,3716
562,6,0,11,14,13621740,3670,0,0,3722
563,10,0,10,15,13663500,3671,0,0,3732
564,9,0,6,19,13706580,3669,0,0,3741
565,11,0,9,16,13729380,3668,0,0,3752
566,12,0,12,13,13752420,3665,0,0,3764
567,8,0,10,15,13786860,3664,0,0,3772
568,6,0,7,18,13819320,3664,0,0,3778
569,7,0,5,20,13850280,3664,0,0,3785
570,2,0,4,21,13857000,3662,0,0,3787
571,8,0,5,20,13886820,3664,0,0,3795
572,3,0,6,19,13893120,3663,0,0,3798
573,10,0,7,18,13928640,3664,0,0,3808
574,3,0,6,19,13942140,3664,0,0,3811
575,4,0,6,19,13965000,3666,0,0,3815
576,3,0,3,22,13984860,3665,0,0,3818
577,3,0,1,24,14007780,3666,0,0,3821
578,4,0,2,23,14009640,3664,0,0,3825
579,4,0,4,21,14011800,3663,0,0,3829
580,4,0,5,20,14030100,3665,0,0,3833
581,5,0,6,19,14035800,3662,0,0,3838
582,6,0,6,19,14064600,3664,0,0,3844
583,9,0,10,15,14088480,3666,0,0,3853
584,10,0,10,15,14121060,3664,0,0,3863
585,11,0,8,17,14151840,3660,0,0,3874
586,5,0,8,17,14175000,3661,0,0,3879
587,11,0,10,15,14214000,3663,0,0,3890
588,10,0,15,10,14224980,3661,0,0,3900
589,11,0,14,11,14273520,3662,0,0,3911
590,7,0,12,13,14322120,3666,0,0,3918
591,13,0,12,13,14372640,3667,0,0,3931
592,6,0,7,18,14422800,3669,0,0,3937
593,8,0,6,19,14444880,3667,0,0,3945
594,6,0,8,17,14465640,3668,0,0,3951
595,10,0,10,15,14497740,3669,0,0,3961
596,8,0,6,19,14541840,3669,0,0,3969
597,2,0,5,20,14558340,3670,0,0,3971
598,1,0,2,23,14583900,3673,0,0,3972
599,1,0,1,24,14595000,3674,0,0,3973
600,3,0,4,21,14595000,3674,0,0,3976
601,5,0,5,20,14614620,3675,0,0,3981
602,8,0,9,16,14628900,3675,0,0,3989
603,7,0,11,14,14655060,3677,0,0,3996
604,5,0,8,17,14682120,3676,0,0,4001
605,4,0,6,19,14714880,3679,0,0,4005
606,9,0,7,18,14749080,3680,0,0,4014
607,5,0,6,19,14766720,3679,0,0,4019
608,7,0,7,18,14789280,3679,0,0,4026
609,9,0,12,13,14807340,3680,0,0,4035
610,7,0,7,18,14856660,3681,0,0,4042
611,7,0,5,20,14900280,3684,0,0,4049
612,7,0,6,19,14915340,3682,0,0,4056
613,4,0,4,21,14940480,3683,0,0,4060
614,6,0,7,18,14955300,3684,0,0,4066
615,4,0,7,18,14973060,3685,0,0,4070
616,8,0,7,18,15006420,3686,0,0,4078
617,5,0,7,18,15021660,3685,0,0,4083
618,5,0,4,21,15048900,3684,0,0,4088
619,7,0,6,19,15064920,3684,0,0,4095
620,10,0,10,15,15090780,3685,0,0,4105
621,5,0,10,15,15112920,3686,0,0,4110
622,4,0,7,18,15148020,3688,0,0,4114
623,5,0,7,18,15167640,3688,0,0,4119
624,7,0,9,16,15192840,3690,0,0,4126
625,3,0,3,22,15230940,3691,0,0,4129
626,4,0,5,20,15243660,3692,0,0,4133
627,2,0,4,21,15250980,3691,0,0,4135
628,6,0,5,20,15276480,3693,0,0,4141
629,3,0,5,20,15288720,3693,0,0,4144
630,3,0,3,22,15307740,3693,0,0,4147
631,4,0,2,23,15315540,3691,0,0,4151
632,5,0,5,20,15324900,3691,0,0,4156
633,8,0,6,19,15345300,3690,0,0,4164
634,6,0,5,20,15367260,3689,0,0,4170
635,8,0,8,17,15379620,3688,0,0,4178
636,14,0,14,11,15404880,3687,0,0,4192
637,11,0,10,15,15449640,3684,0,0,4203
638,13,0,12,13,15483660,3683,0,0,4216
639,5,0,6,19,15515880,3681,0,0,4221
640,10,0,9,16,15551940,3683,0,0,4231
641,6,0,11,14,15563400,3682,0,0,4237
642,10,0,8,17,15618840,3684,0,0,4247
643,8,0,12,13,15633420,3684,0,0,4255
644,6,0,9,16,15665580,3684,0,0,4261
645,5,0,5,20,15719760,3689,0,0,4266
646,10,0,12,13,15722640,3687,0,0,4276
647,9,0,12,13,15754560,3687,0,0,4285
648,3,0,3,22,15822360,3692,0,0,4288
649,1,0,0,25,15836400,3692,0,0,4289
650,4,0,2,23,15838500,3691,0,0,4293
651,7,0,8,17,15839400,3690,0,0,4300
652,5,0,6,19,15858900,3688,0,0,4305
653,7,0,7,18,15885480,3690,0,0,4312
654,2,0,5,20,15900480,3690,0,0,4314
655,2,0,3,22,15927360,3692,0,0,4316
656,6,0,6,19,15932520,3691,0,0,4322
657,5,0,5,20,15957360,3692,0,0,4327
658,9,0,9,16,15984960,3694,0,0,4336
659,7,0,10,15,16015140,3696,0,0,4343
660,3,0,7,18,16047900,3698,0,0,4346
661,12,0,8,17,16091760,3699,0,0,4358
662,9,0,13,12,16102620,3698,0,0,4367
663,8,0,10,15,16140660,3697,0,0,4375
664,12,0,10,15,16186680,3698,0,0,4387
665,12,0,14,11,16219320,3698,0,0,4399
666,8,0,9,16,16276620,3700,0,0,4407
667,6,0,7,18,16314000,3702,0,0,4413
668,11,0,11,14,16339620,3702,0,0,4424
669,4,0,7,18,16367940,3702,0,0,4428
670,6,0,8,17,16391880,3703,0,0,4434
671,3,0,6,19,16414080,3704,0,0,4437
672,5,0,6,19,16428900,3703,0,0,4442
673,6,0,10,15,16433040,3702,0,0,4448
674,4,0,12,13,16439040,3702,0,0,4452
675,3,0,8,17,16466880,3702,0,0,4455
676,2,0,7,18,16473120,3701,0,0,4457
677,8,0,11,14,16491660,3702,0,0,4465
678,9,0,12,13,16509540,3700,0,0,4474
679,8,0,12,13,16521720,3696,0,0,4482
680,4,0,9,16,16558020,3698,0,0,4486
681,6,0,9,16,16573860,3697,0,0,4492
682,5,0,10,15,16584480,3696,0,0,4497
683,8,0,12,13,16605480,3695,0,0,4505
684,8,0,12,13,16631700,3695,0,0,4513
685,9,0,16,9,16654200,3696,0,0,4522
686,5,0,12,13,16686120,3695,0,0,4527
687,13,0,16,9,16717620,3695,0,0,4540
688,7,0,15,10,16750740,3696,0,0,4547
689,6,0,10,15,16803600,3698,0,0,4553
690,3,0,9,16,16823640,3699,0,0,4556
691,7,0,9,16,16846440,3699,0,0,4563
692,8,0,14,11,16855980,3698,0,0,4571
693,7,0,14,11,16878180,3698,0,0,4578
694,4,0,10,15,16914480,3699,0,0,4582
695,5,0,14,11,16918080,3699,0,0,4587
696,6,0,10,15,16964280,3701,0,0,4593
697,1,0,8,17,16976220,3701,0,0,4594
698,5,0,9,16,16994880,3702,0,0,4599
699,7,0,10,15,17008500,3700,0,0,4606
700,3,0,9,16,17020080,3700,0,0,4609
701,6,0,13,12,17034180,3701,0,0,4615
702,9,0,13,12,17069040,3701,0,0,4624
703,3,0,7,18,17101080,3701,0,0,4627
704,8,0,13,12,17108280,3701,0,0,4635
705,7,0,13,12,17128080,3700,0,0,4642
706,10,0,15,10,17155500,3699,0,0,4652
707,10,0,14,11,17200800,3700,0,0,4662
708,6,0,15,10,17228700,3702,0,0,4668
709,14,0,17,8,17270160,3702,0,0,4682
710,9,0,14,11,17306880,3700,0,0,4691
711,8,0,12,13,17343000,3700,0,0,4699
712,11,0,14,11,17379420,3700,0,0,4710
713,11,0,14,11,17410920,3698,0,0,4721
714,5,0,12,13,17438040,3699,0,0,4726
715,7,0,11,14,17470980,3699,0,0,4733
716,4,0,13,12,17479440,3700,0,0,4737
717,7,0,10,15,17518440,3700,0,0,4744
718,4,0,10,15,17537880,3701,0,0,4748
719,1,0,7,18,17564340,3703,0,0,4749
720,5,0,9,16,17577780,3704,0,0,4754
721,7,0,9,16,17592180,3702,0,0,4761
722,2,0,9,16,17598660,3701,0,0,4763
723,6,0,9,16,17620560,3701,0,0,4769
724,6,0,11,14,17634840,3701,0,0,4775
725,4,0,11,14,17645400,3700,0,0,4779
726,6,0,12,13,17660220,3700,0,0,4785
727,7,0,13,12,17687940,3701,0,0,4792
728,8,0,16,9,17697540,3699,0,0,4800
729,13,0,17,8,17728680,3696,0,0,4813
730,5,0,12,13,17778420,3699,0,0,4818
731,7,0,7,18,17813700,3697,0,0,4825
732,13,0,15,10,17829240,3696,0,0,4838
733,12,0,14,11,17854620,3692,0,0,4850
734,13,0,16,9,17888280,3690,840,0,4863
735,8,0,17,8,17915520,3690,840,0,4871
736,8,0,19,6,17952780,3693,1680,0,4879
737,5,0,12,13,18015360,3697,1680,0,4884
738,7,0,12,13,18039720,3697,1680,0,4891
739,4,0,11,14,18062220,3698,1680,0,4895
740,5,0,13,12,18072180,3698,1680,0,4900
741,5,0,12,13,18097200,3698,1680,0,4905
742,10,0,15,10,18126180,3699,1680,0,4915
743,7,0,13,12,18155760,3698,1680,0,4922
744,3,0,8,17,18191580,3699,1680,0,4925
745,3,0,10,15,18199500,3700,1680,0,4928
746,1,0,8,17,18208560,3700,1680,0,4929
747,1,0,6,19,18225780,3701,1680,0,4930
748,5,0,8,17,18231000,3700,1680,0,4935
749,3,0,8,17,18244620,3700,1680,0,4938
750,4,0,8,17,18256860,3700,1680,0,4942
751,7,0,13,12,18265140,3700,1680,0,4949
752,9,0,16,9,18280380,3698,1680,0,4958
753,6,0,8,17,18327840,3698,1680,0,4964
754,8,0,12,13,18347640,3699,1680,0,4972
755,10,0,18,7,18360300,3698,1680,0,4982
756,12,0,19,6,18399600,3698,1680,0,4994
757,13,0,18,7,18436440,3695,1680,0,5007
758,11,0,18,7,18480960,3696,1680,0,5018
759,8,0,14,11,18525480,3696,1680,0,5026
760,5,0,9,16,18564900,3696,1680,0,5031
761,12,0,18,7,18569220,3695,1680,0,5043
762,8,0,14,11,18605340,3693,1680,0,5051
763,5,0,12,13,18652800,3698,1680,0,5056
764,5,0,8,17,18694440,3699,1680,0,5061
765,1,0,8,17,18700920,3700,1680,0,5062
766,8,0,9,16,18717060,3698,1680,0,5070
767,6,0,9,16,18735120,3697,1680,0,5076
768,3,0,9,16,18748440,3697,1680,0,5079
769,4,0,9,16,18762540,3697,1680,0,5083
770,7,0,9,16,18781020,3696,1680,0,5090
771,4,0,10,15,18789360,3695,1680,0,5094
772,6,0,11,14,18800520,3694,1680,0,5100
773,9,0,12,13,18827520,3693,1680,0,5109
774,2,0,11,14,18840900,3694,1680,0,5111
775,6,0,10,15,18873540,3695,1680,0,5117
776,5,0,9,16,18886320,3693,1680,0,5122
777,9,0,12,13,18906120,3693,1680,0,5131
778,7,0,13,12,18924420,3692,1680,0,5138
779,8,0,14,11,18957480,3693,1680,0,5146
780,5,0,14,11,18989580,3696,1680,0,5151
781,9,0,13,12,19034580,3698,1680,0,5160
782,5,0,12,13,19050060,3696,1680,0,5165
783,10,0,14,11,19081800,3697,1680,0,5175
784,7,0,12,13,19113240,3696,1680,0,5182
785,6,0,11,14,19136220,3696,1680,0,5188
786,4,0,10,15,19156500,3696,1680,0,5192
787,7,0,10,15,19184940,3697,1680,0,5199
788,9,0,15,10,19204560,3698,1680,0,5208
789,8,0,16,9,19228980,3697,1680,0,5216
790,7,0,12,13,19267500,3697,1680,0,5223
791,7,0,12,13,19298100,3698,1680,0,5230
792,7,0,10,15,19333140,3698,1680,0,5237
793,5,0,12,13,19345920,3699,1680,0,5242
794,2,0,11,14,19352640,3698,1680,0,5244
795,5,0,9,16,19398420,3701,1680,0,5249
796,8,0,13,12,19406820,3700,1680,0,5257
797,9,0,12,13,19436580,3699,1680,0,5266
798,8,0,11,14,19457580,3697,1680,0,5274
799,5,0,12,13,19470480,3696,1680,0,5279
800,5,0,9,16,19508040,3698,1680,0,5284
801,7,0,12,13,19519320,3697,1680,0,5291
802,10,0,14,11,19539240,3695,1680,0,5301
803,11,0,15,10,19565520,3693,1680,0,5312
804,5,0,9,16,19608360,3694,1680,0,5317
805,10,0,12,13,19626480,3692,1680,0,5327
806,9,0,12,13,19649820,3690,1680,0,5336
807,7,0,14,11,19657140,3688,1680,0,5343
808,4,0,10,15,19694160,3690,1680,0,5347
809,7,0,11,14,19724940,3691,1680,0,5354
810,8,0,14,11,19740480,3691,1680,0,5362
811,7,0,14,11,19754100,3688,1680,0,5369
812,2,0,7,18,19803360,3691,1680,0,5371
813,3,0,8,17,19810680,3691,1680,0,5374
814,2,0,8,17,19818720,3692,1680,0,5376
815,4,0,8,17,19835040,3692,1680,0,5380
816,3,0,9,16,19839420,3691,1680,0,5383
817,5,0,12,13,19855560,3693,1680,0,5388
818,4,0,9,16,19872960,3691,1680,0,5392
819,4,0,10,15,19890420,3692,1680,0,5396
820,3,0,8,17,19915200,3694,1680,0,5399
821,8,0,13,12,19920180,3693,1680,0,5407
822,4,0,12,13,19942500,3693,1680,0,5411
823,6,0,11,14,19976940,3695,1680,0,5417
824,3,0,10,15,19993980,3695,1680,0,5420
825,3,0,7,18,20017260,3695,1680,0,5423
826,10,0,11,14,20022720,3692,1680,0,5433
827,8,0,14,11,20035680,3691,1680,0,5441
828,7,0,11,14,20075820,3692,1680,0,5448
829,8,0,15,10,20084940,3691,1680,0,5456
830,6,0,14,11,20116380,3692,1680,0,5462
831,9,0,16,9,20142720,3692,1680,0,5471
832,6,0,12,13,20199840,3696,1680,0,5477
833,4,0,11,14,20213460,3695,1680,0,5481
834,6,0,9,16,20251740,3696,1680,0,5487
835,5,0,9,16,20260920,3695,1680,0,5492
836,5,0,13,12,20261580,3694,1680,0,5497
837,2,0,9,16,20290020,3695,1680,0,5499
838,7,0,9,16,20316180,3695,1680,0,5506
839,4,0,9,16,20331600,3695,1680,0,5510
840,0,0,6,19,20349420,3697,1680,0,5510
841,2,0,6,19,20358480,3697,1680,0,5512
842,6,0,8,17,20367480,3696,1680,0,5518
843,5,0,9,16,20372100,3694,1680,0,5523
844,5,0,10,15,20382660,3693,1680,0,5528
845,5,0,9,16,20403720,3693,1680,0,5533
846,5,0,10,15,20425860,3694,1680,0,5538
847,6,0,12,13,20432280,3693,1680,0,5544
848,8,0,14,11,20458680,3694,1680,0,5552
849,11,0,16,9,20489460,3693,1680,0,5563
850,6,0,11,14,20521860,3692,1680,0,5569
851,6,0,9,16,20546520,3691,1680,0,5575
852,9,0,13,12,20563560,3691,1680,0,5584
853,7,0,11,14,20594700,3690,1680,0,5591
854,6,0,11,14,20615220,3690,1680,0,5597
855,7,0,9,16,20646840,3690,1680,0,5604
856,8,0,11,14,20654880,3687,1680,0,5612
857,11,0,16,9,20671980,3686,1680,0,5623
858,2,0,10,15,20703300,3687,1680,0,5625
859,2,0,11,14,20709480,3687,1680,0,5627
860,1,0,7,18,20739420,3689,1680,0,5628
861,10,0,16,9,20740620,3689,1680,0,5638
862,7,0,10,15,20770080,3685,1680,0,5645
863,2,0,7,18,20793240,3686,1680,0,5647
864,6,0,12,13,20795220,3686,1680,0,5653
865,5,0,10,15,20814060,3685,1680,0,5658
866,5,0,11,14,20830620,3685,1680,0,5663
867,4,0,11,14,20856060,3687,1680,0,5667
868,4,0,8,17,20879580,3687,1680,0,5671
869,13,0,16,9,20892900,3686,1680,0,5684
870,6,0,12,13,20923860,3685,1680,0,5690
871,7,0,12,13,20955480,3686,1680,0,5697
872,10,0,16,9,20972100,3685,1680,0,5707
873,9,0,17,8,21005340,3685,1680,0,5716
874,14,0,18,7,21056580,3686,1680,0,5730
875,5,0,11,14,21105240,3687,1680,0,5735
876,10,0,14,11,21136560,3688,1680,0,5745
877,11,0,16,9,21154200,3685,1680,0,5756
878,8,0,15,10,21183720,3684,1680,0,5764
879,10,0,13,12,21228600,3684,1680,0,5774
880,9,0,14,11,21254700,3684,1680,0,5783
881,10,0,15,10,21274740,3682,1680,0,5793
882,4,0,11,14,21314640,3683,1680,0,5797
883,5,0,13,12,21331680,3684,1680,0,5802
884,11,0,19,6,21346980,3684,1680,0,5813
885,5,0,12,13,21388080,3683,1680,0,5818
886,6,0,12,13,21419160,3685,1680,0,5824
887,4,0,9,16,21437580,3684,1680,0,5828
888,4,0,9,16,21456300,3684,1680,0,5832
889,4,0,8,17,21468360,3683,1680,0,5836
890,4,0,9,16,21481620,3684,1680,0,5840
891,4,0,8,17,21500880,3684,1680,0,5844
892,8,0,11,14,21510120,3682,1680,0,5852
893,8,0,13,12,21534180,3682,1680,0,5860
894,5,0,14,11,21547080,3682,1680,0,5865
895,4,0,10,15,21596340,3686,1680,0,5869
896,6,0,11,14,21606480,3684,1680,0,5875
897,12,0,16,9,21635160,3685,1680,0,5887
898,11,0,16,9,21663780,3683,1680,0,5898
899,7,0,15,10,21699420,3684,1680,0,5905
900,5,0,11,14,21740640,3685,1680,0,5910
901,10,0,13,12,21758280,3683,1680,0,5920
902,9,0,12,13,21781560,3681,1680,0,5929
903,13,0,19,6,21810780,3682,1680,0,5942
904,8,0,17,8,21853440,3683,1680,0,5950
905,13,0,21,4,21889920,3683,1680,0,5963
906,9,0,15,10,21944220,3683,1680,0,5972
907,14,0,14,11,21996240,3683,1680,0,5986
908,4,0,9,16,22025520,3682,1680,0,5990
909,8,0,14,11,22045620,3684,1680,0,5998
910,3,0,10,15,22064580,3682,1680,0,6001
911,9,0,12,13,22090320,3682,1680,0,6010
912,6,0,11,14,22115460,3682,1680,0,6016
913,6,0,10,15,22134300,3681,1680,0,6022
914,4,0,10,15,22147080,3681,1680,0,6026
915,7,0,12,13,22168980,3681,1680,0,6033
916,3,0,10,15,22182000,3681,1680,0,6036
917,4,0,8,17,22212840,3682,1680,0,6040
918,3,0,8,17,22219080,3681,1680,0,6043
919,5,0,9,16,22223940,3680,1680,0,6048
920,6,0,9,16,22242420,3679,1680,0,6054
921,8,0,10,15,22257420,3677,1680,0,6062
922,10,0,14,11,22274940,3676,1680,0,6072
923,6,0,9,16,22305060,3675,1680,0,6078
924,15,0,17,8,22320180,3673,1680,0,6093
925,9,0,15,10,22347780,3671,1680,0,6102
926,11,0,14,11,22391280,3671,1680,0,6113
927,4,0,12,13,22407720,3670,1680,0,6117
928,6,0,13,12,22434180,3671,1680,0,6123
929,10,0,15,10,22464060,3671,1680,0,6133
930,6,0,12,13,22500720,3672,1680,0,6139
931,10,0,15,10,22526160,3672,1680,0,6149
932,2,0,11,14,22551780,3672,1680,0,6151
933,7,0,13,12,22571400,3673,1680,0,6158
934,4,0,7,18,22607760,3673,1680,0,6162
935,1,0,6,19,22615560,3673,1680,0,6163
936,4,0,8,17,22617660,3672,1680,0,6167
937,6,0,11,14,22624440,3671,1680,0,6173
938,4,0,10,15,22637760,3670,1680,0,6177
939,3,0,9,16,22652880,3670,1680,0,6180
940,12,0,10,15,22687320,3669,1680,0,6192
941,6,0,12,13,22696980,3669,1680,0,6198
942,14,0,18,7,22714860,3667,1680,0,6212
943,6,0,14,11,22760100,3668,1680,0,6218
944,4,0,10,15,22799100,3670,1680,0,6222
945,8,0,11,14,22826040,3670,1680,0,6230
946,7,0,13,12,22841700,3669,1680,0,6237
947,11,0,16,9,22863420,3668,1680,0,6248
948,4,0,9,16,22907160,3669,1680,0,6252
949,15,0,18,7,22924560,3668,1680,0,6267
950,9,0,14,11,22963920,3667,1680,0,6276
951,5,0,10,15,22994340,3666,1680,0,6281
952,5,0,8,17,23014920,3665,1680,0,6286
953,10,0,14,11,23018460,3664,1680,0,6296
954,6,0,12,13,23044200,3663,1680,0,6302
955,3,0,12,13,23057040,3663,1680,0,6305
956,6,0,12,13,23089320,3665,1680,0,6311
957,7,0,11,14,23114700,3664,1680,0,6318
958,6,0,12,13,23138520,3665,1680,0,6324
959,2,0,8,17,23160960,3665,1680,0,6326
960,4,0,8,17,23176560,3666,1680,0,6330
961,3,0,7,18,23183580,3664,1680,0,6333
962,2,0,7,18,23190960,3664,1680,0,6335
963,5,0,9,16,23201100,3664,1680,0,6340
964,6,0,11,14,23211600,3664,1680,0,6346
965,4,0,10,15,23227140,3663,1680,0,6350
966,4,0,7,18,23251560,3663,1680,0,6354
967,7,0,12,13,23258400,3663,1680,0,6361
968,5,0,12,13,23272920,3662,1680,0,6366
969,8,0,14,11,23294280,3662,1680,0,6374
970,9,0,12,13,23332440,3662,1680,0,6383
971,2,0,8,17,23354760,3662,1680,0,6385
972,5,0,10,15,23366280,3662,1680,0,6390
973,15,0,18,7,23380740,3660,1680,0,6405
974,8,0,14,11,23414640,3659,1680,0,6413
975,5,0,10,15,23457000,3660,1680,0,6418
976,12,0,16,9,23478240,3660,1680,0,6430
977,2,0,6,19,23518920,3659,1680,0,6432
978,5,0,9,16,23521320,3659,1680,0,6437
979,9,0,12,13,23539800,3658,1680,0,6446
980,8,0,13,12,23558100,3657,1680,0,6454
981,3,0,9,16,23585100,3657,1680,0,6457
982,3,0,9,16,23611560,3660,1680,0,6460
983,3,0,8,17,23621940,3659,1680,0,6463
984,6,0,11,14,23633100,3659,1680,0,6469
985,7,0,15,10,23645280,3659,1680,0,6476
986,5,0,13,12,23665260,3658,1680,0,6481
987,4,0,11,14,23706480,3661,1680,0,6485
988,4,0,8,17,23734020,3662,1680,0,6489
989,4,0,7,18,23746380,3661,1680,0,6493
990,7,0,13,12,23751840,3661,1680,0,6500
991,3,0,9,16,23778780,3661,1680,0,6503
992,15,0,19,6,23798640,3661,1680,0,6518
993,10,0,19,6,23824680,3660,1860,0,6528
994,9,0,18,7,23876220,3662,1860,0,6537
995,7,0,11,14,23946600,3665,1860,0,6544
996,13,0,15,10,23966700,3663,1860,0,6557
997,12,0,15,10,23997780,3661,1860,0,6569
998,9,0,12,13,24027180,3659,1860,0,6578
999,12,0,17,8,24058920,3660,1860,0,6590
1000,9,0,15,10,24092100,3659,1860,0,6599
1001,5,0,13,12,24120840,3659,1860,0,6604
1002,8,0,13,12,24165300,3661,1860,0,6612
1003,3,0,9,16,24182580,3660,1860,0,6615
1004,8,0,15,10,24196140,3661,1860,0,6623
1005,6,0,13,12,24236580,3663,1860,0,6629
1006,8,0,12,13,24275160,3664,1860,0,6637
1007,3,0,11,14,24294360,3664,1860,0,6640
1008,5,0,8,17,24330840,3665,1860,0,6645
1009,5,0,11,14,24339960,3666,1860,0,6650
1010,2,0,13,12,24339960,3666,1860,0,6652
1011,6,0,10,15,24390060,3668,1860,0,6658
1012,6,0,12,13,24407220,3669,1860,0,6664
1013,2,0,9,16,24427140,3669,1860,0,6666
1014,9,0,12,13,24454320,3670,1860,0,6675
1015,9,0,13,12,24478140,3669,1860,0,6684
1016,5,0,14,11,24497160,3669,1860,0,6689
1017,8,0,13,12,24528780,3669,1860,0,6697
1018,7,0,13,12,24555120,3669,1860,0,6704
1019,6,0,9,16,24590700,3669,1860,0,6710
1020,5,0,11,14,24603840,3670,1860,0,6715
1021,8,0,15,10,24622320,3670,1860,0,6723
1022,9,0,14,11,24661620,3670,1860,0,6732
1023,6,0,13,12,24677160,3669,1860,0,6738
1024,6,0,13,12,24708540,3670,1860,0,6744
1025,6,0,11,14,24737580,3670,1860,0,6750
1026,11,0,17,8,24753120,3670,1860,0,6761
1027,5,0,14,11,24793620,3672,1860,0,6766
1028,9,0,17,8,24824460,3673,1860,0,6775
1029,3,0,10,15,24873180,3675,1860,0,6778
1030,6,0,10,15,24899040,3675,1860,0,6784
1031,7,0,11,14,24914100,3674,1860,0,6791
1032,3,0,8,17,24938040,3674,1860,0,6794
1033,3,0,6,19,24951240,3674,1860,0,6797
1034,5,0,10,15,24956280,3674,1860,0,6802
1035,2,0,6,19,24973080,3673,1860,0,6804
1036,5,0,9,16,24974940,3672,1860,0,6809
1037,7,0,12,13,24981420,3671,1860,0,6816
1038,8,0,12,13,25008360,3671,1860,0,6824
1039,7,0,14,11,25023360,3670,1860,0,6831
1040,8,0,14,11,25060080,3671,1860,0,6839
1041,8,0,13,12,25081140,3670,1860,0,6847
1042,2,0,11,14,25097520,3670,1860,0,6849
1043,11,0,14,11,25128420,3670,1860,0,6860
1044,9,0,13,12,25160940,3669,1860,0,6869
1045,7,0,13,12,25192320,3670,1860,0,6876
1046,7,0,15,10,25218300,3671,1860,0,6883
1047,11,0,11,14,25263600,3670,1860,0,6894
1048,8,0,16,9,25279260,3671,1860,0,6902
1049,8,0,11,14,25319580,3670,1860,0,6910
1050,12,0,15,10,25350900,3670,1860,0,6922
1051,7,0,11,14,25374660,3667,1860,0,6929
1052,7,0,11,14,25400160,3667,1860,0,6936
1053,8,0,14,11,25416540,3667,1860,0,6944
1054,4,0,13,12,25428960,3666,1860,0,6948
1055,3,0,7,18,25477980,3669,1860,0,6951
1056,5,0,9,16,25484700,3668,1860,0,6956
1057,9,0,11,14,25499340,3666,1860,0,6965
1058,5,0,9,16,25521720,3666,1860,0,6970
1059,2,0,8,17,25538100,3667,1860,0,6972
1060,4,0,9,16,25547220,3666,1860,0,6976
1061,7,0,14,11,25557720,3667,1860,0,6983
1062,5,0,11,14,25583880,3666,1860,0,6988
1063,7,0,13,12,25598220,3666,1860,0,6995
1064,6,0,12,13,25628460,3666,1860,0,7001
1065,9,0,17,8,25654140,3668,1860,0,7010
1066,9,0,18,7,25678200,3667,1860,0,7019
1067,10,0,16,9,25732320,3669,1860,0,7029
1068,10,0,15,10,25793940,3672,1860,0,7039
1069,6,0,12,13,25823580,3671,1860,0,7045
1070,7,0,11,14,25851660,3671,1860,0,7052
1071,4,0,9,16,25874280,3671,1860,0,7056
1072,7,0,11,14,25882260,3670,1860,0,7063
1073,6,0,9,16,25908420,3669,1860,0,7069
1074,10,0,15,10,25918560,3669,1860,0,7079
1075,3,0,13,12,25937580,3669,1860,0,7082
1076,6,0,10,15,25984620,3671,1860,0,7088
1077,6,0,10,15,26001600,3670,1860,0,7094
1078,4,0,9,16,26023980,3671,1860,0,7098
1079,6,0,9,16,26055060,3672,1860,0,7104
1080,3,0,9,16,26062080,3671,1860,0,7107
1081,5,0,9,16,26080920,3671,1860,0,7112
1082,6,0,12,13,26084760,3670,1860,0,7118
1083,6,0,13,12,26113320,3672,1860,0,7124
1084,6,0,14,11,26130120,3672,1860,0,7130
1085,10,0,12,13,26165100,3670,1860,0,7140
1086,6,0,11,14,26202540,3672,1860,0,7146
1087,4,0,11,14,26220780,3672,1860,0,7150
1088,7,0,9,16,26245200,3671,1860,0,7157
1089,7,0,10,15,26261820,3670,1860,0,7164
1090,11,0,17,8,26272980,3670,1860,0,7175
1091,6,0,14,11,26303160,3670,1860,0,7181
1092,6,0,12,13,26331540,3669,1860,0,7187
1093,9,0,10,15,26364120,3668,1860,0,7196
1094,10,0,13,12,26373240,3666,1860,0,7206
1095,8,0,16,9,26396820,3667,1860,0,7214
1096,9,0,15,10,26447820,3669,1860,0,7223
1097,6,0,15,10,26478180,3670,1860,0,7229
1098,9,0,15,10,26518320,3671,1860,0,7238
1099,12,0,14,11,26567700,3671,1860,0,7250
1100,7,0,16,9,26582880,3671,1860,0,7257
1101,7,0,12,13,26629860,3672,1860,0,7264
1102,5,0,9,16,26670660,3673,1860,0,7269
1103,6,0,11,14,26688420,3674,1860,0,7275
1104,5,0,12,13,26710740,3675,1860,0,7280
1105,5,0,7,18,26744100,3674,1860,0,7285
1106,4,0,9,16,26750400,3674,1860,0,7289
1107,4,0,10,15,26765160,3675,1860,0,7293
1108,6,0,12,13,26781900,3675,1860,0,7299
1109,5,0,9,16,26800980,3673,1860,0,7304
1110,8,0,13,12,26819400,3674,1860,0,7312
1111,9,0,18,7,26826240,3673,1860,0,7321
1112,12,0,18,7,26863020,3672,1860,0,7333
1113,6,0,9,16,26933040,3674,1860,0,7339
1114,1,0,7,18,26949840,3675,1860,0,7340
1115,17,0,18,7,26956740,3673,1860,0,7357
1116,8,0,19,6,26984760,3673,1860,0,7365
1117,9,0,16,9,27048360,3676,1860,0,7374
1118,8,0,11,14,27087960,3674,1860,0,7382
1119,11,0,11,14,27121620,3674,1860,0,7393
1120,7,0,11,14,27143580,3673,1860,0,7400
1121,8,0,15,10,27158100,3673,1860,0,7408
1122,11,0,17,8,27184920,3672,1860,0,7419
1123,5,0,9,16,27244680,3674,1860,0,7424
1124,8,0,13,12,27253380,3673,1860,0,7432
1125,8,0,13,12,27282120,3673,1860,0,7440
1126,5,0,10,15,27311220,3673,1860,0,7445
1127,2,0,7,18,27325020,3672,1860,0,7447
1128,7,0,9,16,27348420,3673,1860,0,7454
1129,7,0,8,17,27361920,3671,1860,0,7461
1130,2,0,8,17,27370440,3671,1860,0,7463
1131,6,0,9,16,27384480,3670,1860,0,7469
1132,4,0,12,13,27385380,3670,1860,0,7473
1133,3,0,11,14,27403140,3670,1860,0,7476
1134,5,0,11,14,27426360,3671,1860,0,7481
1135,4,0,9,16,27458040,3672,1860,0,7485
1136,9,0,13,12,27469680,3671,1860,0,7494
1137,5,0,11,14,27488460,3671,1860,0,7499
1138,9,0,15,10,27513660,3671,1860,0,7508
1139,12,0,19,6,27540000,3671,1860,0,7520
1140,8,0,12,13,27600780,3672,1860,0,7528
1141,7,0,14,11,27618120,3672,1860,0,7535
1142,6,0,12,13,27650640,3672,1860,0,7541
1143,9,0,12,13,27681960,3672,1860,0,7550
1144,9,0,16,9,27691740,3671,1860,0,7559
1145,7,0,13,12,27732540,3671,1860,0,7566
1146,10,0,16,9,27752340,3670,1860,0,7576
1147,4,0,13,12,27782340,3671,1860,0,7580
1148,4,0,10,15,27821460,3673,1860,0,7584
1149,6,0,11,14,27840360,3673,1860,0,7590
1150,7,0,13,12,27853800,3672,1860,0,7597
1151,10,0,13,12,27899280,3673,1860,0,7607
1152,4,0,9,16,27914700,3672,1860,0,7611
1153,5,0,9,16,27934860,3672,1860,0,7616
1154,2,0,8,17,27949860,3672,1860,0,7618
1155,3,0,8,17,27963900,3673,1860,0,7621
1156,4,0,9,16,27968220,3672,1860,0,7625
1157,1,0,7,18,27987180,3673,1860,0,7626
1158,11,0,13,12,27993720,3671,1860,0,7637
1159,5,0,12,13,28013100,3671,1860,0,7642
1160,7,0,14,11,28037760,3672,1860,0,7649
1161,7,0,15,10,28062540,3672,1860,0,7656
1162,13,0,18,7,28086720,3670,1860,0,7669
1163,8,0,14,11,28128060,3670,1860,0,7677
1164,4,0,12,13,28168680,3673,1860,0,7681
1165,3,0,12,13,28185960,3673,1860,0,7684
1166,11,0,12,13,28229340,3674,1860,0,7695
1167,14,0,17,8,28245600,3672,1860,0,7709
1168,12,0,20,5,28287420,3673,1860,0,7721
1169,5,0,14,11,28334160,3674,1860,0,7726
1170,5,0,10,15,28381200,3675,1860,0,7731
1171,5,0,7,18,28406340,3675,1860,0,7736
1172,5,0,9,16,28415040,3674,1860,0,7741
1173,4,0,10,15,28425960,3674,1860,0,7745
1174,3,0,10,15,28433100,3674,1860,0,7748
1175,6,0,10,15,28452180,3674,1860,0,7754
1176,6,0,9,16,28471440,3673,1860,0,7760
1177,4,0,8,17,28497780,3674,1860,0,7764
1178,7,0,11,14,28518300,3675,1860,0,7771
1179,5,0,12,13,28533300,3675,1860,0,7776
1180,6,0,14,11,28545000,3674,1860,0,7782
1181,3,0,9,16,28575420,3674,1860,0,7785
1182,8,0,14,11,28598820,3676,1860,0,7793
1183,7,0,14,11,28630380,3677,1860,0,7800
1184,8,0,15,10,28656660,3677,1860,0,7808
1185,9,0,14,11,28690980,3676,1860,0,7817
1186,11,0,15,10,28729440,3677,1860,0,7828
1187,6,0,14,11,28752660,3676,1860,0,7834
1188,7,0,12,13,28788420,3677,1860,0,7841
1189,13,0,18,7,28813320,3677,1860,0,7854
1190,9,0,12,13,28860660,3676,1860,0,7863
1191,4,0,9,16,28887780,3676,1860,0,7867
1192,10,0,13,12,28899060,3674,1860,0,7877
1193,11,1,20,5,28906080,3674,2100,0,7888
1194,2,0,12,13,28964940,3676,2940,0,7890
1195,1,0,6,19,29008860,3678,2940,0,7891
1196,4,0,7,18,29015400,3678,2940,0,7895
1197,4,0,10,15,29020800,3678,2940,0,7899
1198,4,0,10,15,29033880,3678,2940,0,7903
1199,2,0,9,16,29046660,3678,2940,0,7905
1200,5,0,8,17,29064240,3678,2940,0,7910
1201,10,0,14,11,29072520,3677,2940,0,7920
1202,4,0,9,16,29102400,3676,2940,0,7924
1203,3,0,7,18,29122560,3677,2940,0,7927
1204,4,0,9,16,29129760,3677,2940,0,7931
1205,4,0,8,17,29141100,3676,2940,0,7935
1206,5,0,12,13,29142120,3675,2940,0,7940
1207,7,0,13,12,29163720,3675,2940,0,7947
1208,6,0,11,14,29195220,3676,2940,0,7953
1209,6,0,11,14,29220600,3676,2940,0,7959
1210,6,0,9,16,29249460,3676,2940,0,7965
1211,7,0,13,12,29254500,3675,2940,0,7972
1212,17,0,19,6,29288760,3674,2940,0,7989
1213,10,0,15,10,29330640,3673,2940,0,7999
1214,15,0,18,7,29370600,3673,2940,0,8014
1215,7,0,14,11,29418240,3674,2940,0,8021
1216,8,0,13,12,29450400,3673,2940,0,8029
1217,13,0,16,9,29489820,3674,2940,0,8042
1218,5,0,10,15,29516340,3672,2940,0,8047
1219,5,0,10,15,29533980,3672,2940,0,8052
1220,5,0,10,15,29556000,3672,2940,0,8057
1221,5,0,12,13,29566140,3672,2940,0,8062
1222,3,0,9,16,29586600,3672,2940,0,8065
1223,6,0,9,16,29608320,3672,2940,0,8071
1224,5,0,11,14,29619180,3672,2940,0,8076
1225,2,0,8,17,29640900,3672,2940,0,8078
1226,4,0,11,14,29651340,3673,2940,0,8082
1227,2,0,8,17,29672400,3674,2940,0,8084
1228,13,0,14,11,29692380,3673,2940,0,8097
1229,3,0,13,12,29709000,3673,2940,0,8100
1230,5,0,13,12,29742180,3675,2940,0,8105
1231,8,0,13,12,29780460,3676,2940,0,8113
1232,1,0,7,18,29816040,3677,2940,0,8114
1233,12,0,14,11,29831700,3677,2940,0,8126
1234,8,0,14,11,29845080,3675,2940,0,8134
1235,6,0,16,9,29869020,3676,2940,0,8140
1236,7,3,13,12,29896560,3676,3180,0,8147
1237,6,0,13,12,29942520,3678,8760,1,8153
1238,6,0,9,16,29990700,3679,8760,1,8159
1239,7,0,12,13,30006360,3679,8760,1,8166
1240,12,0,17,8,30024600,3679,8760,1,8178
1241,6,0,13,12,30061920,3679,8760,1,8184
1242,10,0,17,8,30089400,3679,8760,1,8194
1243,4,0,13,12,30120540,3679,8760,1,8198
1244,6,0,11,14,30150720,3680,8760,1,8204
1245,10,0,12,13,30182040,3679,8760,1,8214
1246,2,0,10,15,30192900,3679,8760,1,8216
1247,7,0,9,16,30226320,3679,8760,1,8223
1248,3,0,8,17,30238860,3679,8760,1,8226
1249,5,0,11,14,30242520,3679,8760,1,8231
1250,7,0,12,13,30263400,3678,8760,1,8238
1251,3,0,11,14,30282900,3679,8760,1,8241
1252,1,0,7,18,30307980,3680,8760,1,8242
1253,3,0,7,18,30319380,3680,8760,1,8245
1254,7,0,11,14,30327660,3680,8760,1,8252
1255,7,0,11,14,30351600,3679,8760,1,8259
1256,8,0,15,10,30359400,3679,8760,1,8267
1257,6,0,10,15,30402060,3679,8760,1,8273
1258,10,0,15,10,30413880,3678,8760,1,8283
1259,8,0,13,12,30450540,3678,8760,1,8291
1260,9,0,14,11,30481260,3678,8760,1,8300
1261,8,0,16,9,30503340,3678,8760,1,8308
1262,6,0,12,13,30541500,3678,8760,1,8314
1263,13,0,15,10,30576780,3678,8760,1,8327
1264,6,0,15,10,30598140,3678,8760,1,8333
1265,9,0,14,11,30641820,3679,8760,1,8342
1266,7,0,14,11,30666300,3679,8760,1,8349
1267,3,0,10,15,30697920,3679,8760,1,8352
1268,7,0,10,15,30724140,3679,8760,1,8359
1269,5,0,8,17,30748440,3679,8760,1,8364
1270,7,0,11,14,30761760,3679,8760,1,8371
1271,2,0,9,16,30771000,3678,8760,1,8373
1272,1,0,6,19,30790920,3679,8760,1,8374
1273,9,0,12,13,30792840,3678,8760,1,8383
1274,4,0,8,17,30819240,3678,8760,1,8387
1275,9,0,12,13,30836400,3678,8760,1,8396
1276,6,0,11,14,30856200,3677,8760,1,8402
1277,5,0,9,16,30876180,3676,8760,1,8407
1278,4,0,10,15,30887820,3676,8760,1,8411
1279,3,0,8,17,30903060,3676,8760,1,8414
1280,9,0,13,12,30910140,3675,8760,1,8423
1281,8,0,12,13,30938820,3674,8760,1,8431
1282,3,0,8,17,30957600,3674,8760,1,8434
1283,5,0,11,14,30970740,3674,8760,1,8439
1284,11,0,15,10,30990540,3674,8760,1,8450
1285,8,0,12,13,31030920,3674,8760,1,8458
1286,4,0,10,15,31055700,3674,8760,1,8462
1287,8,0,11,14,31085460,3674,8760,1,8470
1288,8,0,11,14,31106760,3673,8760,1,8478
1289,9,0,11,14,31122060,3671,8760,1,8487
1290,7,0,11,14,31139580,3670,8760,1,8494
1291,6,0,9,16,31168680,3670,8760,1,8500
1292,6,0,9,16,31182300,3669,8760,1,8506
1293,5,0,8,17,31204980,3669,8760,1,8511
1294,2,0,8,17,31210380,3669,8760,1,8513
1295,6,0,11,14,31224480,3670,8760,1,8519
1296,2,0,8,17,31239060,3669,8760,1,8521
1297,3,0,7,18,31257180,3669,8760,1,8524
1298,9,0,13,12,31265700,3669,8760,1,8533
1299,3,0,8,17,31290540,3669,8760,1,8536
1300,2,0,8,17,31294800,3668,8760,1,8538
1301,6,0,9,16,31311180,3668,8760,1,8544
1302,5,0,7,18,31339380,3668,8760,1,8549
1303,12,0,12,13,31347720,3666,8760,1,8561
1304,7,0,14,11,31371720,3667,8760,1,8568
1305,5,0,11,14,31396140,3666,8760,1,8573
1306,7,0,10,15,31417680,3666,8760,1,8580
1307,5,0,9,16,31436520,3665,8760,1,8585
1308,9,0,12,13,31449720,3664,8760,1,8594
1309,7,0,10,15,31472700,3663,8760,1,8601
1310,13,0,20,5,31487640,3663,8760,1,8614
1311,6,0,15,10,31522740,3663,8760,1,8620
1312,11,0,13,12,31567200,3662,8760,1,8631
1313,6,0,11,14,31596600,3662,8760,1,8637
1314,10,0,14,11,31626480,3663,8760,1,8647
1315,5,0,11,14,31649700,3662,8760,1,8652
1316,5,0,11,14,31670880,3663,8760,1,8657
1317,3,0,11,14,31681800,3663,8760,1,8660
1318,1,0,9,16,31698960,3663,8760,1,8661
1319,4,0,9,16,31716840,3664,8760,1,8665
1320,4,0,9,16,31727160,3663,8760,1,8669
1321,7,0,10,15,31757160,3664,8760,1,8676
1322,1,0,9,16,31767360,3664,8760,1,8677
1323,3,0,8,17,31791780,3666,8760,1,8680
1324,4,0,9,16,31800120,3665,8760,1,8684
1325,7,0,12,13,31807860,3664,8760,1,8691
1326,8,0,15,10,31829580,3665,8760,1,8699
1327,2,0,7,18,31864620,3665,8760,1,8701
1328,9,0,13,12,31869180,3664,8760,1,8710
1329,7,0,13,12,31883280,3663,8760,1,8717
1330,8,0,12,13,31920900,3663,8760,1,8725
1331,8,0,16,9,31938060,3663,8760,1,8733
1332,8,0,14,11,31982040,3664,8760,1,8741
1333,9,0,16,9,32010360,3665,8760,1,8750
1334,8,0,14,11,32055240,3665,8760,1,8758
1335,15,0,18,7,32086620,3664,8760,0,8773
1336,8,0,17,8,32132280,3666,8760,0,8781
1337,9,0,14,11,32173920,3666,8760,0,8790
1338,8,0,11,14,32228700,3667,8760,0,8798
1339,5,0,10,15,32253060,3668,8760,0,8803
1340,7,0,13,12,32270100,3668,8760,0,8810
1341,9,0,16,9,32281620,3667,8760,0,8819
1342,9,0,14,11,32336400,3668,8760,0,8828
1343,6,0,12,13,32364300,3668,8760,0,8834
1344,3,0,8,17,32389740,3668,8760,0,8837
1345,5,0,12,13,32390760,3668,8760,0,8842
1346,8,0,13,12,32401620,3666,8760,0,8850
1347,8,0,14,11,32429880,3666,8760,0,8858
1348,4,0,11,14,32455500,3666,8760,0,8862
1349,12,0,17,8,32471160,3666,8760,0,8874
1350,6,0,15,10,32495640,3665,8760,0,8880
1351,8,0,14,11,32533440,3666,8760,0,8888
1352,7,0,13,12,32553180,3665,8760,0,8895
1353,6,0,13,12,32584380,3666,8760,0,8901
1354,8,0,14,11,32605740,3665,8760,0,8909
1355,10,0,17,8,32627640,3665,8760,0,8919
1356,14,0,22,3,32666400,3665,8760,0,8933
1357,10,0,16,9,32713020,3664,8880,0,8943
1358,9,0,13,12,32767200,3665,8880,0,8952
1359,14,0,18,7,32795160,3665,8880,0,8966
1360,9,0,17,8,32823780,3664,8880,0,8975
1361,8,0,14,11,32864580,3664,8880,0,8983
1362,7,0,14,11,32893620,3664,8880,0,8990
1363,6,0,13,12,32917200,3664,8880,0,8996
1364,3,0,10,15,32933400,3663,8880,0,8999
1365,7,0,10,15,32965680,3664,8880,0,9006
1366,4,0,11,14,32973540,3664,8880,0,9010
1368,5,0,8,17,32995920,3663,8880,0,9015
1367,0,0,8,17,32995920,3663,8880,0,9015
1369,3,0,9,16,33005760,3663,8880,0,9018
1370,5,0,12,13,33006900,3662,8880,0,9023
1371,4,0,10,15,33024960,3662,8880,0,9027
1372,4,0,10,15,33038220,3662,8880,0,9031
1373,7,0,14,11,33042840,3661,8880,0,9038
1374,5,0,12,13,33073980,3662,8880,0,9043
1375,5,0,9,16,33097080,3661,8880,0,9048
1376,4,0,13,12,33097080,3661,8880,0,9052
1377,9,0,17,8,33116700,3661,8880,0,9061
1378,6,0,11,14,33153720,3660,8880,0,9067
1379,4,0,11,14,33165420,3660,8880,0,9071
1380,7,0,15,10,33173220,3660,8880,0,9078
1381,10,0,15,10,33209940,3660,8880,0,9088
1382,5,0,15,10,33217200,3659,8880,0,9093
1383,9,0,13,12,33248820,3658,8880,0,9102
1384,5,0,11,14,33278760,3658,8880,0,9107
1385,7,0,14,11,33293220,3658,8880,0,9114
1386,7,0,11,14,33329340,3658,8880,0,9121
1387,10,0,15,10,33345720,3657,8880,0,9131
1388,5,0,11,14,33373020,3657,8880,0,9136
1389,6,0,10,15,33397860,3657,8880,0,9142
1390,7,0,13,12,33404820,3656,8880,0,9149
1391,6,0,11,14,33429360,3655,8880,0,9155
1392,1,0,9,16,33443160,3656,8880,0,9156
1393,7,0,13,12,33460500,3656,8880,0,9163
1394,6,0,12,13,33480060,3656,8880,0,9169
1395,2,0,11,14,33494160,3656,8880,0,9171
1396,10,0,14,11,33506580,3655,8880,0,9181
1397,3,0,11,14,33535680,3655,8880,0,9184
1398,7,0,13,12,33550560,3655,8880,0,9191
1399,7,0,15,10,33565920,3655,8880,0,9198
1400,8,0,17,8,33590280,3655,8880,0,9206
1401,7,0,16,9,33620580,3655,8880,0,9213
1402,9,0,18,7,33653040,3656,8880,0,9222
1403,8,0,13,12,33693420,3655,8880,0,9230
1404,15,0,20,5,33709980,3654,8880,0,9245
1405,10,0,17,8,33754440,3653,8880,0,9255
1406,6,0,16,9,33777960,3653,8880,0,9261
1407,12,0,17,8,33825360,3654,8880,0,9273
1408,10,0,16,9,33867660,3654,8880,0,9283
1409,7,0,15,10,33901500,3655,8880,0,9290
1410,8,0,14,11,33937440,3655,8880,0,9298
1411,7,0,17,8,33956460,3655,8880,0,9305
1412,2,0,10,15,33998820,3656,8880,0,9307
1413,9,0,13,12,34022040,3657,8880,0,9316
1414,7,0,14,11,34033920,3656,8880,0,9323
1415,4,0,14,11,34057860,3657,8880,0,9327
1416,1,0,12,13,34070580,3657,8880,0,9328
1417,5,0,12,13,34096140,3657,8880,0,9333
1418,5,0,13,12,34108560,3657,8880,0,9338
1419,5,0,12,13,34139160,3658,8880,0,9343
1420,4,0,13,12,34153500,3659,8880,0,9347
1421,5,0,11,14,34177200,3658,8880,0,9352
1422,6,0,13,12,34189260,3658,8880,0,9358
1423,6,0,14,11,34203660,3658,8880,0,9364
1424,5,0,14,11,34222920,3658,8880,0,9369
1425,6,0,12,13,34249440,3657,8880,0,9375
1426,13,0,18,7,34269960,3657,8880,0,9388
1427,4,0,13,12,34306560,3657,8880,0,9392
1428,4,0,13,12,34325460,3658,8880,0,9396
1429,5,0,13,12,34352520,3659,8880,0,9401
1430,8,0,14,11,34374780,3658,8880,0,9409
1431,8,0,16,9,34390740,3658,8880,0,9417
1432,9,0,17,8,34427160,3658,8880,0,9426
1433,2,0,10,15,34480080,3661,8880,0,9428
1434,5,0,13,12,34492440,3661,8880,0,9433
1435,11,2,18,7,34500120,3660,9180,0,9444
1436,3,3,15,10,34528080,3661,12840,1,9447
1437,6,0,15,10,34573800,3663,22800,2,9453
1438,10,0,15,10,34605360,3662,22800,2,9463
1439,0,0,11,14,34621920,3662,22800,2,9463
1440,3,0,11,14,34642380,3663,22800,2,9466
1441,5,0,13,12,34648260,3663,22800,2,9471
1442,3,0,13,12,34662060,3663,22800,2,9474
1443,3,0,10,15,34707720,3666,22800,2,9477
1444,2,0,10,15,34714320,3666,22800,2,9479
1445,5,0,12,13,34724940,3666,22800,2,9484
1446,9,0,14,11,34741740,3665,22800,2,9493
1447,7,0,14,11,34775760,3666,22800,2,9500
1448,7,0,18,7,34792500,3666,22800,2,9507
1449,11,0,19,6,34842660,3668,22800,2,9518
1450,8,0,23,2,34859220,3668,22800,2,9526
1451,10,0,18,7,34927440,3669,22800,2,9536
1452,11,0,18,7,34970040,3669,22800,2,9547
1453,9,0,15,10,35008200,3669,22800,2,9556
1454,10,0,17,8,35029680,3668,22800,2,9566
1455,12,0,17,8,35074680,3668,22800,2,9578
1456,5,0,13,12,35099820,3667,22800,2,9583
1457,9,0,16,9,35124780,3668,22800,2,9592
1458,4,0,12,13,35143800,3666,22800,2,9596
1459,16,0,18,7,35169480,3665,22800,2,9612
1460,8,0,17,8,35191920,3664,22800,2,9620
1461,6,0,13,12,35233080,3665,22800,2,9626
1462,7,0,13,12,35264940,3665,22800,2,9633
1463,6,0,12,13,35287620,3665,22800,2,9639
1464,6,0,13,12,35306460,3665,22800,2,9645
1465,7,0,15,10,35326140,3665,22800,2,9652
1466,8,0,17,8,35357520,3666,24360,2,9660
1467,4,0,13,12,35393580,3667,24360,2,9664
1468,3,0,11,14,35418120,3667,24360,2,9667
1469,4,0,12,13,35440380,3669,24360,2,9671
1470,4,0,11,14,35448600,3668,24360,2,9675
1471,4,0,9,16,35477280,3668,24360,2,9679
1472,6,0,12,13,35479740,3667,24360,2,9685
1473,5,0,10,15,35504700,3667,24360,2,9690
1474,10,0,15,10,35520540,3667,24360,2,9700
1475,13,0,20,5,35545260,3667,24360,2,9713
1476,5,0,17,8,35576100,3667,24360,2,9718
1477,4,0,12,13,35621340,3668,24360,2,9722
1478,5,0,9,16,35647620,3668,24360,2,9727
1479,6,0,12,13,35653500,3667,24360,2,9733
1480,6,0,15,10,35659380,3667,24360,2,9739
1481,10,0,18,7,35682120,3666,24360,2,9749
1482,9,0,19,6,35712360,3666,24360,2,9758
1483,2,0,11,14,35754660,3667,24360,2,9760
1484,0,0,8,17,35774400,3668,24360,2,9760
1485,9,0,10,15,35787180,3667,24360,2,9769
1486,4,0,14,11,35787180,3667,24360,2,9773
1487,5,0,12,13,35817780,3667,24360,2,9778
1488,3,0,11,14,35827980,3667,24360,2,9781
1489,7,0,10,15,35852400,3666,24360,2,9788
1490,7,0,14,11,35860020,3666,24360,2,9795
1491,3,0,13,12,35868180,3665,24360,2,9798
1492,4,0,9,16,35911080,3667,24360,2,9802
1493,2,0,10,15,35914800,3667,24360,2,9804
1494,5,0,11,14,35937000,3667,24360,2,9809
1495,6,0,16,9,35940240,3667,24360,2,9815
1496,7,0,16,9,35968200,3667,24360,2,9822
1497,9,0,14,11,36018420,3668,24360,2,9831
1498,4,0,15,10,36033060,3669,24360,2,9835
1499,5,0,12,13,36075720,3670,24360,2,9840
1500,14,0,20,5,36083160,3669,24360,2,9854
1501,7,0,14,11,36119400,3668,24360,2,9861
1502,11,0,18,7,36134700,3667,24360,2,9872
1503,9,0,18,7,36179220,3668,24360,2,9881
1504,12,0,19,6,36224820,3668,24360,2,9893
1505,13,6,20,5,36252000,3669,27240,2,9906
1506,1,0,14,11,36316620,3670,42600,4,9907
1507,7,0,12,13,36349140,3670,42600,4,9914
1508,5,0,11,14,36372180,3670,42600,4,9919
1509,5,0,10,15,36398400,3671,42600,4,9924
1510,5,0,12,13,36405120,3670,42600,4,9929
1511,4,0,11,14,36427440,3671,42600,4,9933
1512,3,0,8,17,36449820,3671,42600,4,9936
1513,3,0,10,15,36452820,3671,42600,4,9939
1514,5,0,14,11,36456600,3671,42600,4,9944
1515,5,0,10,15,36486900,3671,42600,4,9949
1516,8,0,12,13,36498900,3670,42600,4,9957
1517,5,0,11,14,36517740,3669,42600,4,9962
1518,6,0,12,13,36531960,3669,42600,4,9968
1519,3,0,12,13,36544920,3669,42600,4,9971
1520,5,0,13,12,36557760,3669,42600,4,9976
1521,4,0,14,11,36570060,3669,42600,4,9980
1522,4,0,14,11,36592440,3670,42600,4,9984
1523,12,0,20,5,36620280,3670,42600,4,9996
1524,7,0,15,10,36656340,3670,42600,4,10003
1525,4,0,11,14,36698340,3671,42600,4,10007
1526,8,0,13,12,36709680,3670,42600,4,10015
1527,6,0,11,14,36739020,3670,42600,4,10021
1528,3,0,8,17,36755400,3669,42600,4,10024
1529,6,0,11,14,36760440,3669,42600,4,10030
1530,11,0,18,7,36772560,3668,42600,4,10041
1531,4,0,13,12,36800340,3668,42600,4,10045
1532,7,0,15,10,36823560,3668,42600,4,10052
1533,4,0,11,14,36853500,3668,42600,4,10056
1534,4,0,11,14,36869400,3668,42600,4,10060
1535,7,0,13,12,36885840,3668,42600,4,10067
1536,9,0,15,10,36902580,3667,42600,4,10076
1537,8,0,15,10,36937380,3668,42600,4,10084
1538,6,0,14,11,36967860,3668,42600,4,10090
1539,5,0,14,11,36991200,3669,42600,4,10095
1540,8,0,16,9,37010460,3669,42600,4,10103
1541,6,0,13,12,37043100,3669,42600,4,10109
1542,9,0,12,13,37070700,3668,42600,4,10118
1543,4,0,10,15,37090140,3667,42600,4,10122
1544,7,0,14,11,37094940,3667,42600,4,10129
1545,7,0,15,10,37113240,3666,42600,4,10136
1546,9,0,18,7,37138200,3667,42600,4,10145
1547,5,0,16,9,37168860,3667,42600,4,10150
1548,17,0,20,5,37213980,3667,42600,4,10167
1549,3,0,16,9,37243200,3667,42600,4,10170
1550,6,0,12,13,37297140,3669,42600,4,10176
1551,11,0,16,9,37315140,3668,42600,4,10187
1552,9,0,19,6,37336140,3668,42600,4,10196
1553,11,0,21,4,37371240,3668,42600,4,10207
1554,6,0,15,10,37425360,3669,42600,4,10213
1555,4,0,16,9,37438620,3670,42600,4,10217
1556,8,0,15,10,37474920,3670,42600,4,10225
1557,6,0,11,14,37515060,3670,42600,4,10231
1558,6,0,12,13,37529940,3670,42600,4,10237
1559,9,0,16,9,37540740,3669,42600,4,10246
1560,3,0,12,13,37566600,3669,42600,4,10249
1561,7,0,12,13,37603020,3670,42600,4,10256
1562,4,0,9,16,37625100,3670,42600,4,10260
1563,5,0,11,14,37635780,3670,42600,4,10265
1564,7,0,13,12,37647420,3669,42600,4,10272
1565,2,0,11,14,37671960,3670,42600,4,10274
1566,7,0,14,11,37686960,3670,42600,4,10281
1567,5,0,14,11,37716420,3671,42600,4,10286
1568,3,0,11,14,37739880,3671,42600,4,10289
1569,6,0,11,14,37762080,3671,42600,4,10295
1570,10,0,13,12,37770840,3669,42600,4,10305
1571,6,0,15,10,37792140,3670,42600,4,10311
1572,9,0,18,7,37808340,3670,42600,4,10320
1573,13,0,20,5,37855800,3670,42600,4,10333
1574,12,0,18,7,37900920,3670,42600,4,10345
1575,5,0,16,9,37924440,3669,42600,4,10350
1576,11,0,15,10,37967040,3669,42600,4,10361
1577,6,0,15,10,37992240,3670,42600,4,10367
1578,11,0,14,11,38030940,3669,42600,4,10378
1579,6,0,14,11,38051760,3669,42600,4,10384
1580,5,0,14,11,38072100,3669,42600,4,10389
1581,5,0,11,14,38102760,3669,42600,4,10394
1582,7,0,14,11,38111880,3669,42600,4,10401
1583,8,0,15,10,38140740,3669,42600,4,10409
1584,1,0,8,17,38176020,3670,42600,4,10410
1585,5,0,10,15,38182140,3669,42600,4,10415
1586,4,0,13,12,38183040,3669,42600,4,10419
1587,4,0,10,15,38206080,3669,42600,4,10423
1588,4,0,9,16,38223780,3669,42600,4,10427
1589,8,0,13,12,38231820,3668,42600,4,10435
1590,4,0,12,13,38244000,3667,42600,4,10439
1591,5,0,11,14,38260860,3667,42600,4,10444
1592,7,0,12,13,38276040,3666,42600,4,10451
1593,7,0,13,12,38289300,3665,42600,4,10458
1594,8,0,15,10,38307660,3665,42600,4,10466
1595,7,0,13,12,38335860,3664,42600,4,10473
1596,4,0,11,14,38363160,3665,42600,4,10477
1597,5,0,9,16,38387280,3665,42600,4,10482
1598,10,0,16,9,38390520,3664,42600,4,10492
1599,6,0,14,11,38416440,3664,42600,4,10498
1600,6,0,13,12,38442600,3664,42600,4,10504
1601,6,0,15,10,38462160,3664,42600,4,10510
1602,5,0,16,9,38480520,3665,42600,4,10515
1603,6,0,17,8,38508900,3666,42600,4,10521
1604,4,0,14,11,38544300,3667,42600,4,10525
1605,4,0,11,14,38585580,3668,42600,4,10529
1606,5,0,10,15,38598780,3667,42600,4,10534
1607,4,0,10,15,38610600,3667,42600,4,10538
1608,4,0,9,16,38626560,3667,42600,4,10542
1609,7,0,12,13,38637240,3666,42600,4,10549
1610,4,0,13,12,38650320,3667,42600,4,10553
1611,5,0,16,9,38667480,3667,42600,4,10558
1612,7,0,14,11,38700120,3667,42600,4,10565
1613,2,0,12,13,38726940,3669,42600,4,10567
1614,6,0,11,14,38752320,3669,42600,4,10573
1615,3,0,12,13,38763720,3669,42600,4,10576
1616,3,0,9,16,38780460,3668,42600,4,10579
1617,8,0,15,10,38793420,3669,42600,4,10587
1618,13,0,19,6,38816160,3668,42600,4,10600
1619,9,0,19,6,38847660,3668,42600,4,10609
1620,11,0,18,7,38889780,3668,42600,4,10620
1621,11,0,17,8,38930580,3667,42600,4,10631
1622,12,0,15,10,38986440,3668,42600,4,10643
1623,9,0,17,8,39009600,3668,42600,3,10652
1624,10,0,18,7,39037980,3667,42600,3,10662
1625,5,0,13,12,39083700,3668,42600,3,10667
1626,5,0,13,12,39097020,3667,42600,3,10672
1627,7,0,11,14,39130200,3667,42600,3,10679
1628,6,0,13,12,39141120,3667,42600,3,10685
1629,9,0,14,11,39168180,3667,42600,3,10694
1630,6,0,14,11,39185640,3667,42600,3,10700
1631,7,0,13,12,39212700,3666,42600,3,10707
1632,7,0,15,10,39231420,3666,42600,3,10714
1633,7,0,13,12,39265440,3666,42600,3,10721
1634,4,0,14,11,39280680,3667,42600,3,10725
1635,8,0,13,12,39314940,3667,42600,3,10733
1636,5,0,12,13,39338520,3667,42600,3,10738
1637,4,0,12,13,39345720,3666,42600,3,10742
1638,5,0,13,12,39363300,3667,42600,3,10747
1639,6,0,15,10,39373860,3666,42600,3,10753
1640,12,0,18,7,39409800,3667,42600,3,10765
1641,12,0,17,8,39454440,3666,42600,3,10777
1642,8,0,18,7,39479820,3666,42600,3,10785
1643,11,0,20,5,39526020,3667,42600,3,10796
1644,5,0,13,12,39567060,3667,42600,3,10801
1645,16,0,23,2,39590940,3667,42600,3,10817
1646,7,0,16,9,39640140,3667,42600,3,10824
1647,12,0,17,8,39694620,3668,42600,3,10836
1648,7,0,17,8,39707520,3667,42600,3,10843
1649,6,0,10,15,39761820,3668,42600,3,10849
1650,7,0,13,12,39770220,3667,42600,3,10856
1651,6,0,12,13,39788580,3667,42600,3,10862
1652,7,0,13,12,39813720,3667,42600,3,10869
1653,3,0,11,14,39830520,3667,42600,3,10872
1654,7,0,14,11,39840240,3666,42600,3,10879
1655,7,0,15,10,39867720,3667,42600,3,10886
1656,5,0,10,15,39909420,3667,42600,3,10891
1657,4,0,12,13,39919020,3668,42600,3,10895
1658,3,0,11,14,39940140,3668,42600,3,10898
1659,3,0,8,17,39961200,3668,42600,3,10901
1660,6,0,11,14,39963780,3667,42600,3,10907
1661,7,0,14,11,39976860,3667,42600,3,10914
1662,10,0,16,9,40001100,3667,42600,3,10924
1663,3,0,12,13,40026720,3667,42600,3,10927
1664,9,0,16,9,40045500,3667,42600,3,10936
1665,2,0,12,13,40075620,3667,42600,3,10938
1666,8,0,19,6,40079760,3667,42600,3,10946
1667,11,0,18,7,40119060,3667,42600,3,10957
1668,6,0,12,13,40171080,3668,42600,3,10963
1669,12,0,19,6,40184700,3667,42600,3,10975
1670,8,0,16,9,40221600,3667,42600,3,10983
1671,11,0,17,8,40250460,3666,42600,3,10994
1672,6,0,16,9,40290120,3668,42600,3,11000
1673,6,0,16,9,40316820,3668,42600,3,11006
1674,5,0,15,10,40354080,3669,42600,3,11011
1675,5,0,14,11,40377420,3670,42600,3,11016
1676,8,0,15,10,40404120,3670,42600,3,11024
1677,3,0,12,13,40432740,3670,42600,3,11027
1678,3,0,8,17,40461840,3671,42600,3,11030
1679,3,0,10,15,40462740,3670,42600,3,11033
1680,1,0,10,15,40469280,3671,42600,3,11034
1681,6,0,11,14,40489920,3671,42600,3,11040
1682,5,0,11,14,40497540,3670,42600,3,11045
1683,3,0,11,14,40504980,3669,42600,3,11048
1684,4,0,11,14,40516140,3669,42600,3,11052
1685,6,0,12,13,40538760,3669,42600,3,11058
1686,5,0,14,11,40546260,3669,42600,3,11063
1687,4,0,10,15,40576920,3669,42600,3,11067
1688,9,0,13,12,40590420,3669,42600,3,11076
1689,5,0,10,15,40611420,3668,42600,3,11081
1690,5,0,12,13,40618080,3667,42600,3,11086
1691,7,0,13,12,40641660,3668,42600,3,11093
1692,5,0,12,13,40656120,3667,42600,3,11098
1693,8,0,16,9,40661100,3666,42600,3,11106
1694,2,0,10,15,40703340,3667,42600,3,11108
1695,6,0,14,11,40717980,3668,42600,3,11114
1696,7,0,17,8,40735260,3668,42600,3,11121
1697,12,0,19,6,40768080,3668,42600,3,11133
1698,10,0,14,11,40810980,3667,42600,3,11143
1699,2,0,11,14,40837920,3667,42600,3,11145
1700,8,0,13,12,40862820,3668,42600,3,11153
1701,6,0,13,12,40884180,3668,42600,3,11159
1702,4,0,10,15,40913400,3668,42600,3,11163
1703,4,0,12,13,40924140,3668,42600,3,11167
1704,3,0,11,14,40944840,3669,42600,3,11170
1705,7,0,12,13,40964940,3669,42600,3,11177
1706,4,0,11,14,40978440,3668,42600,3,11181
1707,5,0,10,15,40997400,3668,42600,3,11186
1708,4,0,9,16,41014920,3668,42600,3,11190
1709,7,0,15,10,41021700,3668,42600,3,11197
1710,4,0,16,9,41039040,3669,42600,3,11201
1711,5,0,11,14,41082360,3669,42600,3,11206
1712,7,0,12,13,41092560,3668,42600,3,11213
1713,11,0,18,7,41106660,3668,42600,3,11224
1714,10,0,14,11,41152140,3667,42600,3,11234
1715,6,0,10,15,41172840,3666,42600,3,11240
1716,6,0,11,14,41191380,3666,42600,3,11246
1717,11,0,14,11,41209860,3665,42600,3,11257
1718,3,0,11,14,41220780,3664,42600,3,11260
1719,13,0,16,9,41249220,3664,42600,3,11273
1720,6,0,17,8,41259360,3663,42600,3,11279
1721,4,0,10,15,41306040,3664,42600,3,11283
1722,11,0,14,11,41320440,3663,42600,3,11294
1723,5,0,12,13,41360280,3664,42600,3,11299
1724,9,0,16,9,41374200,3664,42600,3,11308
1725,7,0,18,7,41393220,3664,42600,3,11315
1726,4,0,14,11,41432040,3664,42600,3,11319
1727,12,0,17,8,41470020,3665,42600,3,11331
1728,0,0,12,13,41494260,3665,42600,3,11331
1729,3,0,10,15,41528340,3667,42600,3,11334
1730,6,0,12,13,41533920,3666,42600,3,11340
1731,2,0,10,15,41548800,3666,42600,3,11342
1732,5,0,11,14,41559360,3666,42600,3,11347
1733,6,0,12,13,41568900,3665,42600,3,11353
1734,4,0,12,13,41591940,3666,42600,3,11357
1735,5,0,13,12,41612520,3666,42600,3,11362
1736,4,0,10,15,41636040,3666,42600,3,11366
1737,6,0,12,13,41652180,3666,42600,3,11372
1738,10,0,17,8,41664840,3666,42600,3,11382
1739,11,0,17,8,41690820,3664,42600,3,11393
1740,12,0,15,10,41736720,3664,42600,3,11405
1741,9,0,15,10,41762280,3663,42600,3,11414
1742,11,0,19,6,41791680,3664,42600,3,11425
1743,8,0,16,9,41833500,3664,42600,3,11433
1744,10,0,16,9,41867760,3663,42600,3,11443
1745,6,0,14,11,41898480,3664,42600,3,11449
1746,8,0,15,10,41923920,3664,42600,3,11457
1747,7,0,15,10,41954700,3664,42600,3,11464
1748,8,0,15,10,41985240,3664,42600,3,11472
1749,6,0,14,11,42004440,3664,42600,3,11478
1750,1,0,10,15,42028320,3664,42600,3,11479
1751,3,0,9,16,42045300,3664,42600,3,11482
1752,2,0,8,17,42061680,3665,42600,3,11484
1753,3,0,9,16,42063540,3664,42600,3,11487
1754,3,0,10,15,42073020,3664,42600,3,11490
1755,6,0,11,14,42082440,3664,42600,3,11496
1756,5,0,13,12,42089040,3663,42600,3,11501
1757,4,0,12,13,42120540,3664,42600,3,11505
1758,7,0,15,10,42129420,3664,42600,3,11512
1759,7,0,13,12,42157620,3663,42600,3,11519
1760,8,0,16,9,42181800,3664,42600,3,11527
1761,6,0,14,11,42212940,3664,42600,3,11533
1762,11,0,18,7,42241920,3664,42600,3,11544
1763,9,0,20,5,42267720,3664,42600,3,11553
1764,10,0,16,9,42328380,3665,42600,3,11563
1765,16,0,22,3,42368220,3666,42720,3,11579
1766,8,0,18,7,42406680,3665,42720,3,11587
1767,7,0,11,14,42477780,3667,42720,3,11594
1768,11,0,16,9,42486360,3666,42720,3,11605
1769,9,0,13,12,42520800,3665,42720,3,11614
1770,5,0,14,11,42536940,3665,42720,3,11619
1771,8,0,12,13,42567180,3664,42720,3,11627
1772,5,0,13,12,42584460,3665,42720,3,11632
1773,6,0,12,13,42614940,3665,42720,3,11638
1774,4,0,9,16,42633900,3664,42720,3,11642
1775,4,0,13,12,42633900,3664,42720,3,11646
1776,6,0,14,11,42659940,3665,42720,3,11652
1777,9,0,16,9,42686040,3665,42720,3,11661
1778,3,0,12,13,42705360,3665,42720,3,11664
1779,7,0,11,14,42730980,3664,42720,3,11671
1780,3,0,12,13,42738900,3664,42720,3,11674
1781,3,0,11,14,42751560,3664,42720,3,11677
1782,4,0,13,12,42766140,3665,42720,3,11681
1783,11,0,18,7,42787620,3665,42720,3,11692
1784,7,0,20,5,42813540,3665,44040,3,11699
1785,7,0,18,7,42851580,3666,44040,3,11706
1786,7,0,13,12,42913380,3667,44040,3,11713
1787,7,0,13,12,42925440,3666,44040,3,11720
1788,13,0,15,10,42959160,3666,44040,3,11733
1789,8,0,17,8,42977760,3665,44040,3,11741
1790,6,0,13,12,43015080,3665,44040,3,11747
1791,9,0,14,11,43032600,3664,44040,3,11756
1792,8,0,13,12,43062660,3664,44040,3,11764
1793,4,0,12,13,43077120,3664,44040,3,11768
1794,8,0,13,12,43099080,3663,44040,3,11776
1795,8,0,17,8,43107720,3663,44040,3,11784
1796,2,0,12,13,43137780,3663,44040,3,11786
1797,2,0,10,15,43158540,3664,44040,3,11788
1798,6,0,11,14,43182960,3664,44040,3,11794
1799,5,0,8,17,43204560,3664,44040,3,11799
1800,5,0,12,13,43207560,3664,44040,3,11804
1801,5,0,12,13,43218180,3663,44040,3,11809
1802,2,0,11,14,43233780,3663,44040,3,11811
1803,5,0,9,16,43258980,3663,44040,3,11816
1804,2,0,9,16,43265280,3663,44040,3,11818
1805,7,0,11,14,43279380,3663,44040,3,11825
1806,4,0,11,14,43283700,3662,44040,3,11829
1807,6,0,12,13,43301940,3662,44040,3,11835
1808,7,0,15,10,43312440,3662,44040,3,11842
1809,4,0,12,13,43339200,3662,44040,3,11846
1810,6,0,16,9,43349820,3662,44040,3,11852
1811,10,0,16,9,43385100,3662,44040,3,11862
1812,10,0,12,13,43423920,3661,44040,3,11872
1813,11,0,15,10,43441080,3660,44040,3,11883
1814,6,0,15,10,43460580,3660,44040,3,11889
1815,9,0,17,8,43488840,3660,44040,3,11898
1816,9,0,17,8,43515120,3659,44040,3,11907
1817,6,0,12,13,43561020,3660,44040,3,11913
1818,6,0,11,14,43587960,3660,44040,3,11919
1819,9,0,12,13,43603500,3659,44040,3,11928
1820,6,0,15,10,43615200,3659,44040,3,11934
1821,5,0,14,11,43644960,3659,44040,3,11939
1822,8,0,16,9,43674540,3660,44040,3,11947
1823,7,0,15,10,43706460,3660,44040,3,11954
1824,10,0,14,11,43739040,3660,44040,3,11964
1825,3,0,10,15,43768440,3660,44040,3,11967
1826,3,0,9,16,43774080,3659,44040,3,11970
1827,3,0,10,15,43793520,3660,44040,3,11973
1828,5,0,9,16,43809300,3660,44040,3,11978
1829,7,0,11,14,43817700,3659,44040,3,11985
1830,7,0,15,10,43825260,3659,44040,3,11992
1831,11,0,18,7,43850100,3658,44040,3,12003
1832,8,0,19,6,43880940,3659,44040,3,12011
1833,8,0,17,8,43932840,3660,44040,3,12019
1834,8,0,14,11,43977660,3660,44040,3,12027
1835,9,2,17,8,43998000,3661,44340,3,12036
1836,9,8,18,7,44007780,3661,47160,3,12045
1837,5,0,22,3,44065020,3663,72840,6,12050
1838,8,0,14,11,44117220,3663,72840,6,12058
1839,6,0,15,10,44137080,3663,72840,6,12064
1840,10,0,18,7,44158980,3662,72840,6,12074
1841,5,0,13,12,44198400,3663,72840,6,12079
1842,7,0,12,13,44222940,3662,72840,6,12086
1843,12,0,18,7,44234220,3661,72840,6,12098
1844,3,0,12,13,44277720,3662,72840,6,12101
1845,8,0,12,13,44306520,3662,72840,6,12109
1846,5,0,13,12,44325960,3662,72840,6,12114
1847,3,0,12,13,44340000,3662,72840,6,12117
1848,5,0,10,15,44361360,3662,72840,6,12122
1849,6,0,14,11,44370480,3662,72840,6,12128
1850,8,0,15,10,44392320,3662,72840,6,12136
1851,1,0,9,16,44414460,3662,72840,6,12137
1852,4,0,10,15,44426100,3662,72840,5,12141
1853,10,0,14,11,44434320,3661,72840,5,12151
1854,3,0,11,14,44454240,3660,72840,5,12154
1855,4,0,11,14,44475480,3661,72840,5,12158
1856,13,0,17,8,44488440,3660,72840,5,12171
1857,11,0,20,5,44505360,3659,72840,5,12182
1858,4,0,12,13,44559360,3660,72840,5,12186
1859,8,0,13,12,44588880,3660,72840,5,12194
1860,7,0,16,9,44601600,3660,72840,5,12201
1861,8,0,16,9,44640900,3661,72840,5,12209
1862,12,0,19,6,44675340,3661,72840,5,12221
1863,11,0,19,6,44717400,3661,72840,5,12232
1864,10,0,18,7,44762940,3661,72840,5,12242
1865,7,0,18,7,44789880,3661,72840,5,12249
1866,7,0,15,10,44828400,3662,72840,5,12256
1867,6,0,13,12,44863080,3662,72840,5,12262
1868,5,0,12,13,44888040,3662,72840,5,12267
1869,6,0,14,11,44898300,3662,72840,5,12273
1870,3,0,11,14,44917620,3662,72840,5,12276
1871,4,0,12,13,44929860,3662,72840,5,12280
1872,4,0,11,14,44949180,3662,72840,5,12284
1873,4,0,10,15,44964300,3662,72840,5,12288
1874,5,0,12,13,44975460,3662,72840,5,12293
1875,6,0,12,13,44996460,3662,72840,5,12299
1876,2,0,9,16,45013200,3661,72840,5,12301
1877,8,0,16,9,45014940,3661,72840,5,12309
1878,3,0,10,15,45042420,3661,72840,5,12312
1879,5,0,10,15,45059940,3661,72840,5,12317
1880,3,0,8,17,45072420,3660,72840,5,12320
1881,4,0,9,16,45083760,3660,72840,5,12324
1882,13,0,18,7,45088080,3660,72840,5,12337
1883,6,0,15,10,45118260,3659,72840,5,12343
1884,19,6,20,5,45152160,3660,76020,6,12362
1885,7,3,21,4,45189780,3660,95760,7,12369
1886,12,0,18,7,45236700,3659,107520,8,12381
1887,6,0,15,10,45265980,3658,107520,8,12387
1888,5,0,13,12,45300480,3659,107520,8,12392
1889,8,0,20,5,45306360,3659,107520,8,12400
1890,4,0,17,8,45351900,3661,107520,8,12404
1891,17,0,21,4,45399900,3661,107520,8,12421
1892,5,0,16,9,45438240,3661,107520,8,12426
1893,5,0,12,13,45480660,3662,107520,8,12431
1894,5,0,14,11,45498720,3662,107520,8,12436
1895,4,0,15,10,45514380,3663,107520,8,12440
1896,5,0,12,13,45545160,3663,107520,8,12445
1897,6,0,12,13,45567360,3663,107520,8,12451
1898,6,0,13,12,45588240,3663,107520,8,12457
1899,6,0,14,11,45601860,3663,107520,8,12463
1900,9,0,16,9,45629100,3663,107520,8,12472
1901,7,0,16,9,45667380,3664,107520,8,12479
1902,3,0,11,14,45696000,3664,107520,8,12482
1903,3,0,12,13,45708060,3664,107520,8,12485
1904,6,0,11,14,45724380,3663,107520,8,12491
1905,5,0,13,12,45737940,3664,107520,8,12496
1906,9,0,18,7,45751500,3663,107520,8,12505
1907,8,0,11,14,45799260,3663,107520,8,12513
1908,7,0,16,9,45806220,3663,107520,8,12520
1909,10,0,18,7,45833880,3663,107520,8,12530
1910,8,0,15,10,45866880,3662,107520,8,12538
1911,9,0,12,13,45910800,3662,107520,8,12547
1912,4,0,13,12,45917100,3662,107520,8,12551
1913,11,0,16,9,45939120,3661,107520,8,12562
1914,8,0,15,10,45964260,3661,107520,8,12570
1915,3,0,14,11,45975840,3660,107520,8,12573
1916,9,0,15,10,46021200,3662,107520,8,12582
1917,5,0,13,12,46038180,3661,107520,8,12587
1918,9,0,14,11,46070640,3661,107520,8,12596
1919,4,0,12,13,46092840,3661,107520,8,12600
1920,3,0,10,15,46121880,3662,107520,8,12603
1921,0,0,8,17,46131840,3662,107520,8,12603
1922,6,0,12,13,46136400,3662,107520,8,12609
1923,4,0,12,13,46144980,3662,107520,8,12613
1924,7,0,13,12,46166100,3661,107520,8,12620
1925,5,0,14,11,46179840,3661,107520,8,12625
1926,6,0,17,8,46183440,3661,107520,8,12631
1927,4,0,13,12,46226280,3662,107520,8,12635
1928,10,0,18,7,46256820,3663,107520,8,12645
1929,12,0,19,6,46295640,3663,107520,8,12657
1930,8,0,17,8,46330980,3663,107520,8,12665
1931,11,0,17,8,46377360,3663,107520,8,12676
1932,7,0,12,13,46414080,3663,107520,8,12683
1933,11,0,17,8,46433580,3662,107520,8,12694
1934,13,0,19,6,46469280,3662,107520,8,12707
1935,6,0,14,11,46507560,3662,107520,8,12713
1936,6,0,14,11,46525740,3662,107520,8,12719
1937,8,0,13,12,46564620,3662,107520,8,12727
1938,13,0,18,7,46582380,3661,107520,8,12740
1939,9,0,18,7,46617840,3661,107520,8,12749
1940,5,0,17,8,46647840,3662,107520,8,12754
1941,5,0,14,11,46682640,3662,107520,8,12759
1942,2,0,12,13,46711320,3663,107520,8,12761
1943,3,0,11,14,46735140,3664,107520,8,12764
1944,3,0,9,16,46749480,3664,107520,8,12767
1945,3,0,10,15,46759080,3664,107520,8,12770
1946,4,0,10,15,46767300,3664,107520,8,12774
1947,8,0,13,12,46777500,3663,107520,8,12782
1948,5,0,10,15,46808220,3663,107520,8,12787
1949,5,0,11,14,46820760,3663,107520,8,12792
1950,4,0,12,13,46826520,3662,107520,8,12796
1951,4,0,10,15,46850400,3663,107520,8,12800
1952,5,0,14,11,46857600,3663,107520,8,12805
1953,12,0,21,4,46870740,3662,107520,8,12817
1954,10,0,20,5,46910940,3662,107520,8,12827
1955,11,0,16,9,46967040,3663,107520,8,12838
1956,10,0,16,9,46999500,3662,107520,8,12848
1957,10,0,19,6,47031900,3663,107520,8,12858
1958,6,0,14,11,47068200,3662,107520,8,12864
1959,5,0,12,13,47097300,3663,107520,8,12869
1960,7,0,13,12,47118480,3663,107520,8,12876
1961,9,0,17,8,47133720,3662,107520,8,12885
1962,4,0,14,11,47161200,3663,107520,8,12889
1963,5,0,15,10,47177460,3663,107520,8,12894
1964,7,0,14,11,47217240,3663,107520,8,12901
1965,3,0,12,13,47240220,3664,107520,8,12904
1966,9,0,13,12,47265120,3663,107520,8,12913
1967,3,0,11,14,47289900,3664,107520,8,12916
1968,5,0,10,15,47313360,3664,107520,8,12921
1969,4,0,10,15,47321340,3664,107520,8,12925
1970,3,0,12,13,47324700,3664,107520,8,12928
1971,3,0,11,14,47344800,3664,107520,8,12931
1972,5,0,12,13,47363700,3664,107520,8,12936
1973,4,0,10,15,47386980,3664,107520,8,12940
1974,3,0,12,13,47394960,3665,107520,8,12943
1975,8,0,13,12,47412180,3664,107520,8,12951
1976,4,0,12,13,47425800,3664,107520,8,12955
1977,7,0,14,11,47447700,3664,107520,8,12962
1978,13,0,20,5,47468640,3664,107520,8,12975
1979,9,0,18,7,47508540,3664,107520,8,12984
1980,3,0,14,11,47537700,3664,107520,8,12987
1981,12,0,18,7,47572260,3664,107520,8,12999
1982,8,0,16,9,47624100,3665,107520,8,13007
1983,13,0,17,8,47664960,3665,107520,8,13020
1984,10,0,18,7,47685060,3664,107520,8,13030
1985,5,0,8,17,47737500,3664,107520,8,13035
1986,8,0,11,14,47753340,3664,107520,8,13043
1987,7,0,10,15,47764500,3662,107520,8,13050
1988,4,0,9,16,47779080,3662,107520,8,13054
1989,3,0,8,17,47790060,3662,107520,8,13057
1990,5,0,11,14,47792340,3661,107520,8,13062
1991,5,0,9,16,47813460,3661,107520,8,13067
1992,7,0,15,10,47815800,3661,107520,8,13074
1993,7,0,14,11,47841240,3661,107520,8,13081
1994,3,0,12,13,47858940,3661,107520,8,13084
1995,12,0,17,8,47890020,3661,107520,8,13096
1996,10,0,19,6,47907360,3660,107520,8,13106
1997,9,0,16,9,47956920,3661,107520,8,13115
1998,4,0,13,12,47993100,3661,107520,8,13119
1999,6,0,13,12,48020040,3662,107520,8,13125
2000,5,0,12,13,48037500,3661,107520,8,13130
2001,9,0,15,10,48049860,3661,107520,8,13139
2002,14,0,19,6,48079320,3660,107520,8,13153
2003,11,0,20,5,48113940,3660,107520,8,13164
2004,8,0,16,9,48152640,3660,107520,8,13172
2005,8,0,15,10,48188280,3660,107520,8,13180
2006,6,0,10,15,48225060,3660,107520,8,13186
2007,12,0,12,13,48247500,3658,107520,8,13198
2008,9,0,15,10,48256020,3657,107520,8,13207
2009,11,0,16,9,48288120,3657,107520,8,13218
2010,10,0,16,9,48324960,3657,107520,8,13228
2011,13,0,20,5,48347100,3656,107520,8,13241
2012,3,0,11,14,48387480,3656,107520,8,13244
2013,7,0,10,15,48417780,3656,107520,8,13251
2014,2,0,10,15,48426240,3656,107520,8,13253
2015,7,0,14,11,48433560,3656,107520,8,13260
2016,2,0,10,15,48461520,3656,107520,8,13262
2017,5,0,14,11,48462300,3656,107520,8,13267
2018,6,0,15,10,48476220,3656,107520,8,13273
2019,5,0,15,10,48499200,3656,107520,8,13278
2020,3,0,13,12,48517500,3656,107520,8,13281
2021,6,0,14,11,48539220,3656,107520,8,13287
2022,8,0,17,8,48553200,3656,107520,8,13295
2023,6,0,16,9,48588240,3657,107520,8,13301
2024,8,0,17,8,48613680,3657,107520,8,13309
2025,5,0,16,9,48626160,3656,107520,8,13314
2026,13,0,21,4,48658500,3656,107520,8,13327
2027,10,0,19,6,48707100,3657,107520,8,13337
2028,8,0,18,7,48730560,3656,107520,8,13345
2029,5,0,14,11,48766320,3656,107520,8,13350
2030,10,0,19,6,48776160,3656,107520,8,13360
2031,4,0,14,11,48814200,3656,107520,8,13364
2032,10,0,19,6,48836820,3656,107520,8,13374
2033,10,0,20,5,48865620,3656,107520,8,13384
2034,5,0,13,12,48908520,3656,107520,8,13389
2035,8,0,13,12,48920580,3655,107520,8,13397
2036,6,0,12,13,48947400,3655,107520,8,13403
2037,8,0,16,9,48954060,3654,107520,8,13411
2038,6,0,14,11,48982500,3654,107520,8,13417
2039,3,0,15,10,48988740,3654,107520,8,13420
2040,3,0,13,12,49016640,3655,107520,8,13423
2041,8,0,18,7,49027680,3655,107520,8,13431
2042,2,0,13,12,49047540,3654,107520,8,13433
2043,5,0,15,10,49064040,3655,107520,8,13438
2044,4,0,13,12,49090620,3655,107520,7,13442
2045,4,0,14,11,49105200,3655,107520,7,13446
2046,3,0,13,12,49122480,3656,107520,7,13449
2047,3,0,13,12,49138080,3656,107520,7,13452
2048,5,0,13,12,49156140,3656,107520,7,13457
2049,7,0,15,10,49170480,3656,107520,7,13464
2050,10,0,18,7,49193700,3655,107520,7,13474
2051,10,0,21,4,49216320,3655,107520,7,13484
2052,8,0,17,8,49254900,3655,107520,7,13492
2053,13,0,23,2,49294620,3656,107520,7,13505
2054,14,3,23,2,49337040,3656,111840,8,13519
2055,11,0,22,3,49391700,3656,122100,9,13530
2056,12,0,20,5,49438560,3656,122100,9,13542
2057,5,0,15,10,49480320,3656,122100,9,13547
2058,4,0,13,12,49505100,3656,122100,9,13551
2059,8,0,17,8,49522680,3656,122100,9,13559
2060,3,0,12,13,49535220,3655,122100,9,13562
2061,5,0,13,12,49553400,3655,122100,8,13567
2062,7,0,16,9,49569300,3656,122100,8,13574
2063,6,0,13,12,49595580,3655,122100,8,13580
2064,3,0,12,13,49613040,3655,122100,8,13583
2065,5,0,13,12,49623960,3655,122100,8,13588
2066,2,0,12,13,49632060,3655,122100,8,13590
2067,7,0,14,11,49640640,3654,122100,8,13597
2068,4,0,12,13,49662120,3654,122100,8,13601
2069,4,0,12,13,49679580,3654,122100,8,13605
2070,9,0,18,7,49685100,3654,122100,8,13614
2071,8,0,21,4,49707360,3654,122100,8,13622
2072,8,0,15,10,49759800,3654,122100,8,13630
2073,8,0,16,9,49781040,3654,122100,8,13638
2074,10,0,17,8,49800600,3653,122100,8,13648
2075,9,0,17,8,49830240,3653,122100,8,13657
2076,10,0,18,7,49861800,3653,122100,8,13667
2077,10,0,22,3,49882500,3653,122100,8,13677
2078,20,2,23,2,49936500,3652,123480,9,13697
2079,11,0,23,2,49977480,3651,127560,9,13708
2080,11,0,24,1,50011080,3651,127560,9,13719
2081,3,0,12,13,50076720,3652,127560,9,13722
2082,11,0,18,7,50082540,3651,127560,9,13733
2083,8,0,18,7,50113200,3651,127560,9,13741
2084,2,0,12,13,50147520,3652,127560,9,13743
2085,5,0,12,13,50171220,3652,127560,9,13748
2086,3,0,13,12,50180040,3652,127560,9,13751
2087,7,0,14,11,50187600,3651,127560,9,13758
2088,4,0,12,13,50211600,3651,127560,9,13762
2089,4,0,14,11,50227920,3652,127560,9,13766
2090,8,0,20,5,50230860,3652,127560,9,13774
2091,5,0,13,12,50278620,3652,127560,9,13779
2092,5,0,14,11,50296560,3652,127560,9,13784
2093,2,0,13,12,50303700,3652,127560,9,13786
2094,9,0,18,7,50317020,3652,127560,9,13795
2095,15,0,22,3,50348940,3651,127560,9,13810
2096,14,0,21,4,50391840,3650,128700,9,13824
2097,10,0,18,7,50441400,3650,128700,9,13834
2098,5,0,12,13,50477460,3650,128700,9,13839
2099,8,0,14,11,50497020,3650,128700,9,13847
2100,10,0,19,6,50510220,3650,128700,9,13857
2101,8,0,16,9,50541120,3649,128700,9,13865
2102,10,0,15,10,50578260,3649,128700,9,13875
2103,6,0,15,10,50593560,3648,128700,9,13881
2104,6,0,18,7,50608080,3649,128700,9,13887
2105,12,0,23,2,50633700,3649,128700,9,13899
2106,6,0,22,3,50659920,3649,129360,9,13905
2107,7,0,18,7,50713680,3650,129360,9,13912
2108,4,0,17,8,50740140,3650,129360,9,13916
2109,7,0,18,7,50768700,3651,129360,9,13923
2110,6,0,13,12,50816700,3651,129360,9,13929
2111,4,0,13,12,50822760,3651,129360,9,13933
2112,5,0,14,11,50834400,3650,129360,9,13938
2113,5,0,14,11,50849280,3650,129360,9,13943
2114,5,0,13,12,50868540,3650,129360,9,13948
2115,4,0,16,9,50872980,3650,129360,9,13952
2116,6,0,16,9,50904960,3651,129360,9,13958
2117,8,0,18,7,50921340,3650,129360,9,13966
2118,7,0,19,6,50948640,3651,129360,9,13973
2119,15,0,23,2,50993880,3651,129600,9,13988
2120,3,0,15,10,51035880,3651,129600,9,13991
2121,12,0,19,6,51074640,3652,129600,9,14003
2122,8,0,19,6,51089880,3651,129600,9,14011
2123,8,0,14,11,51127140,3650,129600,9,14019
2124,6,0,14,11,51139740,3649,129600,9,14025
2125,6,0,14,11,51161880,3649,129600,9,14031
2126,9,0,15,10,51179820,3649,129600,9,14040
2127,8,0,16,9,51200100,3648,129600,9,14048
2128,6,0,16,9,51218580,3648,129600,9,14054
2129,7,0,16,9,51245040,3648,129600,9,14061
2130,9,0,18,7,51266040,3648,129600,9,14070
2131,7,0,18,7,51293580,3648,129600,9,14077
2132,4,0,13,12,51324900,3648,129600,9,14081
2133,11,0,18,7,51364860,3649,129600,9,14092
2134,5,0,19,6,51384180,3649,129600,9,14097
2135,3,0,14,11,51421620,3650,129600,9,14100
2136,5,0,14,11,51453600,3651,129600,9,14105
2137,6,0,12,13,51476520,3651,129600,9,14111
2138,3,0,12,13,51480780,3650,129600,9,14114
2139,4,0,12,13,51498360,3650,129600,9,14118
2140,2,0,12,13,51505320,3650,129600,9,14120
2141,4,0,14,11,51513180,3650,129600,9,14124
2142,8,0,15,10,51530040,3650,129600,9,14132
2143,11,0,21,4,51548820,3650,129600,9,14143
2144,4,0,16,9,51584700,3650,129600,9,14147
2145,7,0,16,9,51618780,3651,129600,9,14154
2146,11,0,20,5,51648060,3651,129600,9,14165
2147,7,0,20,5,51671340,3651,129600,9,14172
2148,7,0,17,8,51704580,3650,129600,9,14179
2149,11,0,19,6,51751680,3651,129600,9,14190
2150,10,0,18,7,51778500,3651,129600,9,14200
2151,10,0,18,7,51822000,3651,129600,9,14210
2152,12,0,22,3,51839760,3650,129600,9,14222
2153,9,0,18,7,51895020,3651,129600,9,14231
2154,4,0,12,13,51925920,3650,129600,9,14235
2155,6,0,13,12,51939180,3650,129600,9,14241
2156,4,0,13,12,51957360,3650,129600,9,14245
2157,6,0,14,11,51973620,3650,129600,9,14251
2158,4,0,16,9,51977880,3650,129600,9,14255
2159,4,0,14,11,52012080,3651,129600,9,14259
2160,3,0,13,12,52027800,3651,129600,9,14262
2161,7,0,12,13,52042620,3650,129600,9,14269
2162,4,0,11,14,52056060,3649,129600,9,14273
2163,5,0,12,13,52065720,3649,129600,9,14278
2164,6,0,16,9,52069980,3649,129600,9,14284
2165,9,0,14,11,52095240,3648,129600,9,14293
2166,6,0,15,10,52117920,3648,129600,9,14299
2167,10,0,18,7,52136460,3648,129600,9,14309
2168,3,0,16,9,52153860,3648,129600,9,14312
2169,5,0,14,11,52187040,3648,129600,9,14317
2170,8,0,14,11,52210620,3648,129600,9,14325
2171,6,0,17,8,52217640,3648,129600,9,14331
2172,15,0,23,2,52249080,3647,129600,9,14346
2173,5,0,17,8,52286100,3647,129600,9,14351
2174,13,0,21,4,52320240,3647,129600,9,14364
2175,4,0,15,10,52365660,3648,129600,9,14368
2176,6,0,13,12,52400520,3648,129600,9,14374
2177,4,0,13,12,52415760,3648,129600,9,14378
2178,9,0,19,6,52430940,3649,129600,9,14387
2179,7,0,20,5,52451280,3649,129600,9,14394
2180,7,0,17,8,52495560,3649,129600,8,14401
2181,6,0,16,9,52525980,3649,129600,8,14407
2182,3,0,11,14,52560000,3650,129600,8,14410
2183,11,0,20,5,52561500,3649,129600,8,14421
2184,4,0,16,9,52584780,3649,129600,8,14425
2185,3,0,11,14,52631280,3650,129600,8,14428
2186,3,0,9,16,52642740,3650,129600,8,14431
2187,6,0,10,15,52649460,3649,129600,8,14437
2188,4,0,10,15,52660620,3649,129600,8,14441
2189,6,0,15,10,52661220,3648,129600,8,14447
2190,6,0,12,13,52685280,3648,129600,8,14453
2191,6,0,15,10,52687800,3647,129600,8,14459
2192,9,0,18,7,52707840,3647,129600,8,14468
2193,8,0,19,6,52734960,3647,129600,8,14476
2194,9,0,20,5,52776180,3648,129600,8,14485
2195,11,1,19,6,52810800,3648,130680,9,14496
2196,6,0,20,5,52839120,3648,131700,9,14502
2197,11,0,19,6,52899060,3649,131700,9,14513
2198,8,0,17,8,52931580,3649,131700,9,14521
2199,6,0,16,9,52960260,3649,131700,9,14527
2200,7,0,16,9,52987920,3649,131700,9,14534
2201,9,0,18,7,53019840,3650,131700,9,14543
2202,9,0,18,7,53039880,3649,131700,9,14552
2203,5,0,16,9,53073180,3649,131700,9,14557
2204,4,0,12,13,53106720,3650,131700,9,14561
2205,7,0,16,9,53111820,3649,131700,9,14568
2206,6,0,17,8,53135760,3650,131700,9,14574
2207,3,0,15,10,53153760,3650,131700,9,14577
2208,1,0,11,14,53189340,3651,131700,9,14578
2209,3,0,13,12,53195220,3651,131700,9,14581
2210,6,0,16,9,53199960,3651,131700,9,14587
2211,4,0,13,12,53231820,3651,131700,9,14591
2212,5,0,15,10,53239440,3651,131700,9,14596
2213,5,0,15,10,53266800,3651,131700,9,14601
2214,9,1,17,8,53291520,3652,132840,9,14610
2215,3,0,15,10,53320620,3652,134280,9,14613
2216,9,0,19,6,53339880,3652,134280,9,14622
2217,10,0,19,6,53367360,3652,134280,9,14632
2218,10,0,19,6,53421120,3653,134280,9,14642
2219,6,1,20,5,53437140,3653,137820,9,14648
2220,13,1,25,0,53466840,3653,147120,10,14661
2221,7,0,19,6,53527980,3654,148020,10,14668
2222,11,0,21,4,53564340,3654,148020,10,14679
2223,13,0,16,9,53623200,3653,148020,10,14692
2224,9,0,16,9,53645880,3653,148020,10,14701
2225,7,0,15,10,53676180,3653,148020,10,14708
2226,6,0,16,9,53690340,3652,148020,10,14714
2227,5,0,16,9,53705340,3652,148020,10,14719
2228,6,0,15,10,53741640,3653,148020,10,14725
2229,3,0,11,14,53764320,3653,148020,10,14728
2230,5,0,15,10,53767740,3653,148020,10,14733
2231,5,0,14,11,53787660,3653,148020,10,14738
2232,1,0,13,12,53801160,3653,148020,10,14739
2233,9,0,16,9,53818800,3653,148020,10,14748
2234,8,0,20,5,53834280,3653,148020,10,14756
2235,6,0,18,7,53866440,3653,148020,10,14762
2236,7,0,16,9,53903700,3653,148020,10,14769
2237,4,0,17,8,53918220,3653,148020,10,14773
2238,12,0,21,4,53948820,3654,148020,10,14785
2239,6,0,16,9,54004140,3655,148020,10,14791
2240,10,0,21,4,54022140,3655,148020,10,14801
2241,5,0,17,8,54067800,3655,148020,9,14806
2242,11,0,20,5,54101760,3656,148020,9,14817
2243,8,0,16,9,54137640,3655,148020,9,14825
2244,7,0,15,10,54159780,3655,148020,9,14832
2245,6,0,16,9,54177900,3655,148020,9,14838
2246,7,0,15,10,54204900,3655,148020,9,14845
2247,11,0,20,5,54219840,3654,148020,9,14856
2248,6,0,18,7,54247380,3654,148020,9,14862
2249,4,0,15,10,54287580,3655,148020,9,14866
2250,12,0,17,8,54320580,3655,148020,9,14878
2251,4,0,16,9,54336360,3655,148020,9,14882
2252,4,0,15,10,54358740,3655,148020,9,14886
2253,4,0,14,11,54386940,3656,148020,9,14890
2254,4,0,13,12,54406440,3656,148020,9,14894
2255,3,0,11,14,54426540,3656,148020,9,14897
2256,2,0,11,14,54432720,3656,148020,9,14899
2257,4,0,11,14,54445920,3656,148020,9,14903
2258,4,0,14,11,54447060,3655,148020,9,14907
2259,4,0,15,10,54456840,3655,148020,9,14911
2260,5,0,13,12,54486000,3656,148020,9,14916
2261,5,0,17,8,54494400,3656,148020,9,14921
2262,7,0,18,7,54514320,3656,148020,9,14928
2263,8,0,16,9,54558360,3656,148020,9,14936
2264,7,0,16,9,54582360,3656,148020,9,14943
2265,7,0,13,12,54616920,3656,148020,9,14950
2266,6,0,15,10,54627060,3656,148020,9,14956
2267,7,0,19,6,54641760,3656,148020,9,14963
2268,14,0,23,2,54673380,3656,148020,9,14977
2269,6,0,18,7,54724680,3656,148020,9,14983
2270,8,0,15,10,54760500,3656,148020,9,14991
2271,12,0,19,6,54792180,3656,148020,9,15003
2272,15,1,21,4,54816300,3655,148740,9,15018
2273,8,8,20,5,54827220,3655,149820,9,15026
2274,5,0,23,2,54891180,3657,179340,11,15031
2275,6,0,14,11,54944340,3657,179340,11,15037
2276,2,0,9,16,54965580,3657,179340,11,15039
2277,5,0,13,12,54966480,3656,179340,11,15044
2278,6,0,16,9,54972780,3656,179340,11,15050
2279,2,0,14,11,54987900,3656,179340,11,15052
2280,3,0,12,13,55009140,3656,179340,11,15055
2281,7,0,13,12,55026300,3656,179340,11,15062
2282,3,0,15,10,55029240,3656,179340,11,15065
2283,6,0,16,9,55050420,3656,179340,11,15071
2284,3,0,13,12,55082820,3657,179340,11,15074
2285,4,0,11,14,55101480,3657,179340,11,15078
2286,9,0,15,10,55113780,3656,179340,11,15087
2287,7,0,13,12,55134000,3655,179340,11,15094
2288,15,0,21,4,55153800,3655,179340,11,15109
2289,10,1,19,6,55184400,3654,179340,11,15119
2290,8,0,18,7,55230600,3655,181500,11,15127
2291,6,0,16,9,55259040,3655,181500,11,15133
2292,5,0,15,10,55276320,3655,181500,11,15138
2293,8,0,15,10,55315800,3655,181500,11,15146
2294,7,0,18,7,55324440,3655,181500,11,15153
2295,11,0,20,5,55359000,3655,181500,11,15164
2296,8,0,19,6,55384260,3655,181500,11,15172
2297,8,0,14,11,55431960,3655,181500,11,15180
2298,4,0,12,13,55445940,3654,181500,11,15184
2299,6,0,14,11,55458780,3654,181500,11,15190
2300,9,0,18,7,55474260,3654,181500,11,15199
2301,3,0,12,13,55508580,3654,181500,11,15202
2302,6,0,14,11,55524300,3654,181500,11,15208
2303,5,0,15,10,55535940,3654,181500,11,15213
2304,5,0,14,11,55562280,3654,181500,11,15218
2305,6,0,13,12,55586220,3654,181500,11,15224
2306,4,0,13,12,55591560,3653,181500,11,15228
2307,1,0,10,15,55606320,3653,181500,11,15229
2308,4,0,12,13,55613760,3653,181500,11,15233
2309,6,0,11,14,55627620,3652,181500,11,15239
2310,5,0,14,11,55630680,3652,181500,11,15244
2311,6,0,18,7,55634820,3652,181500,11,15250
2312,6,0,19,6,55660800,3653,181500,11,15256
2313,9,0,15,10,55715160,3653,181500,11,15265
2314,7,0,18,7,55725540,3653,181500,11,15272
2315,9,0,19,6,55756680,3653,181500,11,15281
2316,12,1,19,6,55781940,3652,182100,11,15293
2317,5,0,16,9,55839540,3653,183120,11,15298
2318,9,0,19,6,55863240,3654,183120,11,15307
2319,8,0,14,11,55902960,3653,183120,11,15315
2320,7,0,17,8,55918920,3653,183120,11,15322
2321,3,0,13,12,55948920,3653,183120,11,15325
2322,7,0,15,10,55963680,3653,183120,11,15332
2323,6,0,13,12,55988640,3653,183120,11,15338
2324,8,0,15,10,56001300,3652,183120,11,15346
2325,7,0,15,10,56018580,3652,183120,11,15353
2326,2,0,14,11,56037360,3652,183120,11,15355
2327,3,0,12,13,56067600,3653,183120,11,15358
2328,3,0,12,13,56073960,3653,183120,11,15361
2329,5,0,13,12,56090760,3653,183120,11,15366
2330,3,0,11,14,56101200,3652,183120,11,15369
2331,2,0,11,14,56109000,3652,183120,11,15371
2332,3,0,13,12,56112120,3652,183120,11,15374
2333,8,0,15,10,56125380,3652,183120,11,15382
2334,8,0,17,8,56144700,3652,183120,11,15390
2335,5,0,15,10,56173440,3652,183120,11,15395
2336,11,0,20,5,56203740,3652,183120,11,15406
2337,15,0,21,4,56244900,3652,183120,11,15421
2338,11,0,20,5,56287140,3652,183120,11,15432
2339,10,0,21,4,56315940,3651,183120,11,15442
2340,11,0,18,7,56368140,3651,183120,11,15453
2341,9,0,19,6,56400780,3652,183120,11,15462
2342,9,0,18,7,56448960,3652,183120,11,15471
2343,14,0,20,5,56482680,3652,183120,11,15485
2344,6,0,17,8,56514060,3652,183120,11,15491
2345,5,0,13,12,56552820,3652,183120,11,15496
2346,8,0,16,9,56569260,3652,183120,11,15504
2347,2,0,13,12,56587560,3652,183120,11,15506
2348,6,0,15,10,56601660,3652,183120,11,15512
2349,6,0,16,9,56622600,3652,183120,11,15518
2350,7,0,13,12,56643720,3651,183120,11,15525
2351,3,0,11,14,56666220,3651,183120,11,15528
2352,0,0,10,15,56671260,3651,183120,11,15528
2353,5,0,13,12,56681700,3652,183120,11,15533
2354,6,0,14,11,56690880,3651,183120,11,15539
2355,3,0,12,13,56714040,3651,183120,11,15542
2356,3,0,14,11,56719560,3652,183120,11,15545
2357,4,0,11,14,56740140,3651,183120,11,15549
2358,7,0,15,10,56745840,3651,183120,11,15556
2359,5,0,12,13,56771280,3651,183120,11,15561
2360,1,0,11,14,56785500,3651,183120,11,15562
2361,10,0,18,7,56793660,3651,183120,11,15572
2362,11,1,20,5,56809320,3650,183360,11,15583
2363,7,0,21,4,56855520,3651,196800,12,15590
2364,9,0,16,9,56892960,3650,196800,12,15599
2365,8,0,16,9,56923560,3651,196800,12,15607
2366,13,0,20,5,56953800,3650,196800,12,15620
2367,9,0,20,5,56987100,3650,196800,12,15629
2368,8,0,18,7,57018180,3650,196800,12,15637
2369,14,0,18,7,57067620,3650,196800,12,15651
2370,13,2,20,5,57087780,3649,197340,12,15664
2371,7,1,19,6,57117360,3649,206280,13,15671
2372,5,0,13,12,57175680,3650,206580,13,15676
2373,7,0,16,9,57188940,3650,206580,13,15683
2374,6,0,15,10,57211620,3650,206580,13,15689
2375,5,0,14,11,57241260,3650,206580,13,15694
2376,8,0,17,8,57261780,3650,206580,13,15702
2377,9,0,13,12,57280320,3648,206580,13,15711
2378,3,0,12,13,57297600,3649,206580,13,15714
2379,4,0,12,13,57308640,3648,206580,13,15718
2380,7,0,15,10,57313500,3648,206580,13,15725
2381,3,0,13,12,57342900,3648,206580,13,15728
2382,9,0,15,10,57357660,3648,206580,13,15737
2383,5,0,14,11,57376620,3648,206580,13,15742
2384,3,0,12,13,57396960,3648,206580,13,15745
2385,6,0,13,12,57404940,3647,206580,13,15751
2386,4,0,12,13,57418020,3647,206580,13,15755
2387,7,0,16,9,57428160,3647,206580,13,15762
2388,13,0,21,4,57449640,3646,206580,13,15775
2389,10,0,17,8,57484860,3645,206580,13,15785
2390,9,0,16,9,57524160,3645,206580,13,15794
2391,4,0,17,8,57536580,3645,206580,13,15798
2392,5,0,15,10,57566520,3646,206580,13,15803
2393,10,0,17,8,57594000,3646,206580,13,15813
2394,7,0,14,11,57629460,3646,206580,13,15820
2395,11,0,22,3,57639300,3645,206580,13,15831
2396,8,0,22,3,57660840,3645,206580,13,15839
2397,2,0,14,11,57718860,3646,206580,13,15841
2398,4,0,12,13,57754980,3647,206580,13,15845
2399,4,0,13,12,57767640,3647,206580,13,15849
2400,4,0,13,12,57775740,3647,206580,13,15853
2401,1,0,11,14,57789840,3647,206580,13,15854
2402,3,0,11,14,57802080,3647,206580,13,15857
2403,6,0,15,10,57806580,3647,206580,13,15863
2404,3,0,13,12,57826980,3647,206580,13,15866
2405,4,0,13,12,57844380,3647,206580,13,15870
2406,4,0,11,14,57867660,3647,206580,13,15874
2407,8,0,15,10,57875220,3647,206580,13,15882
2408,5,0,12,13,57893460,3646,206580,13,15887
2409,6,0,14,11,57906180,3646,206580,12,15893
2410,11,0,19,6,57926160,3646,206580,12,15904
2411,12,0,22,3,57951120,3646,206580,12,15916
2412,10,0,24,1,57983640,3646,206580,12,15926
2413,8,0,18,7,58034700,3646,206580,12,15934
2414,2,0,14,11,58063680,3646,206580,12,15936
2415,5,0,14,11,58082820,3646,206580,12,15941
2416,9,0,14,11,58118880,3647,206580,12,15950
2417,6,0,15,10,58128780,3646,206580,12,15956
2418,11,0,18,7,58154160,3646,206580,12,15967
2419,6,0,16,9,58180620,3646,206580,12,15973
2420,7,0,17,8,58204920,3646,206580,12,15980
2421,5,0,13,12,58227540,3645,206580,12,15985
2422,3,0,11,14,58252500,3646,206580,12,15988
2423,6,0,13,12,58258080,3645,206580,12,15994
2424,5,0,15,10,58262160,3645,206580,12,15999
2425,6,0,15,10,58290480,3645,206580,12,16005
2426,6,0,14,11,58311960,3645,206580,12,16011
2427,7,0,14,11,58333200,3644,206580,12,16018
2428,7,0,16,9,58345440,3644,206580,12,16025
2429,5,0,15,10,58364220,3644,206580,12,16030
2430,7,0,17,8,58373580,3643,206580,12,16037
2431,4,0,14,11,58411860,3644,206580,12,16041
2432,5,0,12,13,58432440,3644,206580,12,16046
2433,9,0,18,7,58440960,3644,206580,12,16055
2434,13,0,23,2,58464840,3643,206580,12,16068
2435,12,0,21,4,58520640,3644,207780,12,16080
2436,12,1,21,4,58560420,3644,211020,13,16092
2437,15,12,17,8,58601880,3644,213480,13,16107
2438,7,14,16,9,58635780,3645,230760,14,16114
2439,11,13,25,0,58654860,3646,264960,16,16125
2440,11,4,25,0,58718220,3645,352800,21,16136
2441,3,0,12,13,58770900,3644,381000,23,16139
2442,6,0,15,10,58786740,3644,381000,23,16145
2443,3,0,15,10,58801260,3644,381000,23,16148
2444,6,0,14,11,58831260,3645,381000,23,16154
2445,7,0,16,9,58848480,3644,381000,23,16161
2446,5,0,16,9,58868160,3645,381000,23,16166
2447,5,0,15,10,58900440,3645,381000,23,16171
2448,3,0,12,13,58922640,3645,381000,23,16174
2449,6,0,15,10,58933080,3645,381000,23,16180
2450,7,0,17,8,58948140,3645,381000,23,16187
2451,5,0,16,9,58969560,3645,381000,23,16192
2452,3,0,12,13,59007420,3646,381000,23,16195
2453,6,0,13,12,59022840,3646,381000,23,16201
2454,7,0,14,11,59036280,3645,381000,23,16208
2455,5,0,14,11,59050620,3645,381000,23,16213
2456,8,0,13,12,59072400,3644,381000,23,16221
2457,8,0,13,12,59095380,3644,381000,23,16229
2458,7,0,15,10,59105580,3643,381000,23,16236
2459,7,0,16,9,59128200,3643,381000,23,16243
2460,5,0,14,11,59146380,3643,381000,23,16248
2461,7,0,16,9,59176680,3644,381000,23,16255
2462,8,0,16,9,59212440,3644,381300,23,16263
2463,8,0,17,8,59228340,3643,381300,23,16271
2464,16,3,25,0,59254500,3644,391080,24,16287
2465,5,0,19,6,59300580,3644,395940,24,16292
2466,4,0,15,10,59337420,3644,395940,24,16296
2467,8,0,16,9,59365080,3644,395940,24,16304
2468,10,0,17,8,59395440,3644,395940,24,16314
2469,5,0,15,10,59420700,3644,395940,24,16319
2470,6,0,16,9,59438160,3644,395940,24,16325
2471,3,0,15,10,59452980,3644,395940,24,16328
2472,8,0,16,9,59481300,3644,395940,24,16336
2473,2,0,13,12,59494620,3644,395940,24,16338
2474,5,0,14,11,59513220,3644,395940,24,16343
2475,4,0,15,10,59524920,3644,395940,24,16347
2476,7,0,13,12,59562600,3644,395940,24,16354
2477,5,0,14,11,59574900,3644,395940,24,16359
2478,7,1,17,8,59584320,3644,396780,24,16366
2479,4,2,17,8,59602860,3645,398820,24,16370
2480,8,0,17,8,59652180,3645,403440,24,16378
2481,6,0,17,8,59676180,3646,403440,24,16384
2482,8,0,18,7,59701920,3646,403440,24,16392
2483,10,0,22,3,59732820,3646,403440,24,16402
2484,11,0,23,2,59771640,3646,403440,24,16413
2485,9,0,15,10,59835360,3646,403440,24,16422
2486,8,0,16,9,59853480,3646,403440,24,16430
2487,7,0,15,10,59877960,3646,403440,24,16437
2488,11,0,16,9,59907180,3645,403440,24,16448
2489,7,0,16,9,59923200,3645,403440,24,16455
2490,6,0,14,11,59946060,3644,403440,24,16461
2491,7,0,16,9,59966580,3644,403440,24,16468
2492,6,0,15,10,59983740,3644,403440,24,16474
2493,1,0,11,14,60013680,3645,403440,24,16475
2494,11,0,18,7,60030060,3645,403440,24,16486
2495,4,0,17,8,60038040,3644,403440,24,16490
2496,4,0,14,11,60081240,3645,403440,24,16494
2497,0,0,11,14,60093840,3645,403440,24,16494
2498,3,0,12,13,60109020,3646,403440,24,16497
2499,8,0,14,11,60118020,3645,403440,24,16505
2500,6,0,14,11,60142680,3645,403440,24,16511
2501,7,0,15,10,60157260,3645,403440,24,16518
2502,2,0,11,14,60180600,3645,403440,24,16520
2503,6,0,16,9,60187320,3645,403440,24,16526
2504,5,0,15,10,60206940,3645,403440,24,16531
2505,4,0,14,11,60221160,3645,403440,24,16535
2506,9,0,17,8,60248940,3645,403440,24,16544
2507,10,0,17,8,60275220,3644,403440,24,16554
2508,10,0,20,5,60301620,3644,403440,24,16564
2509,5,0,15,10,60349560,3645,403440,24,16569
2510,9,0,18,7,60374040,3645,403440,24,16578
2511,5,0,15,10,60400380,3645,403440,24,16583
2512,8,0,16,9,60436620,3646,403440,24,16591
2513,5,0,16,9,60452820,3646,403440,24,16596
2514,7,0,16,9,60483300,3646,403440,24,16603
2515,6,0,13,12,60521760,3646,403440,24,16609
2516,8,0,17,8,60537420,3646,403440,24,16617
2517,4,0,15,10,60562440,3647,403440,24,16621
2518,2,0,13,12,60585180,3647,403440,24,16623
2519,2,0,13,12,60597360,3647,403440,24,16625
2520,3,0,15,10,60600240,3647,403440,24,16628
2521,6,0,13,12,60639360,3648,403440,24,16634
2522,3,0,13,12,60648840,3648,403440,24,16637
2523,4,0,13,12,60664920,3648,403440,24,16641
2524,9,0,12,13,60683700,3647,403440,24,16650
2525,2,0,14,11,60683700,3647,403440,24,16652
2526,5,0,13,12,60704520,3647,403440,24,16657
2527,5,0,13,12,60724080,3647,403440,24,16662
2528,13,0,22,3,60733440,3646,403440,24,16675
2529,4,0,15,10,60770340,3646,403440,24,16679
2530,9,0,16,9,60797940,3646,403440,24,16688
2531,4,0,16,9,60810180,3646,403440,24,16692
2532,3,0,12,13,60835500,3646,403440,24,16695
2533,12,0,17,8,60862140,3646,403440,24,16707
2534,11,0,18,7,60884040,3645,403440,24,16718
2535,6,0,18,7,60913140,3646,403440,24,16724
2536,7,0,13,12,60952680,3645,403440,24,16731
2537,13,0,17,8,60966780,3644,403440,24,16744
2538,10,0,17,8,60988740,3643,403440,24,16754
2539,2,0,14,11,61010580,3644,403440,24,16756
2540,10,0,16,9,61040760,3644,403440,24,16766
2541,4,0,13,12,61055460,3643,403440,24,16770
2542,2,0,13,12,61061340,3643,403440,24,16772
2543,3,0,11,14,61081560,3643,403440,24,16775
2544,5,0,12,13,61086840,3643,403440,24,16780
2545,5,0,13,12,61099320,3642,403440,24,16785
2546,3,0,12,13,61109460,3642,403440,24,16788
2547,10,0,18,7,61123620,3642,403440,24,16798
2548,5,0,15,10,61142040,3642,403440,24,16803
2549,3,0,12,13,61170240,3642,403440,24,16806
2550,4,0,14,11,61176900,3642,403440,24,16810
2551,3,0,12,13,61201680,3642,403440,23,16813
2552,8,0,14,11,61215360,3642,403440,23,16821
2553,7,0,17,8,61229460,3642,403440,23,16828
2554,8,0,19,6,61252620,3642,403440,23,16836
2555,5,0,14,11,61295220,3642,403440,23,16841
2556,5,0,13,12,61323780,3643,403440,23,16846
2557,8,0,14,11,61339020,3642,403440,23,16854
2558,9,0,16,9,61358760,3642,403440,23,16863
2559,14,0,24,1,61381740,3642,403440,23,16877
2560,10,0,25,0,61411440,3642,404580,23,16887
2561,10,0,22,3,61467060,3642,404580,23,16897
2562,2,0,12,13,61525200,3643,404580,23,16899
2563,7,0,13,12,61548060,3643,404580,23,16906
2564,7,0,15,10,61561860,3643,404580,23,16913
2565,9,0,15,10,61588080,3642,404580,23,16922
2566,6,0,12,13,61617960,3642,404580,23,16928
2567,4,0,16,9,61617960,3642,404580,23,16932
2568,2,0,13,12,61640520,3642,404580,23,16934
2569,7,0,15,10,61663260,3643,404580,23,16941
2570,4,0,16,9,61676040,3643,404580,23,16945
2571,4,0,16,9,61695300,3643,404580,23,16949
2572,3,0,13,12,61720440,3643,404580,23,16952
2573,5,0,14,11,61731600,3643,404580,23,16957
2574,7,0,14,11,61766280,3644,404580,23,16964
2575,4,0,15,10,61774860,3643,404580,23,16968
2576,6,0,15,10,61795080,3643,404580,23,16974
2577,6,0,16,9,61811820,3643,404580,23,16980
2578,9,0,16,9,61842000,3643,404580,23,16989
2579,10,0,16,9,61870980,3643,404580,23,16999
2580,15,0,25,0,61885740,3642,404820,23,17014
2581,5,0,16,9,61926600,3642,404820,23,17019
2582,7,0,13,12,61974420,3642,404820,23,17026
2583,5,0,12,13,61990140,3642,404820,23,17031
2584,5,0,13,12,62004840,3642,404820,23,17036
2585,10,0,15,10,62020680,3641,404820,23,17046
2586,10,0,17,8,62047980,3641,404820,23,17056
2587,10,0,20,5,62062920,3640,404820,23,17066
2588,10,0,20,5,62106900,3641,404820,23,17076
2589,6,0,19,6,62124540,3640,404820,23,17082
2590,3,0,14,11,62180400,3642,404820,23,17085
2591,4,0,12,13,62211960,3643,404820,23,17089
2592,5,0,15,10,62220780,3643,404820,23,17094
2593,4,0,11,14,62244600,3642,404820,23,17098
2594,5,0,14,11,62250000,3642,404820,23,17103
2595,5,0,16,9,62260740,3642,404820,23,17108
2596,8,0,15,10,62290200,3642,404820,23,17116
2597,10,0,13,12,62318280,3641,404820,23,17126
2598,8,0,16,9,62336040,3641,404820,23,17134
2599,4,0,14,11,62351400,3641,404820,23,17138
2600,7,0,15,10,62375400,3641,404820,23,17145
2601,12,0,20,5,62399940,3641,404820,23,17157
2602,8,0,18,7,62440260,3641,404820,23,17165
2603,7,0,18,7,62464320,3641,404820,23,17172
2604,10,0,18,7,62504760,3641,404820,23,17182
2605,8,0,16,9,62543760,3641,404820,23,17190
2606,8,0,18,7,62560140,3641,404820,23,17198
2607,10,0,18,7,62598060,3641,404820,23,17208
2608,6,0,18,7,62614740,3641,404820,23,17214
2609,10,0,19,6,62651460,3641,404820,23,17224
2610,8,0,20,5,62669820,3641,404820,23,17232
2611,8,0,19,6,62704980,3641,404820,23,17240
2612,8,0,15,10,62764440,3642,404820,23,17248
2613,6,0,18,7,62775120,3642,404820,23,17254
2614,3,0,14,11,62808780,3642,404820,23,17257
2615,5,0,15,10,62828220,3642,404820,23,17262
2616,6,0,14,11,62857740,3643,404820,23,17268
2617,7,0,16,9,62869920,3642,404820,23,17275
2618,3,0,11,14,62912400,3643,404820,23,17278
2619,2,0,11,14,62923140,3643,404820,23,17280
2620,2,0,12,13,62924040,3643,404820,23,17282
2621,8,0,17,8,62938620,3643,404820,23,17290
2622,6,0,15,10,62955420,3643,404820,23,17296
2623,11,0,17,8,62988540,3643,404820,23,17307
2624,8,0,15,10,63008520,3642,404820,23,17315
2625,7,0,20,5,63017340,3642,404820,23,17322
2626,9,1,19,6,63052200,3642,405780,23,17331
2627,7,0,18,7,63096960,3643,406440,23,17338
2628,7,0,15,10,63133860,3643,406440,23,17345
2629,12,0,20,5,63169320,3643,406440,23,17357
2630,10,0,20,5,63202800,3643,406440,23,17367
2631,6,0,17,8,63233160,3643,406440,23,17373
2632,5,0,15,10,63266220,3643,406440,23,17378
2633,11,0,18,7,63300660,3644,406440,23,17389
2634,9,0,21,4,63316140,3643,406440,23,17398
2635,8,0,17,8,63363720,3643,406440,23,17406
2636,11,0,18,7,63389580,3643,406440,23,17417
2637,6,0,15,10,63423120,3643,406440,23,17423
2638,7,0,16,9,63444300,3643,406440,23,17430
2639,5,0,12,13,63469380,3642,406440,23,17435
2640,8,0,17,8,63477660,3642,406440,23,17443
2641,4,0,16,9,63494700,3642,406440,23,17447
2642,6,0,18,7,63516300,3643,406440,23,17453
2643,5,0,14,11,63552720,3643,406440,23,17458
2644,5,0,13,12,63567240,3642,406440,23,17463
2645,4,0,12,13,63586500,3642,406440,23,17467
2646,3,0,11,14,63595740,3642,406440,23,17470
2647,8,0,14,11,63604980,3642,406440,23,17478
2648,6,0,15,10,63620520,3641,406440,23,17484
2649,9,0,19,6,63645840,3642,406440,23,17493
2650,9,0,18,7,63674880,3641,406440,23,17502
2651,7,0,18,7,63703380,3642,406440,23,17509
2652,8,0,17,8,63724860,3641,406440,23,17517
2653,5,0,17,8,63753300,3642,406440,23,17522
2654,13,0,21,4,63796560,3642,408360,23,17535
2655,4,0,17,8,63835740,3643,408360,23,17539
2656,6,0,13,12,63875640,3643,408360,23,17545
2657,12,0,18,7,63888660,3642,408360,23,17557
2658,13,1,25,0,63898500,3642,408360,23,17570
2659,2,0,13,12,63954960,3642,408600,23,17572
2660,1,0,10,15,63980520,3642,408600,23,17573
2661,5,0,13,12,63984780,3642,408600,23,17578
2662,6,0,12,13,63993540,3641,408600,23,17584
2663,8,0,17,8,64003980,3641,408600,23,17592
2664,11,0,16,9,64040460,3641,408600,23,17603
2665,4,0,12,13,64065480,3641,408600,23,17607
2666,4,0,12,13,64075920,3640,408600,23,17611
2667,7,0,18,7,64082820,3641,408600,23,17618
2668,5,0,14,11,64107660,3640,408600,23,17623
2669,6,0,15,10,64137840,3641,408600,23,17629
2670,4,0,14,11,64152420,3641,408600,23,17633
2671,8,0,15,10,64170480,3640,408600,23,17641
2672,5,0,13,12,64188540,3640,408600,23,17646
2673,14,0,22,3,64195860,3639,408600,23,17660
2674,7,0,19,6,64229880,3639,408600,23,17667
2675,14,0,23,2,64260480,3639,408600,23,17681
2676,13,0,25,0,64313880,3639,408600,23,17694
2677,7,0,22,3,64348200,3639,408780,23,17701
2678,8,0,19,6,64402800,3640,408780,23,17709
2679,5,0,16,9,64441800,3641,408780,23,17714
2680,11,0,21,4,64473720,3641,408780,23,17725
2681,6,0,19,6,64500240,3641,408780,23,17731
2682,7,0,12,13,64556160,3641,408780,23,17738
2683,5,0,12,13,64567440,3641,408780,23,17743
2684,6,0,12,13,64573860,3640,408780,23,17749
2685,3,0,12,13,64579500,3640,408780,23,17752
2686,8,0,15,10,64593960,3640,408780,23,17760
2687,4,0,13,12,64607940,3639,408780,23,17764

