Hour,Arrivals,Waiting,Treating,Available Rooms,Total Treatment Time,Average Treatment Time,Total Wait Time,Average Wait Time,Total Arrivals
1,6,0,5,20,780,780,0,0,6
2,2,0,5,20,9900,3300,0,0,8
3,2,0,4,21,23880,3980,0,0,10
4,5,0,5,20,51600,5160,0,0,15
5,3,0,3,22,72660,4844,0,0,18
6,4,0,3,22,81240,4275,0,0,22
7,9,0,6,19,97320,3892,0,0,31
8,6,0,7,18,111120,3704,0,0,37
9,10,0,10,15,130140,3517,0,0,47
10,6,0,5,20,165480,3447,0,0,53
11,14,0,15,10,187020,3596,0,0,67
12,3,0,8,17,234180,3777,0,0,70
13,10,0,12,13,248340,3652,0,0,80
14,11,0,14,11,295260,3834,0,0,91
15,8,0,7,18,344400,3743,0,0,99
16,11,0,9,16,380340,3765,0,0,110
17,13,0,12,13,411300,3705,0,0,123
18,7,0,11,14,436980,3672,0,0,130
19,4,0,8,17,476100,3778,0,0,134
20,4,0,2,23,514440,3782,0,0,138
21,3,0,3,22,523320,3792,0,0,141
22,5,0,3,22,537420,3758,0,0,146
23,3,0,2,23,548340,3730,0,0,149
24,5,0,6,19,551280,3724,0,0,154
25,9,0,12,13,559500,3705,0,0,163
26,5,0,10,15,597660,3782,0,0,168
27,8,0,9,16,639300,3828,0,0,176
28,3,0,3,22,676980,3846,0,0,179
29,9,0,8,17,692580,3847,0,0,188
30,4,0,6,19,709860,3816,0,0,192
31,11,0,12,13,727200,3807,0,0,203
32,8,0,7,18,784680,3846,0,0,211
33,2,0,4,21,811740,3883,0,0,213
34,4,0,4,21,823500,3866,0,0,217
35,1,0,4,21,833760,3896,0,0,218
36,13,0,9,16,855840,3855,0,0,231
37,9,0,12,13,875760,3841,0,0,240
38,11,0,12,13,919680,3848,0,0,251
39,10,0,8,17,985200,3894,0,0,261
40,6,0,7,18,1013340,3897,0,0,267
41,7,0,5,20,1050840,3906,0,0,274
42,5,0,6,19,1063980,3897,0,0,279
43,8,0,6,19,1091040,3882,0,0,287
44,3,0,3,22,1111680,3873,0,0,290
45,3,0,3,22,1123500,3874,0,0,293
46,3,0,2,23,1136820,3866,0,0,296
47,4,0,4,21,1144980,3868,0,0,300
48,8,0,7,18,1161360,3858,0,0,308
49,3,0,3,22,1176960,3821,0,0,311
50,4,0,5,20,1183140,3816,0,0,315
51,5,0,4,21,1208280,3823,0,0,320
52,3,0,3,22,1223640,3823,0,0,323
53,4,0,3,22,1233360,3806,0,0,327
54,7,0,6,19,1248120,3805,0,0,334
55,8,0,6,19,1266120,3768,0,0,342
56,6,0,4,21,1292520,3757,0,0,348
57,9,0,10,15,1301340,3750,0,0,357
58,8,0,7,18,1340220,3743,0,0,365
59,8,0,9,16,1359600,3735,0,0,373
60,11,0,12,13,1383480,3719,0,0,384
61,10,0,9,16,1428780,3711,0,0,394
62,13,0,11,14,1463100,3694,0,0,407
63,10,0,13,12,1489320,3686,0,0,417
64,10,0,11,14,1538880,3699,0,0,427
65,7,0,7,18,1581300,3703,0,0,434
66,9,0,8,17,1610400,3702,0,0,443
67,10,0,11,14,1631280,3690,0,0,453
68,8,0,12,13,1669320,3717,0,0,461
69,4,0,3,22,1727040,3738,0,0,465
70,6,0,6,19,1733520,3728,0,0,471
71,4,0,4,21,1752960,3721,0,0,475
72,6,0,4,21,1763880,3697,0,0,481
73,3,0,3,22,1781580,3703,0,0,484
74,3,0,2,23,1791600,3694,0,0,487
75,6,0,7,18,1792260,3687,0,0,493
76,5,0,9,16,1801560,3684,0,0,498
77,9,0,8,17,1854540,3716,0,0,507
78,4,0,3,22,1880880,3702,0,0,511
79,5,0,5,20,1897380,3713,0,0,516
80,7,0,9,16,1905480,3707,0,0,523
81,8,0,6,19,1938060,3691,0,0,531
82,5,0,2,23,1967280,3684,0,0,536
83,6,0,7,18,1967760,3678,0,0,542
84,7,0,8,17,1988220,3675,0,0,549
85,10,0,9,16,2027880,3687,0,0,559
86,11,0,9,16,2054880,3662,0,0,570
87,13,0,9,16,2088300,3638,0,0,583
88,8,0,11,14,2111220,3640,0,0,591
89,6,0,6,19,2157120,3649,0,0,597
90,8,0,6,19,2192580,3660,0,0,605
91,9,0,9,16,2204520,3643,0,0,614
92,7,0,7,18,2244000,3654,0,0,621
93,6,0,4,21,2268300,3640,0,0,627
94,7,0,7,18,2277060,3631,0,0,634
95,9,0,10,15,2308140,3646,0,0,643
96,6,0,5,20,2348760,3647,0,0,649
97,3,0,5,20,2365680,3656,0,0,652
98,1,0,1,24,2393400,3670,0,0,653
99,3,0,2,23,2395020,3662,0,0,656
100,8,0,2,23,2413380,3645,0,0,664
101,4,0,2,23,2416440,3628,0,0,668
102,6,0,4,21,2428980,3625,0,0,674
103,11,0,12,13,2432100,3613,0,0,685
104,7,0,8,17,2468160,3608,0,0,692
105,7,0,9,16,2488800,3606,0,0,699
106,8,0,5,20,2535000,3611,0,0,707
107,4,0,5,20,2547300,3608,0,0,711
108,6,0,5,20,2566260,3604,0,0,717
109,5,0,3,22,2581920,3590,0,0,722
110,4,0,2,23,2600400,3591,0,0,726
111,7,0,6,19,2607900,3587,0,0,733
112,8,0,9,16,2620080,3579,0,0,741
113,9,0,7,18,2657700,3576,0,0,750
114,7,0,8,17,2685540,3585,0,0,757
115,7,0,9,16,2713440,3593,0,0,764
116,8,0,10,15,2741700,3598,0,0,772
117,10,0,8,17,2788800,3603,0,0,782
118,3,0,6,19,2809740,3606,0,0,785
119,5,0,3,22,2857440,3630,0,0,790
120,5,0,5,20,2871240,3634,0,0,795
121,3,0,3,22,2882100,3625,0,0,798
122,6,0,6,19,2889840,3621,0,0,804
123,6,0,8,17,2913480,3632,0,0,810
124,4,0,5,20,2928660,3620,0,0,814
125,1,0,4,21,2948640,3635,0,0,815
126,3,0,1,24,2977860,3644,0,0,818
127,4,0,3,22,2982780,3641,0,0,822
128,11,0,9,16,2992260,3631,0,0,833
129,11,0,12,13,3012000,3620,0,0,844
130,9,0,12,13,3061980,3640,0,0,853
131,11,0,15,10,3098520,3649,0,0,864
132,10,0,13,12,3137400,3643,0,0,874
133,14,0,18,7,3195180,3672,0,0,888
134,11,0,16,9,3256860,3688,0,0,899
135,8,0,12,13,3312900,3701,0,0,907
136,10,0,7,18,3368340,3701,0,0,917
137,2,0,5,20,3390060,3709,0,0,919
138,6,0,5,20,3419040,3716,0,0,925
139,10,0,9,16,3433380,3707,0,0,935
140,6,0,9,16,3454020,3706,0,0,941
141,3,0,3,22,3499500,3718,0,0,944
142,5,0,4,21,3517080,3721,0,0,949
143,5,0,5,20,3529740,3719,0,0,954
144,5,0,4,21,3548400,3715,0,0,959
145,3,0,6,19,3551640,3715,0,0,962
146,6,0,9,16,3557280,3709,0,0,968
147,7,0,8,17,3596580,3719,0,0,975
148,6,0,7,18,3623880,3720,0,0,981
149,5,0,5,20,3655620,3726,0,0,986
150,3,0,3,22,3673980,3726,0,0,989
151,10,0,10,15,3688560,3729,0,0,999
152,7,0,8,17,3705660,3713,0,0,1006
153,6,0,6,19,3742080,3719,0,0,1012
154,12,0,10,15,3778980,3726,0,0,1024
155,11,0,11,14,3797820,3708,0,0,1035
156,7,0,7,18,3840180,3710,0,0,1042
157,14,0,10,15,3879600,3708,0,0,1056
158,18,0,19,6,3902940,3699,0,0,1074
159,6,0,7,18,3974580,3704,0,0,1080
160,4,0,6,19,3994860,3705,0,0,1084
161,4,0,3,22,4026240,3710,0,0,1088
162,12,0,10,15,4038060,3704,0,0,1100
163,3,0,5,20,4064100,3701,0,0,1103
164,7,0,7,18,4087920,3706,0,0,1110
165,8,0,10,15,4100400,3700,0,0,1118
166,3,0,3,22,4142940,3705,0,0,1121
167,4,0,5,20,4148880,3704,0,0,1125
168,6,0,4,21,4168860,3699,0,0,1131
169,2,0,2,23,4185120,3700,0,0,1133
170,6,0,7,18,4192080,3703,0,0,1139
171,1,0,4,21,4201440,3698,0,0,1140
172,9,0,8,17,4227000,3704,0,0,1149
173,6,0,9,16,4249920,3708,0,0,1155
174,5,0,6,19,4282500,3711,0,0,1160
175,8,0,6,19,4300860,3701,0,0,1168
176,6,0,6,19,4326060,3703,0,0,1174
177,5,0,5,20,4345920,3701,0,0,1179
178,11,0,8,17,4362720,3690,0,0,1190
179,7,0,9,16,4385220,3691,0,0,1197
180,12,0,9,16,4428360,3690,0,0,1209
181,11,0,9,16,4453080,3677,0,0,1220
182,6,0,8,17,4482900,3680,0,0,1226
183,11,0,9,16,4519380,3680,0,0,1237
184,13,0,11,14,4544400,3667,0,0,1250
185,8,0,9,16,4576560,3664,0,0,1258
186,5,0,5,20,4605900,3661,0,0,1263
187,5,0,5,20,4642440,3675,0,0,1268
188,7,0,8,17,4653780,3673,0,0,1275
189,7,0,10,15,4678620,3678,0,0,1282
190,5,0,8,17,4702860,3676,0,0,1287
191,6,0,8,17,4726980,3678,0,0,1293
192,4,0,7,18,4755480,3686,0,0,1297
193,2,0,1,24,4797120,3695,0,0,1299
194,6,0,6,19,4798020,3693,0,0,1305
195,11,0,8,17,4817220,3682,0,0,1316
196,6,0,7,18,4844280,3683,0,0,1322
197,8,0,9,16,4870200,3686,0,0,1330
198,7,0,10,15,4897140,3690,0,0,1337
199,3,0,4,21,4941360,3698,0,0,1340
200,6,0,6,19,4950540,3694,0,0,1346
201,4,0,3,22,4973520,3692,0,0,1350
202,7,0,7,18,4982880,3691,0,0,1357
203,9,0,10,15,5000400,3687,0,0,1366
204,10,0,13,12,5031540,3691,0,0,1376
205,11,0,10,15,5088300,3695,0,0,1387
206,13,0,11,14,5127780,3691,0,0,1400
207,4,0,7,18,5164800,3697,0,0,1404
208,15,0,15,10,5188260,3695,0,0,1419
209,4,0,9,16,5229840,3698,0,0,1423
210,16,0,14,11,5271900,3699,0,0,1439
211,6,0,5,20,5325300,3698,0,0,1445
212,5,0,5,20,5344560,3698,0,0,1450
213,6,0,4,21,5369040,3697,0,0,1456
214,5,0,5,20,5382780,3696,0,0,1461
215,3,0,1,24,5406540,3695,0,0,1464
216,4,0,5,20,5406540,3695,0,0,1468
217,5,0,6,19,5425260,3698,0,0,1473
218,5,0,6,19,5443920,3698,0,0,1478
219,1,0,0,25,5473500,3700,0,0,1479
220,4,0,4,21,5473500,3700,0,0,1483
221,9,0,7,18,5482320,3691,0,0,1492
222,6,0,8,17,5496060,3688,0,0,1498
223,9,0,11,14,5515380,3686,0,0,1507
224,5,0,6,19,5557620,3690,0,0,1512
225,4,0,4,21,5584500,3693,0,0,1516
226,11,0,8,17,5602800,3688,0,0,1527
227,8,0,10,15,5620020,3685,0,0,1535
228,7,0,9,16,5658120,3690,0,0,1542
229,12,0,15,10,5683740,3693,0,0,1554
230,10,0,13,12,5723040,3689,0,0,1564
231,6,0,6,19,5790000,3702,0,0,1570
232,13,0,9,16,5818260,3696,0,0,1583
233,5,0,5,20,5848440,3694,0,0,1588
234,15,0,10,15,5875200,3688,0,0,1603
235,9,0,9,16,5904120,3683,0,0,1612
236,5,0,11,14,5918520,3685,0,0,1617
237,5,0,4,21,5976540,3693,0,0,1622
238,4,0,3,22,5999760,3696,0,0,1626
239,7,0,7,18,6006480,3694,0,0,1633
240,8,0,8,17,6026040,3690,0,0,1641
241,7,0,5,20,6059340,3687,0,0,1648
242,5,0,5,20,6078240,3688,0,0,1653
243,2,0,3,22,6097740,3691,0,0,1655
244,6,0,5,20,6114600,3692,0,0,1661
245,3,0,6,19,6117960,3689,0,0,1664
246,3,0,4,21,6137400,3690,0,0,1667
247,6,0,4,21,6161820,3691,0,0,1673
248,3,0,5,20,6172500,3693,0,0,1676
249,5,0,6,19,6192600,3697,0,0,1681
250,8,0,5,20,6220980,3694,0,0,1689
251,5,0,4,21,6234240,3688,0,0,1694
252,6,0,5,20,6247440,3685,0,0,1700
253,13,0,10,15,6261120,3676,0,0,1713
254,9,0,13,12,6285420,3677,0,0,1722
255,8,0,8,17,6343320,3683,0,0,1730
256,2,0,4,21,6358140,3679,0,0,1732
257,6,0,5,20,6382440,3682,0,0,1738
258,6,0,8,17,6395460,3684,0,0,1744
259,8,0,6,19,6427560,3681,0,0,1752
260,4,0,7,18,6439440,3681,0,0,1756
261,2,0,2,23,6470700,3684,0,0,1758
262,6,0,4,21,6483720,3683,0,0,1764
263,4,0,5,20,6497640,3685,0,0,1768
264,2,0,1,24,6515820,3683,0,0,1770
265,4,0,3,22,6523860,3683,0,0,1774
266,3,0,3,22,6531840,3681,0,0,1777
267,2,0,3,22,6541380,3683,0,0,1779
268,8,0,6,19,6551040,3678,0,0,1787
269,7,0,6,19,6576600,3678,0,0,1794
270,6,0,8,17,6586740,3675,0,0,1800
271,7,0,10,15,6613080,3680,0,0,1807
272,3,0,5,20,6654600,3686,0,0,1810
273,5,0,3,22,6682980,3688,0,0,1815
274,10,0,8,17,6690600,3682,0,0,1825
275,7,0,9,16,6711720,3681,0,0,1832
276,4,0,3,22,6751680,3683,0,0,1836
277,8,0,6,19,6759840,3677,0,0,1844
278,6,0,9,16,6771120,3677,0,0,1850
279,14,0,13,12,6801120,3674,0,0,1864
280,20,0,20,5,6849660,3674,0,0,1884
281,10,0,19,6,6884100,3671,0,0,1894
282,3,0,3,22,6978600,3684,0,0,1897
283,12,0,7,18,7004220,3682,0,0,1909
284,8,0,8,17,7021380,3678,0,0,1917
285,13,0,14,11,7040820,3674,0,0,1930
286,4,0,6,19,7080240,3672,0,0,1934
287,3,0,3,22,7113660,3678,0,0,1937
288,4,0,3,22,7128180,3678,0,0,1941
289,5,0,4,21,7141980,3677,0,0,1946
290,3,0,4,21,7157220,3679,0,0,1949
291,6,0,2,23,7174200,3673,0,0,1955
292,2,0,3,22,7174800,3671,0,0,1957
293,4,0,4,21,7185180,3671,0,0,1961
294,9,0,9,16,7198800,3670,0,0,1970
295,4,0,5,20,7225800,3669,0,0,1974
296,9,0,9,16,7250040,3672,0,0,1983
297,12,0,12,13,7274100,3668,0,0,1995
298,3,0,8,17,7303080,3669,0,0,1998
299,6,0,6,19,7340520,3673,0,0,2004
300,9,0,8,17,7362720,3672,0,0,2013
301,12,0,12,13,7380000,3666,0,0,2025
302,9,0,12,13,7419960,3669,0,0,2034
303,14,0,16,9,7462080,3672,0,0,2048
304,5,0,11,14,7506000,3675,0,0,2053
305,11,0,9,16,7576140,3686,0,0,2064
306,7,0,8,17,7613340,3690,0,0,2071
307,8,0,13,12,7631220,3693,0,0,2079
308,6,0,9,16,7662780,3691,0,0,2085
309,7,0,7,18,7707420,3696,0,0,2092
310,10,0,11,14,7728840,3696,0,0,2102
311,6,0,7,18,7767480,3697,0,0,2108
312,5,0,6,19,7796520,3700,0,0,2113
313,7,0,6,19,7817460,3697,0,0,2120
314,7,0,6,19,7836240,3694,0,0,2127
315,9,0,9,16,7862400,3696,0,0,2136
316,8,0,7,18,7891620,3692,0,0,2144
317,2,0,5,20,7910220,3694,0,0,2146
318,9,0,7,18,7935360,3694,0,0,2155
319,4,0,5,20,7956720,3693,0,0,2159
320,3,0,1,24,7984320,3694,0,0,2162
321,5,0,5,20,7986780,3694,0,0,2167
322,6,0,6,19,8001240,3692,0,0,2173
323,11,0,13,12,8015940,3692,0,0,2184
324,12,0,13,12,8057400,3690,0,0,2196
325,5,0,7,18,8095620,3689,0,0,2201
326,6,0,6,19,8128020,3692,0,0,2207
327,10,0,6,19,8152620,3687,0,0,2217
328,13,0,8,17,8188920,3685,0,0,2230
329,7,0,11,14,8201460,3684,0,0,2237
330,7,0,4,21,8251620,3683,0,0,2244
331,7,0,7,18,8262180,3681,0,0,2251
332,9,0,7,18,8282040,3676,0,0,2260
333,4,0,7,18,8297700,3676,0,0,2264
334,6,0,7,18,8327040,3679,0,0,2270
335,4,0,5,20,8351280,3680,0,0,2274
336,4,0,3,22,8368740,3678,0,0,2278
337,1,0,1,24,8385060,3680,0,0,2279
338,3,0,1,24,8391600,3678,0,0,2282
339,9,0,6,19,8399640,3675,0,0,2291
340,11,0,11,14,8407080,3669,0,0,2302
341,8,0,8,17,8446440,3669,0,0,2310
342,9,0,8,17,8475120,3667,0,0,2319
343,7,0,7,18,8506740,3668,0,0,2326
344,5,0,8,17,8523180,3669,0,0,2331
345,4,0,5,20,8552880,3670,0,0,2335
346,9,0,7,18,8569500,3666,0,0,2344
347,9,0,11,14,8580600,3663,0,0,2353
348,7,0,7,18,8628720,3667,0,0,2360
349,12,0,10,15,8659260,3666,0,0,2372
350,7,0,8,17,8682840,3662,0,0,2379
351,4,0,4,21,8713860,3662,0,0,2383
352,10,0,7,18,8734380,3660,0,0,2393
353,8,0,9,16,8750820,3658,0,0,2401
354,8,0,8,17,8777880,3655,0,0,2409
355,11,0,6,19,8833680,3659,0,0,2420
356,6,0,9,16,8844540,3659,0,0,2426
357,4,0,5,20,8863560,3655,0,0,2430
358,6,0,4,21,8883900,3652,0,0,2436
359,3,0,5,20,8894460,3654,0,0,2439
360,8,0,7,18,8911740,3652,0,0,2447
361,3,0,6,19,8917920,3648,0,0,2450
362,6,0,8,17,8938500,3651,0,0,2456
363,4,0,5,20,8972760,3654,0,0,2460
364,5,0,6,19,8983740,3653,0,0,2465
365,5,0,6,19,8997660,3651,0,0,2470
366,5,0,4,21,9030240,3654,0,0,2475
367,4,0,2,23,9049980,3653,0,0,2479
368,12,0,9,16,9062400,3651,0,0,2491
369,6,0,8,17,9088440,3651,0,0,2497
370,8,0,7,18,9126360,3653,0,0,2505
371,10,0,9,16,9151920,3652,0,0,2515
372,11,0,10,15,9182280,3649,0,0,2526
373,9,0,6,19,9218820,3645,0,0,2535
374,6,0,3,22,9247500,3643,0,0,2541
375,14,0,11,14,9264660,3641,0,0,2555
376,13,0,16,9,9288000,3639,0,0,2568
377,8,0,13,12,9322380,3637,0,0,2576
378,6,0,7,18,9379500,3642,0,0,2582
379,9,0,7,18,9404100,3639,0,0,2591
380,7,0,9,16,9415140,3636,0,0,2598
381,3,0,4,21,9452040,3639,0,0,2601
382,4,0,2,23,9470700,3638,0,0,2605
383,5,0,4,21,9482760,3638,0,0,2610
384,5,0,3,22,9491580,3633,0,0,2615
385,5,0,4,21,9502500,3632,0,0,2620
386,2,0,3,22,9517020,3633,0,0,2622
387,7,0,5,20,9531360,3632,0,0,2629
388,5,0,6,19,9556200,3636,0,0,2634
389,5,0,6,19,9575160,3636,0,0,2639
390,11,0,10,15,9595620,3634,0,0,2650
391,4,0,3,22,9628800,3632,0,0,2654
392,8,0,7,18,9644700,3632,0,0,2662
393,5,0,6,19,9660060,3630,0,0,2667
394,12,0,12,13,9683640,3630,0,0,2679
395,14,0,14,11,9718920,3627,0,0,2693
396,11,0,16,9,9757200,3629,0,0,2704
397,12,0,12,13,9810060,3627,0,0,2716
398,3,0,5,20,9859080,3632,0,0,2719
399,8,0,9,16,9880080,3635,0,0,2727
400,7,0,10,15,9902640,3635,0,0,2734
401,9,0,7,18,9943800,3634,0,0,2743
402,7,0,8,17,9961980,3633,0,0,2750
403,12,0,10,15,9994140,3631,0,0,2762
404,7,0,9,16,10011300,3627,0,0,2769
405,8,0,6,19,10061820,3631,0,0,2777
406,6,0,4,21,10093560,3632,0,0,2783
407,5,0,7,18,10096020,3630,0,0,2788
408,4,0,4,21,10119180,3629,0,0,2792
409,8,0,8,17,10133940,3629,0,0,2800
410,9,0,8,17,10171380,3631,0,0,2809
411,7,0,10,15,10187460,3630,0,0,2816
412,4,0,5,20,10219200,3630,0,0,2820
413,9,0,8,17,10253400,3634,0,0,2829
414,8,0,8,17,10290720,3637,0,0,2837
415,8,0,12,13,10310580,3639,0,0,2845
416,10,0,10,15,10354080,3639,0,0,2855
417,8,0,5,20,10406280,3641,0,0,2863
418,7,0,6,19,10418880,3637,0,0,2870
419,8,0,9,16,10442580,3639,0,0,2878
420,7,0,7,18,10472400,3638,0,0,2885
421,11,0,11,14,10508160,3642,0,0,2896
422,14,0,13,12,10541460,3638,0,0,2910
423,7,0,9,16,10567080,3633,0,0,2917
424,8,0,8,17,10613880,3638,0,0,2925
425,16,0,15,10,10648980,3639,0,0,2941
426,9,0,10,15,10700340,3639,0,0,2950
427,9,0,10,15,10738320,3641,0,0,2959
428,6,0,8,17,10777440,3644,0,0,2965
429,6,0,10,15,10797900,3646,0,0,2971
430,5,0,7,18,10842300,3651,0,0,2976
431,5,0,7,18,10864980,3653,0,0,2981
432,6,0,8,17,10888020,3654,0,0,2987
433,5,0,5,20,10911240,3652,0,0,2992
434,4,0,4,21,10936860,3655,0,0,2996
435,3,0,4,21,10951920,3656,0,0,2999
436,10,0,9,16,10961400,3653,0,0,3009
437,8,0,10,15,10988820,3654,0,0,3017
438,5,0,7,18,11029440,3658,0,0,3022
439,6,0,6,19,11045340,3654,0,0,3028
440,4,0,6,19,11066820,3657,0,0,3032
441,4,0,5,20,11087520,3658,0,0,3036
442,7,0,8,17,11107320,3659,0,0,3043
443,16,0,13,12,11143320,3658,0,0,3059
444,13,0,15,10,11172540,3654,0,0,3072
445,14,0,17,8,11219820,3655,0,0,3086
446,7,0,10,15,11284860,3660,0,0,3093
447,4,0,5,20,11329020,3663,0,0,3097
448,9,0,8,17,11354700,3665,0,0,3106
449,9,0,7,18,11381580,3662,0,0,3115
450,8,0,6,19,11425020,3665,0,0,3123
451,6,0,5,20,11448540,3664,0,0,3129
452,6,0,4,21,11464740,3661,0,0,3135
453,3,0,3,22,11481180,3662,0,0,3138
454,4,0,4,21,11494560,3663,0,0,3142
455,5,0,4,21,11510580,3662,0,0,3147
456,1,0,1,24,11530680,3664,0,0,3148
457,6,0,1,24,11543880,3661,0,0,3154
458,5,0,2,23,11548320,3658,0,0,3159
459,4,0,3,22,11554200,3656,0,0,3163
460,2,0,2,23,11565180,3656,0,0,3165
461,6,0,5,20,11569320,3654,0,0,3171
462,0,0,0,25,11590500,3655,0,0,3171
463,5,0,4,21,11591400,3654,0,0,3176
464,8,0,7,18,11598480,3650,0,0,3184
465,5,0,9,16,11606940,3649,0,0,3189
466,7,0,12,13,11620620,3649,0,0,3196
467,9,0,9,16,11676540,3653,0,0,3205
468,10,0,11,14,11704920,3653,0,0,3215
469,10,0,12,13,11738460,3653,0,0,3225
470,5,0,3,22,11788980,3653,0,0,3230
471,7,0,5,20,11800620,3651,0,0,3237
472,12,0,9,16,11814540,3646,0,0,3249
473,12,0,14,11,11848740,3649,0,0,3261
474,5,0,11,14,11867220,3645,0,0,3266
475,6,0,7,18,11915460,3649,0,0,3272
476,7,0,6,19,11945760,3649,0,0,3279
477,4,0,6,19,11961540,3650,0,0,3283
478,5,0,5,20,11985420,3650,0,0,3288
479,2,0,3,22,11993640,3648,0,0,3290
480,3,0,3,22,12022140,3654,0,0,3293
481,6,0,6,19,12028140,3652,0,0,3299
482,5,0,2,23,12056760,3651,0,0,3304
483,3,0,4,21,12061200,3651,0,0,3307
484,5,0,3,22,12082440,3651,0,0,3312
485,5,0,6,19,12089580,3651,0,0,3317
486,6,0,7,18,12106980,3651,0,0,3323
487,7,0,5,20,12130500,3648,0,0,3330
488,5,0,4,21,12159780,3650,0,0,3335
489,9,0,6,19,12175020,3647,0,0,3344
490,4,0,3,22,12199740,3647,0,0,3348
491,12,0,13,12,12207720,3647,0,0,3360
492,6,0,9,16,12237840,3645,0,0,3366
493,12,0,16,9,12253440,3644,0,0,3378
494,6,0,7,18,12324960,3649,0,0,3384
495,7,0,4,21,12352080,3646,0,0,3391
496,8,0,9,16,12362640,3646,0,0,3399
497,13,0,12,13,12397980,3646,0,0,3412
498,5,0,8,17,12426780,3645,0,0,3417
499,5,0,6,19,12459840,3647,0,0,3422
500,5,0,7,18,12477600,3648,0,0,3427
501,9,0,10,15,12505920,3650,0,0,3436
502,3,0,5,20,12548160,3654,0,0,3439
503,5,0,5,20,12570780,3655,0,0,3444
504,4,0,6,19,12585180,3656,0,0,3448
505,4,0,3,22,12610680,3656,0,0,3452
506,7,0,5,20,12631200,3656,0,0,3459
507,4,0,7,18,12640320,3657,0,0,3463
508,3,0,5,20,12662580,3658,0,0,3466
509,3,0,5,20,12674460,3658,0,0,3469
510,5,0,3,22,12703560,3659,0,0,3474
511,9,0,7,18,12710700,3656,0,0,3483
512,7,0,7,18,12731400,3655,0,0,3490
513,5,0,6,19,12756600,3656,0,0,3495
514,14,0,7,18,12790860,3652,0,0,3509
515,18,0,16,9,12810180,3648,0,0,3527
516,11,0,13,12,12844680,3643,0,0,3538
517,9,0,8,17,12911460,3648,0,0,3547
518,7,0,7,18,12944160,3649,0,0,3554
519,11,0,13,12,12958620,3648,0,0,3565
520,8,0,9,16,13009800,3650,0,0,3573
521,5,0,3,22,13052520,3651,0,0,3578
522,5,0,7,18,13057500,3651,0,0,3583
523,5,0,6,19,13082460,3652,0,0,3588
524,11,0,9,16,13100040,3649,0,0,3599
525,5,0,6,19,13136460,3651,0,0,3604
526,8,0,6,19,13166460,3651,0,0,3612
527,5,0,4,21,13177800,3647,0,0,3617
528,3,0,4,21,13188180,3647,0,0,3620
529,9,0,6,19,13209540,3646,0,0,3629
530,2,0,4,21,13221060,3645,0,0,3631
531,3,0,3,22,13244340,3647,0,0,3634
532,5,0,6,19,13246380,3646,0,0,3639
533,2,0,4,21,13264980,3647,0,0,3641
534,6,0,4,21,13297500,3650,0,0,3647
535,4,0,5,20,13308780,3650,0,0,3651
536,7,0,9,16,13319100,3650,0,0,3658
537,8,0,11,14,13343280,3650,0,0,3666
538,13,0,12,13,13398600,3653,0,0,3679
539,12,0,10,15,13436280,3650,0,0,3691
540,12,0,9,16,13477620,3648,0,0,3703
541,8,0,8,17,13502220,3646,0,0,3711
542,9,0,10,15,13542120,3650,0,0,3720
543,10,0,13,12,13560360,3648,0,0,3730
544,8,0,9,16,13618440,3652,0,0,3738
545,11,0,15,10,13631100,3650,0,0,3749
546,7,0,7,18,13696380,3653,0,0,3756
547,9,0,10,15,13722720,3654,0,0,3765
548,4,0,7,18,13747260,3654,0,0,3769
549,7,0,8,17,13783620,3658,0,0,3776
550,5,0,6,19,13807860,3657,0,0,3781
551,7,0,4,21,13839180,3657,0,0,3788
552,5,0,5,20,13853160,3657,0,0,3793
553,2,0,2,23,13874640,3657,0,0,3795
554,6,0,4,21,13887240,3657,0,0,3801
555,5,0,7,18,13889700,3656,0,0,3806
556,7,0,4,21,13921620,3654,0,0,3813
557,6,0,4,21,13934220,3652,0,0,3819
558,7,0,7,18,13948260,3652,0,0,3826
559,4,0,5,20,13960620,3649,0,0,3830
560,7,0,7,18,13985400,3651,0,0,3837
561,7,0,7,18,14005680,3650,0,0,3844
562,3,0,5,20,14032920,3652,0,0,3847
563,12,0,13,12,14051040,3653,0,0,3859
564,5,0,8,17,14090400,3654,0,0,3864
565,4,0,2,23,14130300,3655,0,0,3868
566,15,0,13,12,14134620,3652,0,0,3883
567,9,0,12,13,14169720,3651,0,0,3892
568,10,0,12,13,14215440,3654,0,0,3902
569,20,0,16,9,14260320,3650,0,0,3922
570,9,0,13,12,14314200,3653,0,0,3931
571,7,0,8,17,14363280,3654,0,0,3938
572,1,0,6,19,14386620,3657,0,0,3939
573,0,0,0,25,14430240,3663,0,0,3939
574,6,0,5,20,14433420,3663,0,0,3945
575,5,0,4,21,14444460,3660,0,0,3950
576,2,0,2,23,14462160,3661,0,0,3952
577,6,0,5,20,14477100,3662,0,0,3958
578,6,0,2,23,14498580,3659,0,0,3964
579,5,0,5,20,14505300,3659,0,0,3969
580,7,0,3,22,14524500,3655,0,0,3976
581,8,0,6,19,14537220,3654,0,0,3984
582,1,0,4,21,14549820,3654,0,0,3985
583,6,0,3,22,14566920,3652,0,0,3991
584,9,0,4,21,14584140,3649,0,0,4000
585,10,0,9,16,14587620,3645,0,0,4010
586,7,0,6,19,14627520,3646,0,0,4017
587,10,0,7,18,14655780,3645,0,0,4027
588,10,0,12,13,14666460,3643,0,0,4037
589,9,0,13,12,14686860,3641,0,0,4046
590,10,0,12,13,14734980,3643,0,0,4056
591,6,0,10,15,14779500,3647,0,0,4062
592,8,0,11,14,14808360,3648,0,0,4070
593,11,0,10,15,14855820,3649,0,0,4081
594,5,0,6,19,14897820,3651,0,0,4086
595,6,0,5,20,14923260,3651,0,0,4092
596,8,0,7,18,14941560,3650,0,0,4100
597,7,0,8,17,14963760,3650,0,0,4107
598,3,0,3,22,14984280,3648,0,0,4110
599,6,0,3,22,14998680,3646,0,0,4116
600,7,0,5,20,15023760,3648,0,0,4123
601,8,0,5,20,15043920,3646,0,0,4131
602,5,0,7,18,15046980,3644,0,0,4136
603,12,0,9,16,15085440,3644,0,0,4148
604,3,0,5,20,15111720,3644,0,0,4151
605,8,0,7,18,15143640,3647,0,0,4159
606,9,0,10,15,15158640,3645,0,0,4168
607,4,0,4,21,15196620,3646,0,0,4172
608,2,0,2,23,15212700,3646,0,0,4174
609,11,0,7,18,15225900,3644,0,0,4185
610,8,0,9,16,15238740,3642,0,0,4193
611,6,0,6,19,15273720,3642,0,0,4199
612,3,0,7,18,15287820,3644,0,0,4202
613,8,0,8,17,15313200,3644,0,0,4210
614,16,0,13,12,15352080,3643,0,0,4226
615,6,0,9,16,15389340,3644,0,0,4232
616,9,0,8,17,15427440,3644,0,0,4241
617,2,0,3,22,15446940,3643,0,0,4243
618,8,0,5,20,15480000,3645,0,0,4251
619,2,0,4,21,15490200,3645,0,0,4253
620,4,0,2,23,15514260,3646,0,0,4257
621,5,0,3,22,15530160,3646,0,0,4262
622,4,0,4,21,15537720,3645,0,0,4266
623,2,0,2,23,15552240,3645,0,0,4268
624,3,0,4,21,15554340,3645,0,0,4271
625,4,0,3,22,15572700,3645,0,0,4275
626,4,0,6,19,15574080,3644,0,0,4279
627,6,0,5,20,15593580,3643,0,0,4285
628,2,0,4,21,15599640,3642,0,0,4287
629,8,0,6,19,15615420,3640,0,0,4295
630,7,0,5,20,15643680,3640,0,0,4302
631,8,0,5,20,15659100,3637,0,0,4310
632,3,0,2,23,15692400,3640,0,0,4313
633,9,0,7,18,15700080,3638,0,0,4322
634,11,0,9,16,15724260,3636,0,0,4333
635,7,0,7,18,15751500,3635,0,0,4340
636,17,0,16,9,15780720,3635,0,0,4357
637,12,0,11,14,15833460,3633,0,0,4369
638,14,0,16,9,15854520,3630,0,0,4383
639,8,0,9,16,15918180,3632,0,0,4391
640,5,0,8,17,15951840,3635,0,0,4396
641,6,0,4,21,15993720,3636,0,0,4402
642,8,0,7,18,16008360,3635,0,0,4410
643,7,0,5,20,16037760,3635,0,0,4417
644,3,0,4,21,16051380,3634,0,0,4420
645,5,0,4,21,16077780,3636,0,0,4425
646,6,0,5,20,16092900,3635,0,0,4431
647,5,0,6,19,16100700,3634,0,0,4436
648,6,0,4,21,16130520,3634,0,0,4442
649,2,0,3,22,16140840,3634,0,0,4444
650,3,0,2,23,16152840,3633,0,0,4447
651,8,0,7,18,16162260,3633,0,0,4455
652,5,0,9,16,16173300,3633,0,0,4460
653,6,0,8,17,16201800,3634,0,0,4466
654,5,0,6,19,16244580,3638,0,0,4471
655,6,0,7,18,16261080,3637,0,0,4477
656,10,0,9,16,16290000,3637,0,0,4487
657,5,0,7,18,16310160,3636,0,0,4492
658,8,0,8,17,16333800,3636,0,0,4500
659,8,0,8,17,16358820,3635,0,0,4508
660,6,0,5,20,16393260,3635,0,0,4514
661,7,0,8,17,16406220,3635,0,0,4521
662,14,0,12,13,16432020,3632,0,0,4535
663,15,0,22,3,16449420,3632,0,0,4550
664,4,0,9,16,16533840,3637,0,0,4554
665,6,0,9,16,16556100,3637,0,0,4560
666,5,0,6,19,16597380,3640,0,0,4565
667,5,0,4,21,16635000,3643,0,0,4570
668,1,0,1,24,16650960,3643,0,0,4571
669,3,0,3,22,16653180,3643,0,0,4574
670,7,0,4,21,16666140,3641,0,0,4581
671,5,0,5,20,16683600,3641,0,0,4586
672,3,0,7,18,16685580,3641,0,0,4589
673,4,0,11,14,16685580,3641,0,0,4593
674,4,0,12,13,16689840,3640,0,0,4597
675,2,0,8,17,16716480,3641,0,0,4599
676,10,0,15,10,16725060,3640,0,0,4609
677,5,0,16,9,16746720,3642,0,0,4614
678,10,0,19,6,16774920,3642,0,0,4624
679,7,0,15,10,16825020,3644,0,0,4631
680,6,0,13,12,16866540,3647,0,0,4637
681,11,0,16,9,16892640,3646,0,0,4648
682,8,1,17,8,16911180,3646,300,0,4656
683,10,0,14,11,16972380,3648,360,0,4666
684,8,0,17,8,16997700,3649,360,0,4674
685,10,0,13,12,17027820,3645,360,0,4684
686,10,0,13,12,17072640,3647,360,0,4694
687,12,0,13,12,17109420,3645,360,0,4706
688,11,0,14,11,17138340,3644,360,0,4717
689,7,0,13,12,17159940,3642,360,0,4724
690,7,0,15,10,17187960,3644,360,0,4731
691,7,0,17,8,17211360,3645,360,0,4738
692,8,0,15,10,17252400,3646,360,0,4746
693,10,0,18,7,17282580,3647,360,0,4756
694,3,0,11,14,17322720,3648,360,0,4759
695,3,0,10,15,17333700,3647,360,0,4762
696,4,0,8,17,17362200,3649,360,0,4766
697,2,0,8,17,17367240,3648,360,0,4768
698,3,0,9,16,17374200,3648,360,0,4771
699,5,0,11,14,17389440,3649,360,0,4776
700,3,0,12,13,17396940,3649,360,0,4779
701,2,0,9,16,17428080,3652,360,0,4781
702,5,0,11,14,17436540,3651,360,0,4786
703,11,0,18,7,17441580,3649,360,0,4797
704,8,0,15,10,17482380,3649,360,0,4805
705,8,0,14,11,17516820,3650,360,0,4813
706,5,0,10,15,17552700,3650,360,0,4818
707,7,0,13,12,17565540,3650,360,0,4825
708,3,0,11,14,17578200,3649,360,0,4828
709,7,0,9,16,17606520,3648,360,0,4835
710,6,0,12,13,17615760,3647,360,0,4841
711,5,0,12,13,17635440,3648,360,0,4846
712,9,0,13,12,17657700,3646,360,0,4855
713,9,0,13,12,17681940,3645,360,0,4864
714,6,0,12,13,17713860,3646,360,0,4870
715,5,0,14,11,17729460,3647,360,0,4875
716,9,0,17,8,17748120,3646,360,0,4884
717,6,0,11,14,17806380,3649,360,0,4890
718,5,0,10,15,17823240,3648,360,0,4895
719,3,0,8,17,17842560,3648,360,0,4898
720,2,0,9,16,17843520,3648,360,0,4900
721,5,0,9,16,17858520,3647,360,0,4905
722,7,0,12,13,17867400,3646,360,0,4912
723,4,0,11,14,17876340,3644,360,0,4916
724,3,0,10,15,17890980,3644,360,0,4919
725,5,0,11,14,17915580,3646,360,0,4924
726,4,0,10,15,17929920,3645,360,0,4928
727,10,0,13,12,17944200,3643,360,0,4938
728,4,0,11,14,17957760,3641,360,0,4942
729,9,0,14,11,17978820,3641,360,0,4951
730,12,2,18,7,17995320,3640,420,0,4963
731,12,11,14,11,18033540,3643,5220,1,4975
732,7,10,17,8,18071880,3647,37920,7,4982
733,10,2,25,0,18112200,3647,91320,18,4992
734,10,0,13,12,18181860,3644,105900,21,5002
735,5,0,11,14,18210360,3644,105900,21,5007
736,6,0,12,13,18223800,3644,105900,21,5013
737,7,0,13,12,18239520,3642,105900,21,5020
738,1,0,9,16,18256560,3642,105900,21,5021
739,10,0,13,12,18274320,3641,105900,21,5031
740,7,0,11,14,18305460,3641,105900,21,5038
741,5,0,13,12,18314880,3641,105900,20,5043
742,5,0,10,15,18341160,3640,105900,20,5048
743,3,0,9,16,18352080,3639,105900,20,5051
744,3,0,10,15,18365460,3641,105900,20,5054
745,3,0,7,18,18384720,3640,105900,20,5057
746,5,0,9,16,18390060,3639,105900,20,5062
747,3,0,8,17,18398580,3638,105900,20,5065
748,4,0,11,14,18399480,3637,105900,20,5069
749,7,0,13,12,18425100,3639,105900,20,5076
750,8,0,13,12,18453660,3639,105900,20,5084
751,5,0,11,14,18489300,3641,105900,20,5089
752,4,0,12,13,18501360,3641,105900,20,5093
753,14,0,18,7,18528660,3640,105900,20,5107
754,0,0,10,15,18556980,3640,105900,20,5107
755,7,0,13,12,18581640,3642,105900,20,5114
756,7,0,12,13,18610260,3642,105900,20,5121
757,13,0,17,8,18634560,3641,105900,20,5134
758,6,0,13,12,18669600,3641,105900,20,5140
759,6,0,12,13,18694200,3641,105900,20,5146
760,6,0,11,14,18733560,3643,105900,20,5152
761,11,0,11,14,18754800,3640,105900,20,5163
762,5,0,13,12,18766320,3640,105900,20,5168
763,2,0,10,15,18792960,3642,105900,20,5170
764,9,0,13,12,18813480,3641,105900,20,5179
765,9,0,14,11,18836160,3640,105900,20,5188
766,3,0,13,12,18854580,3641,105900,20,5191
767,4,0,10,15,18902760,3645,105900,20,5195
768,3,0,10,15,18912120,3645,105900,20,5198
769,4,0,11,14,18922680,3645,105900,20,5202
770,5,0,10,15,18939480,3644,105900,20,5207
771,2,0,9,16,18953520,3644,105900,20,5209
772,10,0,14,11,18963240,3643,105900,20,5219
773,4,0,12,13,18986100,3643,105900,20,5223
774,4,0,13,12,18988980,3641,105900,20,5227
775,0,0,9,16,19019280,3644,105900,20,5227
776,5,0,12,13,19032840,3646,105900,20,5232
777,8,0,14,11,19050300,3645,105900,20,5240
778,9,0,16,9,19071600,3644,105900,20,5249
779,8,1,18,7,19093740,3645,107340,20,5257
780,10,4,15,10,19147740,3648,111480,21,5267
781,9,13,14,11,19150620,3648,111480,21,5276
782,7,6,21,4,19212960,3655,150420,28,5283
783,15,8,25,0,19237860,3653,172680,32,5298
784,5,0,18,7,19321260,3655,216060,40,5303
785,12,0,16,9,19382940,3657,216060,40,5315
786,5,0,12,13,19408320,3656,216060,40,5320
787,5,0,11,14,19430700,3656,216060,40,5325
788,9,0,16,9,19448040,3657,216060,40,5334
789,3,0,10,15,19488900,3658,216060,40,5337
790,5,0,8,17,19519200,3659,216060,40,5342
791,7,0,11,14,19530720,3658,216060,40,5349
792,5,0,13,12,19538460,3658,216060,40,5354
793,4,0,13,12,19557900,3659,216060,40,5358
794,4,0,10,15,19588740,3660,216060,40,5362
795,7,0,11,14,19610160,3659,216060,40,5369
796,6,0,13,12,19621680,3659,216060,40,5375
797,5,0,13,12,19639020,3659,216060,40,5380
798,6,0,11,14,19667940,3659,216060,40,5386
799,1,0,9,16,19685400,3660,216060,40,5387
800,3,0,10,15,19698900,3661,216060,40,5390
801,5,0,12,13,19709580,3661,216060,40,5395
802,8,0,15,10,19726260,3661,216060,39,5403
803,10,0,18,7,19752540,3661,216060,39,5413
804,9,0,16,9,19785720,3659,216060,39,5422
805,11,0,17,8,19838340,3662,216060,39,5433
806,7,0,14,11,19858380,3659,216060,39,5440
807,9,0,16,9,19886880,3660,216060,39,5449
808,5,0,10,15,19935060,3661,216060,39,5454
809,9,0,13,12,19948080,3660,216060,39,5463
810,12,0,14,11,19974660,3657,216060,39,5475
811,3,0,10,15,20007600,3659,216060,39,5478
812,7,0,10,15,20027760,3658,216060,39,5485
813,8,0,14,11,20038920,3657,216060,39,5493
814,5,0,14,11,20057580,3657,216060,39,5498
815,6,0,10,15,20097900,3658,216060,39,5504
816,4,0,10,15,20110800,3657,216060,39,5508
817,9,0,12,13,20122800,3655,216060,39,5517
818,4,0,9,16,20148360,3655,216060,39,5521
819,7,0,10,15,20157960,3653,216060,39,5528
820,3,0,11,14,20163060,3652,216060,39,5531
821,7,0,8,17,20198640,3652,216060,39,5538
822,4,0,10,15,20204160,3652,216060,38,5542
823,6,0,13,12,20215740,3652,216060,38,5548
824,9,0,17,8,20226240,3650,216060,38,5557
825,3,0,10,15,20272860,3652,216060,38,5560
826,11,0,15,10,20298480,3653,216060,38,5571
827,11,0,18,7,20321460,3652,216060,38,5582
828,7,0,15,10,20366640,3653,216060,38,5589
829,10,0,14,11,20403960,3653,216060,38,5599
830,8,0,13,12,20434080,3652,216060,38,5607
831,8,0,14,11,20451000,3651,216060,38,5615
832,9,0,14,11,20480400,3650,216060,38,5624
833,10,0,16,9,20518740,3652,216060,38,5634
834,7,1,17,8,20533320,3651,216060,38,5641
835,8,0,15,10,20588400,3654,216360,38,5649
836,5,0,13,12,20606880,3653,216360,38,5654
837,9,0,16,9,20647680,3656,216360,38,5663
838,7,0,13,12,20682480,3656,216360,38,5670
839,6,0,13,12,20709420,3656,216360,38,5676
840,8,0,12,13,20739720,3656,216360,38,5684
841,4,0,9,16,20756220,3654,216360,38,5688
842,4,0,8,17,20782200,3656,216360,38,5692
843,2,0,8,17,20785560,3655,216360,37,5694
844,7,0,13,12,20790540,3655,216360,37,5701
845,7,0,15,10,20807280,3654,216360,37,5708
846,1,0,10,15,20832660,3655,216360,37,5709
847,10,0,10,15,20866620,3655,216360,37,5719
848,8,0,11,14,20880180,3652,216360,37,5727
849,11,0,14,11,20897640,3650,216360,37,5738
850,6,0,14,11,20925480,3651,216360,37,5744
851,11,0,17,8,20958360,3652,216420,37,5755
852,9,0,17,8,20999700,3654,216420,37,5764
853,6,0,12,13,21048240,3655,216420,37,5770
854,18,0,24,1,21065520,3654,216420,37,5788
855,4,0,14,11,21111720,3653,216780,37,5792
856,9,0,13,12,21142380,3652,216780,37,5801
857,7,0,14,11,21174600,3654,216780,37,5808
858,7,0,14,11,21210660,3656,216780,37,5815
859,10,0,16,9,21231300,3654,216780,37,5825
860,7,0,13,12,21265440,3654,216780,37,5832
861,12,0,16,9,21288300,3652,216780,37,5844
862,6,0,13,12,21327480,3653,216780,37,5850
863,6,0,15,10,21353040,3655,216780,37,5856
864,2,0,12,13,21383220,3657,216780,37,5858
865,9,0,9,16,21421200,3656,216780,36,5867
866,6,0,11,14,21428340,3655,216780,36,5873
867,5,0,10,15,21446940,3654,216780,36,5878
868,9,0,13,12,21467280,3654,216780,36,5887
869,7,0,14,11,21483180,3653,216780,36,5894
870,6,0,13,12,21502260,3652,216780,36,5900
871,5,0,11,14,21531480,3653,216780,36,5905
872,4,0,9,16,21553860,3653,216780,36,5909
873,8,0,11,14,21573720,3652,216780,36,5917
874,7,0,13,12,21583920,3651,216780,36,5924
875,9,0,12,13,21618600,3651,216780,36,5933
876,9,0,15,10,21646020,3652,216780,36,5942
877,8,0,14,11,21676440,3651,216780,36,5950
878,7,0,15,10,21698580,3651,216780,36,5957
879,10,0,15,10,21732780,3651,216780,36,5967
880,7,0,14,11,21767760,3652,216780,36,5974
881,5,0,12,13,21801360,3653,216780,36,5979
882,7,0,13,12,21821580,3653,216780,36,5986
883,7,0,15,10,21836160,3652,216780,36,5993
884,3,0,7,18,21884340,3654,216780,36,5996
885,2,0,9,16,21884340,3654,216780,36,5998
886,4,0,9,16,21895020,3653,216780,36,6002
887,5,0,10,15,21906900,3652,216780,36,6007
888,4,0,10,15,21917220,3652,216780,36,6011
889,7,0,15,10,21930420,3653,216780,36,6018
890,5,0,12,13,21965580,3654,216780,35,6023
891,5,0,11,14,21989220,3654,216780,35,6028
892,7,0,13,12,22007040,3654,216780,35,6035
893,4,0,12,13,22018560,3653,216780,35,6039
894,4,0,11,14,22042620,3654,216780,35,6043
895,9,0,14,11,22067940,3654,216780,35,6052
896,11,0,17,8,22084020,3652,216780,35,6063
897,8,0,14,11,22140600,3655,216780,35,6071
898,10,0,14,11,22167300,3653,216780,35,6081
899,6,0,14,11,22195680,3654,216780,35,6087
900,8,0,17,8,22224180,3656,216780,35,6095
901,7,0,13,12,22269900,3657,216780,35,6102
902,7,0,11,14,22305360,3657,216780,35,6109
903,10,0,13,12,22330200,3657,216780,35,6119
904,13,0,19,6,22352580,3656,216780,35,6132
905,10,0,16,9,22405800,3657,216780,35,6142
906,7,0,14,11,22441080,3657,216780,35,6149
907,6,0,14,11,22468560,3658,216780,35,6155
908,6,0,12,13,22492080,3657,216780,35,6161
909,3,0,11,14,22515180,3659,216780,35,6164
910,5,0,10,15,22540200,3659,216780,35,6169
911,2,0,8,17,22551720,3659,216780,35,6171
912,2,0,9,16,22559580,3659,216780,35,6173
913,5,0,10,15,22566180,3658,216780,35,6178
914,4,0,12,13,22569840,3657,216780,35,6182
915,7,0,11,14,22600140,3658,216780,35,6189
916,5,0,12,13,22616280,3658,216780,34,6194
917,5,0,13,12,22628940,3658,216780,34,6199
918,6,0,13,12,22657500,3659,216780,34,6205
919,4,0,13,12,22671300,3659,216780,34,6209
920,6,0,11,14,22707720,3660,216780,34,6215
921,12,0,18,7,22718760,3659,216780,34,6227
922,11,0,17,8,22752300,3657,216780,34,6238
923,8,0,16,9,22791060,3658,216780,34,6246
924,13,0,19,6,22822560,3657,216780,34,6259
925,6,0,14,11,22876920,3659,216780,34,6265
926,8,0,13,12,22904040,3658,216780,34,6273
927,6,0,13,12,22934460,3660,216780,34,6279
928,6,0,15,10,22953420,3660,216780,34,6285
929,11,0,16,9,22985580,3660,216780,34,6296
930,6,0,14,11,23019360,3660,216780,34,6302
931,7,0,13,12,23047020,3660,216780,34,6309
932,7,0,13,12,23082420,3662,216780,34,6316
933,5,0,10,15,23110200,3661,216780,34,6321
934,5,0,13,12,23119260,3662,216780,34,6326
935,8,0,14,11,23145720,3662,216780,34,6334
936,8,0,13,12,23180880,3662,216780,34,6342
937,3,0,11,14,23192940,3661,216780,34,6345
938,1,0,7,18,23225940,3663,216780,34,6346
939,4,0,9,16,23232180,3663,216780,34,6350
940,10,0,11,14,23245320,3661,216780,34,6360
941,0,0,6,19,23269140,3662,216780,34,6360
942,7,0,9,16,23273160,3660,216780,34,6367
943,6,0,8,17,23286960,3658,216780,34,6373
944,7,0,14,11,23290080,3658,216780,33,6380
945,6,0,11,14,23317440,3657,216780,33,6386
946,12,0,14,11,23341920,3656,216780,33,6398
947,6,0,14,11,23361180,3655,216780,33,6404
948,10,0,14,11,23404200,3656,216780,33,6414
949,8,0,14,11,23424900,3655,216780,33,6422
950,5,0,10,15,23464140,3656,216780,33,6427
951,13,0,17,8,23481540,3655,216780,33,6440
952,7,0,19,6,23491980,3654,216780,33,6447
953,12,0,19,6,23544600,3655,216780,33,6459
954,4,0,12,13,23579340,3655,216780,33,6463
955,8,0,14,11,23608500,3656,219480,33,6471
956,8,0,14,11,23632260,3655,219480,33,6479
957,3,0,11,14,23657520,3655,219480,33,6482
958,6,0,12,13,23686800,3657,219480,33,6488
959,7,0,11,14,23707080,3656,219480,33,6495
960,3,0,9,16,23722680,3655,219480,33,6498
961,7,0,11,14,23737080,3655,219480,33,6505
962,7,0,13,12,23745600,3653,219480,33,6512
963,4,0,10,15,23768880,3653,219480,33,6516
964,5,0,11,14,23775840,3652,219480,33,6521
965,11,0,15,10,23798040,3651,219480,33,6532
966,4,0,13,12,23827200,3652,219480,33,6536
967,9,0,14,11,23866320,3654,219480,33,6545
968,8,0,15,10,23882820,3652,219480,33,6553
969,13,0,20,5,23911440,3652,219480,33,6566
970,6,0,14,11,23956140,3652,219480,33,6572
971,10,0,14,11,23995020,3653,219480,33,6582
972,9,0,12,13,24033420,3653,219480,33,6591
973,8,0,17,8,24044940,3653,219480,33,6599
974,5,0,12,13,24080940,3653,219480,33,6604
975,9,0,17,8,24094320,3652,219480,33,6613
976,11,0,18,7,24120900,3651,219480,33,6624
977,10,0,19,6,24164040,3652,219480,33,6634
978,9,0,15,10,24215940,3653,219480,33,6643
979,9,1,18,7,24228120,3652,219720,33,6652
980,5,0,16,9,24282120,3656,220500,33,6657
981,4,0,12,13,24325260,3658,220500,33,6661
982,7,0,12,13,24357900,3659,220500,33,6668
983,2,0,10,15,24366780,3658,220500,33,6670
984,7,0,10,15,24393900,3658,220500,33,6677
985,4,0,11,14,24407520,3659,220500,33,6681
986,6,0,11,14,24423360,3658,220500,32,6687
987,4,0,13,12,24433980,3658,220500,32,6691
988,3,0,9,16,24463800,3659,220500,32,6694
989,4,0,10,15,24475740,3659,220500,32,6698
990,4,0,10,15,24493080,3660,220500,32,6702
991,6,0,11,14,24505320,3659,220500,32,6708
992,7,0,12,13,24521820,3658,220500,32,6715
993,8,0,14,11,24547620,3658,220500,32,6723
994,7,0,12,13,24572580,3657,220500,32,6730
995,6,0,12,13,24597060,3658,220500,32,6736
996,11,0,17,8,24612600,3657,220500,32,6747
997,10,0,16,9,24646620,3656,220500,32,6757
998,10,0,16,9,24687480,3656,220500,32,6767
999,8,0,16,9,24709920,3655,220500,32,6775
1000,10,0,17,8,24746160,3656,220500,32,6785
1001,10,0,14,11,24788820,3655,220500,32,6795
1002,8,0,12,13,24820320,3654,220500,32,6803
1003,7,0,13,12,24843120,3655,220500,32,6810
1004,7,0,13,12,24870420,3655,220500,32,6817
1005,5,0,10,15,24900540,3655,220500,32,6822
1006,7,0,12,13,24912240,3654,220500,32,6829
1007,12,0,16,9,24933060,3653,220500,32,6841
1008,6,0,15,10,24956520,3652,220500,32,6847
1009,5,0,13,12,24989280,3653,220500,32,6852
1010,8,0,12,13,25023600,3654,220500,32,6860
1011,3,0,8,17,25047000,3653,220500,32,6863
1012,8,0,13,12,25057500,3653,220500,32,6871
1013,5,0,12,13,25072080,3652,220500,32,6876
1014,2,0,9,16,25094280,3653,220500,32,6878
1015,7,0,10,15,25113660,3652,220500,32,6885
1016,6,0,9,16,25124580,3650,220500,31,6891
1017,6,0,11,14,25141740,3651,220500,31,6897
1018,7,0,15,10,25154460,3651,220500,31,6904
1019,6,0,13,12,25179720,3650,220500,31,6910
1020,11,0,19,6,25199880,3651,221040,31,6921
1021,6,1,17,8,25221660,3650,221040,31,6927
1022,11,0,16,9,25281360,3652,222060,32,6938
1023,8,0,16,9,25310040,3652,222060,31,6946
1024,5,0,11,14,25360260,3654,222060,31,6951
1025,6,0,13,12,25379400,3654,222060,31,6957
1026,6,0,14,11,25406340,3656,222060,31,6963
1027,6,0,12,13,25427820,3654,222060,31,6969
1028,4,0,12,13,25443060,3655,222060,31,6973
1029,10,0,13,12,25479060,3655,222060,31,6983
1030,4,0,10,15,25506240,3655,222060,31,6987
1031,6,0,12,13,25524300,3656,222060,31,6993
1032,6,0,11,14,25549920,3656,222060,31,6999
1033,4,0,10,15,25560300,3655,222060,31,7003
1034,7,0,10,15,25581120,3654,222060,31,7010
1035,6,0,11,14,25602780,3654,222060,31,7016
1036,6,0,13,12,25613400,3654,222060,31,7022
1037,6,0,11,14,25637100,3653,222060,31,7028
1038,6,0,8,17,25654260,3651,222060,31,7034
1039,6,0,12,13,25657260,3650,222060,31,7040
1040,6,0,11,14,25686660,3651,222060,31,7046
1041,6,0,10,15,25702680,3649,222060,31,7052
1042,7,0,12,13,25716360,3649,222060,31,7059
1043,3,0,11,14,25735860,3649,222060,31,7062
1044,12,0,18,7,25765140,3651,222060,31,7074
1045,5,0,14,11,25793400,3650,222060,31,7079
1046,5,0,9,16,25843320,3652,222060,31,7084
1047,7,0,14,11,25847100,3652,222060,31,7091
1048,7,0,12,13,25878900,3652,222060,31,7098
1049,8,0,11,14,25912860,3652,222060,31,7106
1050,10,0,16,9,25923000,3651,222060,31,7116
1051,4,0,13,12,25945920,3650,222060,31,7120
1052,9,0,14,11,25986960,3652,222060,31,7129
1053,8,0,15,10,26012880,3652,222060,31,7137
1054,8,0,15,10,26043660,3652,222060,31,7145
1055,3,0,11,14,26076180,3653,222060,31,7148
1056,4,0,10,15,26100960,3654,222060,31,7152
1057,1,0,8,17,26115360,3655,222060,31,7153
1058,5,0,10,15,26124660,3654,222060,31,7158
1059,3,0,9,16,26139900,3654,222060,31,7161
1060,5,0,12,13,26149020,3655,222060,30,7166
1061,3,0,11,14,26170800,3656,222060,30,7169
1062,5,0,14,11,26177460,3656,222060,30,7174
1063,11,0,17,8,26209320,3656,222060,30,7185
1064,4,0,13,12,26237040,3656,222060,30,7189
1065,7,0,14,11,26262900,3656,222060,30,7196
1066,7,0,12,13,26297820,3657,222060,30,7203
1067,16,0,20,5,26318040,3655,222060,30,7219
1068,10,0,14,11,26365680,3654,222060,30,7229
1069,7,0,15,10,26392740,3654,222060,30,7236
1070,7,0,14,11,26422500,3655,222060,30,7243
1071,11,0,18,7,26450340,3655,222060,30,7254
1072,6,0,15,10,26486940,3655,222060,30,7260
1073,6,0,14,11,26520060,3656,222060,30,7266
1074,5,0,11,14,26561520,3658,222060,30,7271
1075,2,0,7,18,26586120,3658,222060,30,7273
1076,7,0,11,14,26593680,3658,222060,30,7280
1077,4,0,12,13,26606460,3658,222060,30,7284
1078,5,0,11,14,26630460,3659,222060,30,7289
1079,3,0,10,15,26644200,3658,222060,30,7292
1080,2,0,9,16,26666160,3660,222060,30,7294
1081,6,0,10,15,26673840,3658,222060,30,7300
1082,2,0,8,17,26691780,3659,222060,30,7302
1083,7,0,9,16,26706900,3658,222060,30,7309
1084,2,0,7,18,26719860,3658,222060,30,7311
1085,9,0,13,12,26724420,3657,222060,30,7320
1086,3,0,10,15,26748060,3657,222060,30,7323
1087,9,0,13,12,26764440,3656,222060,30,7332
1088,9,0,14,11,26786760,3655,222060,30,7341
1089,5,0,12,13,26818740,3656,222060,30,7346
1090,12,0,15,10,26856780,3657,222060,30,7358
1091,5,0,12,13,26884740,3657,222060,30,7363
1092,9,0,11,14,26912280,3656,222060,30,7372
1093,11,0,13,12,26931180,3654,222060,30,7383
1094,13,0,15,10,26960400,3652,222060,30,7396
1095,6,0,12,13,26991540,3652,222060,30,7402
1096,7,0,12,13,27012300,3651,222060,29,7409
1097,7,0,11,14,27041820,3651,222060,29,7416
1098,10,0,14,11,27059340,3650,222060,29,7426
1099,3,0,12,13,27078420,3650,222060,29,7429
1100,6,0,12,13,27106620,3651,222060,29,7435
1101,2,0,8,17,27140460,3653,222060,29,7437
1102,3,0,8,17,27155760,3653,222060,29,7440
1103,6,0,13,12,27156420,3653,222060,29,7446
1104,8,0,14,11,27177120,3652,222060,29,7454
1105,4,0,12,13,27207600,3653,222060,29,7458
1106,10,0,16,9,27215880,3652,222060,29,7468
1107,3,0,11,14,27250620,3652,222060,29,7471
1108,3,0,7,18,27285000,3654,222060,29,7474
1109,4,0,11,14,27285000,3654,222060,29,7478
1110,3,0,12,13,27291720,3653,222060,29,7481
1111,9,0,13,12,27308400,3652,222060,29,7490
1112,4,0,13,12,27332220,3653,222060,29,7494
1113,10,0,15,10,27356940,3652,222060,29,7504
1114,9,0,14,11,27382200,3651,222060,29,7513
1115,9,0,14,11,27419160,3651,222060,29,7522
1116,8,0,14,11,27439980,3650,222060,29,7530
1117,7,0,14,11,27469680,3651,222060,29,7537
1118,9,0,12,13,27509280,3651,222060,29,7546
1119,12,0,14,11,27533100,3649,222060,29,7558
1120,4,0,8,17,27558600,3648,222060,29,7562
1121,3,0,9,16,27566640,3648,222060,29,7565
1122,10,0,16,9,27577680,3648,222060,29,7575
1123,5,0,11,14,27609120,3647,222060,29,7580
1124,2,0,7,18,27629640,3647,222060,29,7582
1125,11,0,18,7,27629640,3647,222060,29,7593
1126,4,0,12,13,27657240,3646,222060,29,7597
1127,0,0,7,18,27689940,3648,222060,29,7597
1128,3,0,7,18,27698460,3647,222060,29,7600
1129,6,0,10,15,27707460,3647,222060,29,7606
1130,3,0,9,16,27719580,3647,222060,29,7609
1131,4,0,12,13,27720420,3646,222060,29,7613
1132,5,0,11,14,27746340,3647,222060,29,7618
1133,3,0,11,14,27756900,3647,222060,29,7621
1134,6,0,9,16,27776100,3646,222060,29,7627
1135,9,0,14,11,27796440,3646,222060,29,7636
1136,8,0,14,11,27820980,3646,222060,29,7644
1137,7,0,15,10,27847080,3646,222060,29,7651
1138,11,0,18,7,27885120,3647,222060,28,7662
1139,14,2,18,7,27907080,3645,222180,28,7676
1140,16,13,16,9,27949140,3647,225060,29,7692
1141,9,19,14,11,27986400,3649,231300,30,7701
1142,10,25,14,11,28016820,3651,241800,31,7711
1143,14,37,13,12,28036380,3652,244860,31,7725
1144,6,35,16,9,28078200,3656,307440,39,7731
1145,5,34,21,4,28085940,3656,346260,44,7736
1146,10,31,25,0,28138380,3659,493080,63,7746
1147,8,15,25,0,28230420,3659,739560,95,7754
1148,3,0,11,14,28295040,3652,950280,122,7757
1149,7,0,10,15,28328580,3653,950280,122,7764
1150,3,0,8,17,28340640,3652,950280,122,7767
1151,5,0,12,13,28345980,3652,950280,122,7772
1152,6,0,11,14,28361880,3651,950280,122,7778
1153,4,0,11,14,28375620,3651,950280,122,7782
1154,4,0,11,14,28401600,3652,950280,122,7786
1155,4,0,9,16,28417740,3652,950280,121,7790
1156,4,0,10,15,28428480,3652,950280,121,7794
1157,3,0,12,13,28435200,3652,950280,121,7797
1158,7,0,10,15,28461240,3651,950280,121,7804
1159,4,0,10,15,28475280,3651,950280,121,7808
1160,7,0,12,13,28488960,3651,950280,121,7815
1161,8,0,14,11,28509420,3650,950280,121,7823
1162,1,0,7,18,28537920,3650,950280,121,7824
1163,3,0,8,17,28544820,3650,950280,121,7827
1164,9,0,15,10,28549860,3650,950280,121,7836
1165,9,0,20,5,28558680,3649,950280,121,7845
1166,13,0,22,3,28597560,3649,950280,120,7858
1167,9,0,18,7,28649700,3650,950280,120,7867
1168,9,0,15,10,28699680,3650,950280,120,7876
1169,5,0,12,13,28728480,3650,950280,120,7881
1170,10,0,15,10,28758060,3651,950280,120,7891
1171,7,0,15,10,28777680,3650,950280,120,7898
1172,5,0,12,13,28798320,3649,950280,120,7903
1173,2,0,9,16,28826520,3650,950280,120,7905
1174,4,0,11,14,28838340,3651,950280,120,7909
1175,0,0,8,17,28854060,3651,950280,120,7909
1176,4,0,8,17,28871340,3652,950280,120,7913
1177,4,0,11,14,28872420,3651,950280,120,7917
1178,7,0,15,10,28884420,3652,950280,119,7924
1179,7,0,11,14,28919580,3651,950280,119,7931
1180,3,0,10,15,28934820,3651,950280,119,7934
1181,4,0,11,14,28949460,3652,950280,119,7938
1182,4,0,9,16,28961280,3650,950280,119,7942
1183,6,0,11,14,28979520,3651,950280,119,7948
1184,8,0,11,14,28997520,3649,950280,119,7956
1185,8,0,11,14,29027400,3649,950280,119,7964
1186,9,0,15,10,29037720,3648,950280,119,7973
1187,16,0,19,6,29073120,3647,950280,118,7989
1188,2,0,8,17,29109840,3646,950280,118,7991
1189,10,0,13,12,29118840,3645,950280,118,8001
1190,4,0,9,16,29144580,3644,950280,118,8005
1191,6,0,9,16,29160480,3644,950280,118,8011
1192,9,0,14,11,29175480,3644,950280,118,8020
1193,11,0,15,10,29199960,3642,950280,118,8031
1194,4,0,10,15,29236440,3643,950280,118,8035
1195,7,0,14,11,29244180,3642,950280,118,8042
1196,6,0,14,11,29272020,3643,950280,118,8048
1197,6,0,14,11,29286960,3642,950280,117,8054
1198,2,0,14,11,29302920,3643,950280,117,8056
1199,6,0,14,11,29332620,3644,950280,117,8062
1200,4,0,11,14,29364180,3645,950280,117,8066
1201,3,0,9,16,29380080,3645,950280,117,8069
1202,6,0,13,12,29389020,3645,950280,117,8075
1203,6,0,12,13,29416620,3645,950280,117,8081
1204,6,0,13,12,29432580,3645,950280,117,8087
1205,7,0,13,12,29465160,3646,950280,117,8094
1206,5,0,13,12,29478000,3645,950280,117,8099
1207,6,0,14,11,29499240,3645,950280,117,8105
1208,10,0,16,9,29523180,3645,950280,117,8115
1209,5,0,15,10,29552700,3646,950280,117,8120
1210,12,4,13,12,29591220,3646,950400,116,8132
1211,12,8,18,7,29614860,3648,962760,118,8144
1212,10,0,22,3,29663100,3647,996300,122,8154
1213,6,0,9,16,29718840,3646,996300,122,8160
1214,9,0,11,14,29737440,3645,996300,121,8169
1215,12,0,17,8,29753040,3644,996300,121,8181
1216,5,0,15,10,29778180,3644,996300,121,8186
1217,8,0,10,15,29822280,3643,996300,121,8194
1218,10,0,15,10,29836560,3643,996300,121,8204
1219,3,0,11,14,29865300,3643,996300,121,8207
1220,7,0,8,17,29895900,3643,996300,121,8214
1221,5,0,11,14,29912520,3644,996300,121,8219
1222,5,0,10,15,29929980,3643,996300,121,8224
1223,7,0,11,14,29949420,3643,996300,121,8231
1224,4,0,11,14,29958120,3642,996300,120,8235
1225,3,0,8,17,29979360,3642,996300,120,8238
1226,2,0,10,15,29979360,3642,996300,120,8240
1227,2,0,10,15,29994900,3643,996300,120,8242
1228,7,0,12,13,30014700,3643,996300,120,8249
1229,6,0,12,13,30029580,3643,996300,120,8255
1230,7,0,12,13,30053700,3642,996300,120,8262
1231,5,0,11,14,30071400,3642,996300,120,8267
1232,8,0,15,10,30084000,3642,996300,120,8275
1233,5,0,11,14,30121200,3642,996300,120,8280
1234,6,0,11,14,30132900,3641,996300,120,8286
1235,13,0,20,5,30149520,3641,996300,120,8299
1236,6,0,15,10,30193500,3642,996300,119,8305
1237,9,0,16,9,30223200,3642,996300,119,8314
1238,9,0,12,13,30277680,3643,996300,119,8323
1239,4,0,12,13,30291720,3643,996300,119,8327
1240,14,0,13,12,30318360,3640,996300,119,8341
1241,15,0,17,8,30342540,3638,996300,119,8356
1242,6,0,13,12,30374940,3638,996300,119,8362
1243,9,0,15,10,30406500,3638,996300,119,8371
1244,14,0,22,3,30430980,3638,996300,118,8385
1245,1,1,13,12,30469920,3639,996300,118,8386
1246,6,0,14,11,30520020,3642,998520,118,8392
1247,2,0,9,16,30551160,3643,998520,118,8394
1248,7,0,12,13,30568080,3643,998520,118,8401
1249,7,0,15,10,30581220,3643,998520,118,8408
1250,7,0,12,13,30617880,3643,998520,118,8415
1251,5,0,13,12,30634440,3643,998520,118,8420
1252,4,0,10,15,30667140,3644,998520,118,8424
1253,4,0,11,14,30688200,3645,998520,118,8428
1254,7,0,13,12,30704460,3645,998520,118,8435
1255,11,0,14,11,30730620,3644,998520,118,8446
1256,6,0,16,9,30751260,3645,998520,118,8452
1257,11,0,16,9,30793860,3645,998520,117,8463
1258,8,0,18,7,30813000,3645,998520,117,8471
1259,9,0,13,12,30871320,3646,998520,117,8480
1260,11,0,14,11,30900840,3645,998520,117,8491
1261,11,0,18,7,30921960,3644,998520,117,8502
1262,5,0,14,11,30956460,3644,998520,117,8507
1263,8,0,12,13,30986520,3644,998520,117,8515
1264,8,0,11,14,31012680,3643,998520,117,8523
1265,8,0,14,11,31033860,3643,998520,117,8531
1266,8,0,18,7,31044600,3643,998520,116,8539
1267,2,0,11,14,31086120,3644,998520,116,8541
1268,12,0,17,8,31116420,3645,998520,116,8553
1269,10,0,17,8,31143120,3644,998520,116,8563
1270,3,0,10,15,31194360,3645,998520,116,8566
1271,7,0,13,12,31215000,3646,998520,116,8573
1272,4,0,12,13,31229040,3646,998520,116,8577
1273,10,0,14,11,31252620,3645,998520,116,8587
1274,2,0,8,17,31284360,3645,998520,116,8589
1275,5,0,9,16,31292580,3645,998520,116,8594
1276,6,0,12,13,31303200,3644,998520,116,8600
1277,6,0,13,12,31319280,3644,998520,116,8606
1278,6,0,10,15,31346640,3644,998520,115,8612
1279,6,0,11,14,31360740,3643,998520,115,8618
1280,4,0,10,15,31371660,3642,998520,115,8622
1281,7,0,12,13,31392900,3643,998520,115,8629
1282,4,0,9,16,31417860,3643,998520,115,8633
1283,10,0,16,9,31424220,3642,998520,115,8643
1284,5,0,12,13,31456200,3642,998520,115,8648
1285,5,0,9,16,31481220,3641,998520,115,8653
1286,6,0,9,16,31495620,3641,998520,115,8659
1287,8,0,11,14,31506360,3639,998520,115,8667
1288,11,0,15,10,31522440,3638,998520,115,8678
1289,3,0,10,15,31558380,3639,998520,115,8681
1290,4,0,10,15,31580280,3640,998520,114,8685
1291,8,0,12,13,31598760,3639,998520,114,8693
1292,4,0,8,17,31622880,3639,998520,114,8697
1293,5,0,9,16,31626300,3638,998520,114,8702
1294,7,0,12,13,31640880,3638,998520,114,8709
1295,4,0,10,15,31660740,3637,998520,114,8713
1296,9,0,12,13,31684680,3637,998520,114,8722
1297,4,0,9,16,31698120,3636,998520,114,8726
1298,7,0,13,12,31708920,3636,998520,114,8733
1299,3,0,8,17,31730520,3635,998520,114,8736
1300,4,0,10,15,31743660,3636,998520,114,8740
1301,5,0,10,15,31756980,3635,998520,114,8745
1302,10,0,16,9,31768980,3635,998520,114,8755
1303,5,0,14,11,31787160,3634,998520,113,8760
1304,5,0,10,15,31822740,3634,998520,113,8765
1305,10,0,15,10,31839840,3634,998520,113,8775
1306,14,0,20,5,31865520,3633,998520,113,8789
1307,8,0,16,9,31908960,3633,998520,113,8797
1308,10,0,12,13,31954080,3633,998520,113,8807
1309,8,0,14,11,31972860,3632,998520,113,8815
1310,12,0,16,9,32000160,3631,998520,113,8827
1311,3,0,12,13,32017560,3630,998520,113,8830
1312,8,0,13,12,32050020,3631,998520,112,8838
1313,5,0,14,11,32060700,3631,998520,112,8843
1314,11,0,12,13,32110920,3631,998520,112,8854
1315,11,0,17,8,32119440,3630,998520,112,8865
1316,8,0,15,10,32155200,3630,998520,112,8873
1317,6,0,13,12,32186460,3630,998520,112,8879
1318,7,0,10,15,32217120,3629,998520,112,8886
1319,4,0,10,15,32235060,3630,998520,112,8890
1320,4,0,10,15,32251680,3630,998520,112,8894
1321,4,0,8,17,32266980,3629,998520,112,8898
1322,6,0,13,12,32267520,3629,998520,112,8904
1323,4,0,14,11,32278020,3629,998520,112,8908
1324,3,0,14,11,32287860,3629,998520,112,8911
1325,4,0,8,17,32347800,3631,998520,112,8915
1326,11,0,15,10,32353560,3630,998520,111,8926
1327,9,0,15,10,32381640,3630,998520,111,8935
1328,7,0,11,14,32414700,3629,998520,111,8942
1329,10,0,11,14,32439900,3628,998520,111,8952
1330,11,0,13,12,32451360,3625,998520,111,8963
1331,6,0,14,11,32471220,3626,998520,111,8969
1332,10,0,16,9,32505960,3626,998520,111,8979
1333,13,0,20,5,32531460,3625,998520,111,8992
1334,8,0,19,6,32561580,3625,998520,110,9000
1335,4,0,12,13,32620620,3627,998520,110,9004
1336,10,0,15,10,32651460,3628,998520,110,9014
1337,10,0,16,9,32679360,3627,998520,110,9024
1338,5,0,13,12,32713740,3628,998520,110,9029
1339,5,0,13,12,32744220,3629,998520,110,9034
1340,8,0,14,11,32769900,3629,998520,110,9042
1341,7,0,14,11,32795100,3629,998520,110,9049
1342,4,0,11,14,32827920,3630,998520,110,9053
1343,8,0,13,12,32845440,3630,998520,110,9061
1344,11,0,20,5,32865120,3630,998520,110,9072
1345,2,0,22,3,32865120,3630,998520,110,9074
1346,6,3,24,1,32866680,3630,999000,110,9080
1347,7,9,22,3,32884080,3631,1003380,110,9087
1348,5,10,25,0,32892600,3631,1017120,111,9092
1349,6,13,25,0,32913960,3632,1034640,113,9098
1350,4,12,25,0,32938200,3633,1081620,118,9102
1351,6,2,25,0,32967900,3630,1161660,127,9108
1352,7,3,25,0,32978820,3629,1171440,128,9115
1353,9,10,24,1,32992680,3629,1173420,128,9124
1354,9,17,24,1,33011400,3630,1180080,129,9133
1355,5,20,23,2,33035760,3632,1189260,130,9138
1356,8,25,24,1,33049260,3632,1203960,131,9146
1357,8,32,24,1,33057360,3633,1207860,132,9154
1358,14,39,24,1,33085260,3635,1216140,132,9168
1359,12,40,25,0,33100980,3636,1262100,137,9180
1360,6,39,25,0,33134700,3637,1300560,141,9186
1361,10,40,25,0,33143220,3637,1302240,141,9196
1362,9,40,25,0,33176040,3638,1359720,148,9205
1363,3,36,25,0,33195840,3638,1462620,159,9208
1364,9,40,25,0,33208320,3638,1465200,159,9217
1365,8,40,25,0,33232380,3639,1478280,160,9225
1366,6,36,25,0,33267600,3640,1629840,177,9231
1367,4,34,25,0,33287220,3639,1823940,198,9235
1368,5,33,25,0,33307140,3639,1891560,205,9240
1369,3,30,25,0,33330480,3639,2040000,221,9243
1370,6,32,25,0,33347520,3640,2048040,222,9249
1371,3,32,25,0,33363240,3640,2055420,222,9252
1372,4,28,25,0,33396000,3641,2218860,240,9256
1373,5,28,25,0,33411600,3640,2292660,248,9261
1374,9,32,25,0,33429780,3640,2295420,248,9270
1375,8,36,24,1,33451920,3641,2303640,249,9278
1376,5,38,23,2,33473280,3641,2310600,249,9283
1377,14,40,25,0,33486120,3642,2323140,251,9297
1378,11,39,25,0,33505740,3643,2335440,252,9308
1379,11,40,25,0,33533040,3644,2373420,256,9319
1380,9,35,25,0,33566220,3644,2454120,264,9328
1381,10,40,23,2,33576660,3643,2604720,280,9338
1382,11,40,22,3,33584160,3644,2604720,280,9349
1383,6,37,25,0,33612720,3645,2640600,284,9355
1384,7,37,25,0,33625140,3643,2739360,294,9362
1385,4,34,25,0,33651660,3643,2763540,297,9366
1386,7,38,25,0,33661980,3643,2765340,297,9373
1387,8,35,25,0,33696600,3643,2966400,318,9381
1388,5,37,25,0,33703560,3642,2969040,318,9386
1389,7,40,25,0,33728040,3643,2971200,318,9393
1390,6,40,25,0,33747900,3644,2981040,319,9399
1391,5,40,25,0,33776460,3645,2991780,320,9404
1392,2,37,25,0,33804600,3647,3010920,322,9406
1393,3,22,25,0,33833760,3643,4509540,483,9409
1394,3,5,25,0,33853860,3637,5893920,631,9412
1395,11,5,25,0,33871080,3635,6170100,660,9423
1396,4,6,25,0,33880020,3634,6175680,660,9427
1397,3,4,25,0,33901200,3635,6270960,670,9430
1398,10,4,25,0,33929220,3634,6321900,675,9440
1399,9,11,22,3,33953160,3634,6326220,674,9449
1400,8,17,23,2,33961620,3635,6335220,675,9457
1401,9,23,24,1,33978540,3636,6351000,676,9466
1402,5,26,23,2,33994140,3636,6358920,676,9471
1403,12,36,23,2,34008660,3637,6370020,677,9483
1404,7,39,24,1,34029360,3638,6380220,677,9490
1405,8,40,23,2,34034700,3638,6380220,677,9498
1406,7,39,25,0,34055160,3639,6421800,681,9505
1407,6,39,25,0,34070760,3640,6449400,684,9511
1408,11,36,25,0,34105980,3641,6562140,696,9522
1409,8,39,25,0,34122240,3642,6604980,700,9530
1410,7,40,25,0,34131900,3642,6641400,704,9537
1411,10,40,25,0,34166700,3643,6723300,712,9547
1412,5,40,25,0,34184220,3643,6784620,718,9552
1413,8,37,25,0,34210980,3643,6838800,723,9560
1414,4,35,25,0,34232640,3643,6973380,737,9564
1415,6,35,25,0,34258920,3643,7043400,744,9570
1416,5,38,25,0,34264200,3643,7046100,744,9575
1417,6,38,25,0,34299960,3645,7106040,750,9581
1418,7,40,25,0,34313520,3644,7165740,756,9588
1419,6,35,25,0,34345500,3644,7245660,764,9594
1420,6,32,25,0,34361520,3643,7423500,782,9600
1421,7,31,25,0,34376940,3641,7528680,792,9607
1422,3,30,25,0,34397520,3642,7533480,793,9610
1423,5,27,25,0,34428300,3642,7765080,817,9615
1424,8,24,25,0,34446060,3640,8184780,860,9623
1425,9,22,25,0,34472520,3638,8452380,887,9632
1426,7,20,25,0,34488360,3636,8627700,905,9639
1427,8,23,25,0,34513620,3637,8632740,905,9647
1428,4,24,25,0,34528680,3638,8639940,905,9651
1429,2,21,25,0,34555260,3638,8655120,907,9653
1430,10,26,25,0,34581900,3639,8660280,906,9663
1431,6,28,25,0,34602120,3640,8668140,906,9669
1432,4,31,25,0,34609080,3640,8677260,907,9673
1433,6,29,25,0,34648980,3641,8711160,910,9679
1434,8,33,25,0,34663440,3641,8836740,922,9687
1435,9,40,24,1,34680060,3642,8839140,922,9696
1436,6,39,23,2,34705380,3643,8856540,923,9702
1437,3,40,23,2,34705380,3643,8856540,923,9705
1438,6,40,22,3,34712820,3644,8856540,923,9711
1439,7,38,25,0,34744920,3646,8935500,931,9718
1440,6,40,25,0,34747560,3646,8936760,931,9724
1441,5,39,25,0,34787820,3648,8977620,935,9729
1442,5,29,25,0,34812660,3644,9600120,999,9734
1443,6,21,25,0,34829100,3641,10361160,1078,9740
1444,10,21,25,0,34849740,3639,10424580,1083,9750
1445,6,23,25,0,34871700,3640,10431240,1083,9756
1446,3,22,25,0,34896840,3641,10446960,1084,9759
1447,8,23,25,0,34920780,3641,10460820,1085,9767
1448,7,25,25,0,34935720,3641,10464900,1085,9774
1449,5,26,25,0,34959660,3642,10473300,1085,9779
1450,10,33,25,0,34974120,3642,10476060,1084,9789
1451,16,40,25,0,34996200,3643,10483980,1084,9805
1452,8,40,24,1,35008620,3644,10488660,1084,9813
1453,7,37,25,0,35038560,3645,10517940,1087,9820
1454,9,40,25,0,35058540,3645,10554240,1090,9829
1455,4,38,25,0,35077500,3645,10595520,1094,9833
1456,6,37,25,0,35097000,3644,10609800,1094,9839
1457,14,40,24,1,35120220,3644,10817760,1115,9853
1458,7,39,24,1,35136180,3645,10825260,1115,9860
1459,12,39,25,0,35154720,3646,10836600,1116,9872
1460,5,38,25,0,35174580,3646,10900380,1122,9877
1461,3,22,25,0,35207220,3643,11855400,1220,9880
1462,3,5,25,0,35234580,3638,13160280,1354,9883
1463,5,0,23,2,35246700,3635,13683120,1407,9888
1464,4,0,25,0,35248440,3634,13683120,1407,9892
1465,3,0,22,3,35270700,3634,13683120,1406,9895
1466,2,0,22,3,35277360,3634,13683120,1406,9897
1467,3,0,22,3,35291400,3634,13683120,1406,9900
1468,5,0,25,0,35294400,3634,13683120,1405,9905
1469,5,0,24,1,35323380,3635,13683480,1404,9910
1470,9,4,25,0,35330220,3634,13683480,1404,9919
1471,9,11,25,0,35340120,3634,13687800,1402,9928
1472,10,19,23,2,35371680,3636,13692360,1401,9938
1473,13,31,23,2,35379600,3636,13696740,1401,9951
1474,12,40,22,3,35401380,3638,13702860,1400,9963
1475,7,39,22,3,35414880,3638,13718760,1400,9970
1476,8,40,22,3,35424060,3639,13726080,1401,9978
1477,9,40,23,2,35428800,3639,13748460,1403,9987
1478,14,39,24,1,35447700,3640,13811880,1409,10001
1479,7,40,24,1,35447700,3640,13811880,1409,10008
1480,8,39,23,2,35480520,3642,13857780,1413,10016
1481,12,40,24,1,35488320,3642,13881240,1415,10028
1482,9,39,25,0,35506080,3643,13965600,1423,10037
1483,3,39,25,0,35525100,3644,13992780,1426,10040
1484,3,36,25,0,35551260,3645,14058960,1432,10043
1485,7,40,25,0,35568180,3646,14150040,1441,10050
1486,9,39,25,0,35583780,3647,14202540,1446,10059
1487,5,38,25,0,35613840,3648,14264460,1452,10064
1488,3,35,25,0,35634780,3648,14436000,1468,10067
1489,5,33,25,0,35663580,3648,14697660,1494,10072
1490,3,27,25,0,35689020,3647,15058860,1530,10075
1491,3,23,25,0,35704920,3646,15445260,1569,10078
1492,8,26,24,1,35721480,3646,15512280,1575,10086
1493,5,30,24,1,35727720,3646,15517860,1575,10091
1494,9,34,25,0,35763960,3648,15527640,1574,10100
1495,9,39,25,0,35778240,3648,15530760,1573,10109
1496,4,39,25,0,35801400,3650,15556800,1575,10113
1497,7,39,25,0,35823540,3650,15583740,1577,10120
1498,13,40,25,0,35844480,3650,15593280,1577,10133
1499,11,39,23,2,35859720,3650,15597420,1577,10144
1500,10,39,25,0,35889300,3651,15612360,1578,10154
1501,7,39,25,0,35900160,3652,15621120,1578,10161
1502,11,39,25,0,35924820,3652,15694020,1585,10172
1503,8,40,25,0,35940000,3653,15761820,1592,10180
1504,10,38,25,0,35977260,3653,15794940,1593,10190
1505,3,36,25,0,35991420,3652,15944340,1608,10193
1506,6,39,25,0,35999340,3652,15945120,1607,10199
1507,7,40,25,0,36027120,3653,15947160,1606,10206
1508,5,35,25,0,36064560,3654,16087860,1620,10211
1509,9,35,25,0,36082800,3653,16247100,1635,10220
1510,8,38,25,0,36098580,3652,16255020,1634,10228
1511,7,40,25,0,36123960,3653,16264920,1634,10235
1512,3,33,25,0,36144660,3652,16524900,1660,10238
1513,2,18,25,0,36171000,3648,17847240,1792,10240
1514,6,10,25,0,36193320,3645,18679620,1875,10246
1515,5,9,25,0,36202200,3644,18854880,1891,10251
1516,1,4,25,0,36230040,3645,19117320,1917,10252
1517,4,0,23,2,36251220,3643,19238040,1929,10256
1518,7,0,25,0,36266760,3643,19238820,1927,10263
1519,2,0,22,3,36284220,3643,19238820,1927,10265
1520,3,0,23,2,36291300,3643,19238820,1926,10268
1521,4,0,22,3,36305100,3642,19238820,1926,10272
1522,11,4,25,0,36316620,3642,19239120,1924,10283
1523,10,12,25,0,36326400,3642,19242240,1922,10293
1524,11,20,24,1,36346500,3643,19250820,1922,10304
1525,5,21,24,1,36375780,3644,19267440,1921,10309
1526,15,32,25,0,36387300,3644,19270800,1919,10324
1527,8,36,25,0,36410340,3645,19288140,1919,10332
1528,7,40,25,0,36426240,3646,19296060,1919,10339
1529,11,40,25,0,36451380,3647,19330200,1922,10350
1530,4,36,25,0,36484380,3648,19381740,1926,10354
1531,5,34,25,0,36506760,3647,19438800,1930,10359
1532,3,34,25,0,36515940,3647,19491000,1935,10362
1533,8,36,25,0,36535920,3647,19556760,1941,10370
1534,6,38,25,0,36553080,3647,19561920,1940,10376
1535,3,37,24,1,36584040,3648,19574640,1940,10379
1536,5,40,25,0,36592860,3649,19585620,1941,10384
1537,9,39,25,0,36624480,3650,19660620,1947,10393
1538,5,36,25,0,36652680,3649,19740600,1953,10398
1539,6,38,25,0,36664320,3649,19748520,1953,10404
1540,7,37,25,0,36694380,3650,19808220,1958,10411
1541,4,36,25,0,36710460,3649,20045940,1981,10415
1542,10,40,25,0,36735720,3650,20103240,1985,10425
1543,5,40,25,0,36750360,3650,20107680,1984,10430
1544,5,39,25,0,36773520,3651,20125440,1985,10435
1545,16,40,25,0,36798960,3651,20283240,1999,10451
1546,10,38,25,0,36823740,3650,20356080,2005,10461
1547,4,33,25,0,36844080,3649,20594760,2028,10465
1548,5,24,25,0,36871740,3647,21329820,2099,10470
1549,10,20,25,0,36887580,3643,21844380,2149,10480
1550,7,23,25,0,36901860,3643,21849720,2147,10487
1551,5,20,25,0,36936180,3644,21866280,2147,10492
1552,11,24,25,0,36947520,3643,21991380,2157,10503
1553,8,29,25,0,36964980,3643,21994440,2156,10511
1554,13,38,25,0,36987780,3644,21997860,2155,10524
1555,7,40,23,2,36998700,3644,21997860,2155,10531
1556,4,37,24,1,37031940,3646,22028760,2156,10535
1557,3,37,25,0,37039020,3646,22045920,2157,10538
1558,3,37,25,0,37054200,3647,22069140,2159,10541
1559,5,35,25,0,37087320,3647,22124100,2163,10546
1560,1,27,25,0,37112160,3647,22367400,2186,10547
1561,4,16,25,0,37138320,3644,23054220,2253,10551
1562,1,4,25,0,37153260,3641,23665860,2312,10552
1563,7,4,25,0,37159560,3639,23836260,2328,10559
1564,6,9,23,2,37184040,3640,23839800,2327,10565
1565,8,15,23,2,37198080,3641,23842260,2326,10573
1566,6,19,23,2,37215300,3642,23847540,2324,10579
1567,4,22,23,2,37224960,3642,23853780,2324,10583
1568,8,29,23,2,37235220,3643,23858100,2323,10591
1569,10,36,24,1,37251780,3644,23875860,2323,10601
1570,11,40,23,2,37260420,3644,23875860,2323,10612
1571,8,40,25,0,37287000,3645,23911380,2323,10620
1572,10,39,25,0,37322040,3647,24023040,2333,10630
1573,11,40,25,0,37340940,3647,24032640,2333,10641
1574,7,40,25,0,37351320,3647,24035460,2332,10648
1575,10,40,25,0,37379280,3648,24122100,2340,10658
1576,10,38,25,0,37413360,3649,24258780,2351,10668
1577,9,40,25,0,37420680,3648,24261480,2351,10677
1578,3,34,25,0,37451580,3648,24373320,2360,10680
1579,4,32,25,0,37477680,3648,24510180,2373,10684
1580,3,31,25,0,37491180,3648,24639300,2385,10687
1581,5,31,25,0,37511400,3648,24646680,2385,10692
1582,8,34,25,0,37535520,3649,24652500,2383,10700
1583,3,34,25,0,37550940,3649,24664620,2383,10703
1584,4,34,25,0,37567560,3650,24677460,2384,10707
1585,6,31,25,0,37602240,3650,24862920,2400,10713
1586,2,29,25,0,37616220,3650,24869700,2400,10715
1587,5,28,25,0,37641600,3650,24996720,2412,10720
1588,4,23,25,0,37661580,3649,25247220,2435,10724
1589,3,11,25,0,37691520,3646,26036700,2510,10727
1590,9,10,25,0,37705860,3644,26346420,2538,10736
1591,7,12,25,0,37727280,3645,26352180,2537,10743
1592,9,18,24,1,37746720,3645,26357160,2535,10752
1593,6,21,25,0,37760940,3646,26368200,2535,10758
1594,3,20,25,0,37785480,3647,26380560,2535,10761
1595,9,24,25,0,37810320,3647,26406780,2535,10770
1596,6,26,25,0,37828080,3648,26411640,2534,10776
1597,13,35,25,0,37849140,3648,26413560,2532,10789
1598,7,39,25,0,37865760,3649,26418240,2530,10796
1599,12,39,25,0,37897320,3650,26430360,2530,10808
1600,5,38,25,0,37916940,3650,26443800,2530,10813
1601,5,34,25,0,37952400,3651,26604960,2544,10818
1602,8,36,25,0,37968240,3650,26642160,2546,10826
1603,6,39,25,0,37974660,3650,26645400,2545,10832
1604,4,39,22,3,38001780,3651,26648640,2545,10836
1605,6,36,25,0,38019900,3651,26710860,2550,10842
1606,6,36,25,0,38038860,3650,26720460,2549,10848
1607,2,31,25,0,38051340,3649,26950500,2571,10850
1608,2,23,25,0,38077920,3648,27464880,2619,10852
1609,6,18,25,0,38108100,3647,27882000,2657,10858
1610,5,12,25,0,38124000,3645,28233480,2690,10863
1611,3,6,25,0,38152740,3645,28563540,2720,10866
1612,5,0,24,1,38176920,3643,28867080,2748,10871
1613,7,3,24,1,38184120,3642,28867140,2747,10878
1614,7,9,23,2,38202720,3643,28871520,2745,10885
1615,6,10,25,0,38226900,3644,28890660,2745,10891
1616,8,15,25,0,38241060,3645,28895220,2743,10899
1617,8,19,25,0,38264760,3645,28916460,2744,10907
1618,6,18,25,0,38294640,3646,28926900,2743,10913
1619,6,21,25,0,38303100,3646,28952820,2745,10919
1620,11,25,25,0,38335620,3646,28981440,2744,10930
1621,4,26,24,1,38351520,3646,28983360,2743,10934
1622,15,38,25,0,38364420,3647,28993140,2741,10949
1623,8,40,25,0,38386920,3648,28996740,2739,10957
1624,9,39,25,0,38424000,3650,29014680,2739,10966
1625,3,39,25,0,38431500,3650,29027820,2740,10969
1626,10,39,25,0,38456760,3650,29064600,2742,10979
1627,3,35,25,0,38486280,3651,29144340,2749,10982
1628,3,31,25,0,38511900,3651,29199600,2753,10985
1629,5,31,25,0,38523960,3650,29290020,2761,10990
1630,4,28,25,0,38549940,3650,29345580,2765,10994
1631,6,22,25,0,38580600,3649,29696520,2796,11000
1632,4,13,25,0,38596680,3646,30053100,2829,11004
1633,5,0,25,0,38619360,3642,30652980,2884,11009
1634,3,0,21,4,38636760,3641,30653220,2883,11012
1635,3,0,23,2,38641980,3641,30653220,2882,11015
1636,6,0,24,1,38657640,3641,30653220,2880,11021
1637,8,2,25,0,38672100,3641,30656340,2879,11029
1638,10,6,25,0,38701920,3641,30662700,2877,11039
1639,6,3,25,0,38719080,3640,30682020,2877,11045
1640,13,12,24,1,38732340,3639,30694020,2874,11058
1641,8,18,23,2,38753220,3640,30699360,2874,11066
1642,6,20,23,2,38777520,3641,30717960,2873,11072
1643,14,32,24,1,38781780,3641,30728880,2871,11086
1644,13,40,24,1,38802540,3642,30740700,2869,11099
1645,7,40,24,1,38814840,3643,30759120,2870,11106
1646,12,39,24,1,38834880,3644,30782820,2871,11118
1647,10,39,25,0,38856240,3645,30807300,2872,11128
1648,9,40,25,0,38862060,3645,30837360,2875,11137
1649,5,38,25,0,38897940,3646,30915000,2881,11142
1650,13,40,25,0,38913600,3647,30919320,2880,11155
1651,5,40,25,0,38932800,3647,30992040,2886,11160
1652,8,40,25,0,38956500,3648,31066980,2892,11168
1653,6,38,25,0,38989080,3649,31128960,2897,11174
1654,8,40,25,0,39003360,3649,31246500,2906,11182
1655,5,39,25,0,39028080,3649,31310160,2910,11187
1656,3,36,25,0,39050220,3649,31367280,2914,11190
1657,6,36,25,0,39072000,3649,31619220,2937,11196
1658,6,36,25,0,39092160,3649,31716840,2944,11202
1659,5,35,25,0,39113040,3649,31785480,2949,11207
1660,3,32,25,0,39142920,3650,31924380,2961,11210
1661,6,35,25,0,39150000,3649,31989660,2966,11216
1662,4,32,25,0,39184140,3650,32001360,2965,11220
1663,7,36,25,0,39188700,3649,32080140,2971,11227
1664,8,39,25,0,39225780,3651,32090340,2969,11235
1665,8,39,25,0,39236280,3651,32096520,2969,11243
1666,10,40,25,0,39258480,3652,32114340,2970,11253
1667,6,36,25,0,39287820,3652,32178660,2975,11259
1668,6,30,25,0,39309960,3650,32425620,2995,11265
1669,7,27,25,0,39334560,3649,32732640,3022,11272
1670,8,31,25,0,39341880,3648,32734200,3020,11280
1671,10,35,25,0,39375480,3649,32741340,3018,11290
1672,3,34,25,0,39395280,3650,32751060,3018,11293
1673,12,40,25,0,39407940,3649,32753940,3015,11305
1674,8,40,25,0,39433920,3650,32767680,3015,11313
1675,8,38,25,0,39460860,3651,32796120,3017,11321
1676,7,33,25,0,39488820,3649,33012000,3034,11328
1677,3,26,25,0,39503220,3647,33478140,3076,11331
1678,4,18,25,0,39528360,3645,34499040,3169,11335
1679,10,15,25,0,39547560,3643,34667280,3181,11345
1680,3,12,25,0,39570300,3643,34839780,3196,11348
1681,3,0,25,0,39588420,3639,35566080,3262,11351
1682,4,0,22,3,39607260,3639,35566080,3261,11355
1683,4,0,23,2,39618000,3639,35566080,3260,11359
1684,5,0,24,1,39623220,3638,35566260,3258,11364
1685,6,0,25,0,39642780,3638,35566260,3256,11370
1686,4,1,25,0,39657120,3638,35568900,3256,11374
1687,4,0,25,0,39681420,3639,35573700,3255,11378
1688,10,5,25,0,39704160,3639,35577180,3252,11388
1689,9,10,25,0,39724200,3640,35582760,3250,11397
1690,4,11,25,0,39742620,3641,35593800,3250,11401
1691,13,19,25,0,39767520,3641,35603820,3247,11414
1692,8,25,25,0,39777900,3641,35604540,3245,11422
1693,12,31,25,0,39807720,3642,35620200,3243,11434
1694,7,35,25,0,39821580,3642,35636460,3243,11441
1695,7,40,24,1,39840840,3643,35640000,3241,11448
1696,4,38,24,1,39867420,3645,35652960,3241,11452
1697,10,38,25,0,39889980,3645,35708160,3245,11462
1698,7,40,25,0,39907920,3645,35739600,3246,11469
1699,9,38,25,0,39924240,3645,35781240,3248,11478
1700,6,40,25,0,39943560,3646,35813580,3250,11484
1701,5,36,25,0,39977580,3646,35869140,3254,11489
1702,6,38,25,0,39991920,3646,35870640,3252,11495
1703,3,38,25,0,40004340,3646,35952660,3258,11498
1704,6,37,25,0,40035300,3647,36056040,3266,11504
1705,2,34,25,0,40055940,3647,36161160,3275,11506
1706,3,30,25,0,40083600,3647,36470040,3302,11509
1707,2,12,25,0,40113660,3643,37290420,3375,11511
1708,4,0,24,1,40128840,3639,37693980,3411,11515
1709,4,0,25,0,40132620,3638,37693980,3409,11519
1710,6,3,25,0,40154880,3639,37696680,3408,11525
1711,6,4,25,0,40182180,3640,37708740,3407,11531
1712,9,4,25,0,40198020,3639,37716120,3406,11540
1713,10,7,25,0,40224540,3639,37720740,3403,11550
1714,11,16,25,0,40235400,3639,37723260,3400,11561
1715,5,17,24,1,40266420,3640,37728660,3398,11566
1716,8,23,25,0,40270680,3640,37735260,3398,11574
1717,14,33,24,1,40307880,3642,37746480,3393,11588
1718,4,35,24,1,40320300,3642,37750440,3393,11592
1719,8,40,24,1,40326300,3643,37752720,3391,11600
1720,3,37,25,0,40357800,3644,37798440,3394,11603
1721,13,39,25,0,40381980,3645,37834620,3395,11616
1722,3,35,25,0,40406820,3646,37888140,3400,11619
1723,8,37,25,0,40426080,3645,37911780,3400,11627
1724,7,39,24,1,40442100,3646,37917480,3399,11634
1725,7,39,23,2,40458960,3647,37922100,3399,11641
1726,5,39,24,1,40476720,3648,37947240,3400,11646
1727,3,37,25,0,40491480,3648,37969260,3402,11649
1728,9,37,25,0,40524540,3648,38107560,3411,11658
1729,5,39,25,0,40538280,3648,38109780,3410,11663
1730,1,36,25,0,40557960,3649,38227860,3421,11664
1731,3,34,25,0,40573800,3649,38291880,3425,11667
1732,4,27,25,0,40613580,3649,38713200,3462,11671
1733,1,19,25,0,40630740,3647,39199740,3505,11672
1734,8,11,25,0,40654260,3644,39689940,3546,11680
1735,9,13,25,0,40668060,3643,39706140,3545,11689
1736,7,14,25,0,40687200,3643,39710460,3543,11696
1737,5,15,25,0,40707720,3643,39714660,3542,11701
1738,6,18,25,0,40730520,3644,39724800,3541,11707
1739,14,27,25,0,40758480,3645,39738420,3538,11721
1740,16,40,24,1,40773360,3646,39740040,3534,11737
1741,11,39,24,1,40785960,3646,39749160,3533,11748
1742,7,38,25,0,40814520,3647,39762120,3533,11755
1743,6,39,25,0,40835580,3647,39798660,3535,11761
1744,5,39,25,0,40849980,3647,39836580,3537,11766
1745,7,37,25,0,40881060,3648,39906000,3541,11773
1746,7,40,25,0,40892760,3647,39913980,3540,11780
1747,4,37,25,0,40915920,3648,39928860,3541,11784
1748,3,36,25,0,40937520,3649,39935880,3540,11787
1749,8,38,25,0,40963620,3649,40010280,3545,11795
1750,3,38,25,0,40976880,3649,40023540,3545,11798
1751,3,35,25,0,41007060,3650,40201680,3559,11801
1752,4,33,25,0,41026380,3650,40286700,3566,11805
1753,6,30,25,0,41048160,3649,40570500,3589,11811
1754,2,22,25,0,41075160,3648,41344500,3657,11813
1755,5,9,25,0,41095740,3644,41947260,3708,11818
1756,4,2,25,0,41114160,3642,42368220,3744,11822
1757,9,5,25,0,41133180,3642,42432660,3748,11831
1758,5,7,25,0,41145600,3642,42438180,3747,11836
1759,5,8,25,0,41169060,3643,42447180,3745,11841
1760,9,11,25,0,41193240,3643,42527940,3750,11850
1761,5,12,25,0,41207580,3643,42535620,3748,11855
1762,12,19,25,0,41238600,3644,42540000,3745,11867
1763,8,26,24,1,41250780,3645,42542280,3743,11875
1764,10,33,23,2,41280420,3646,42554520,3741,11885
1765,9,40,23,2,41280420,3646,42554520,3741,11894
1766,8,40,23,2,41299560,3647,42575220,3739,11902
1767,13,40,25,0,41313420,3647,42599640,3740,11915
1768,7,40,25,0,41332080,3648,42641100,3743,11922
1769,11,40,25,0,41352960,3649,42667500,3744,11933
1770,12,40,25,0,41384760,3650,42700020,3745,11945
1771,7,38,25,0,41403540,3650,42801840,3752,11952
1772,11,39,25,0,41428260,3650,42846300,3754,11963
1773,7,40,25,0,41439600,3650,42873960,3755,11970
1774,5,38,25,0,41462820,3651,42885840,3755,11975
1775,4,33,25,0,41494320,3651,43186380,3780,11979
1776,4,25,25,0,41520120,3649,43531560,3809,11983
1777,2,17,25,0,41531340,3647,43871100,3838,11985
1778,3,8,25,0,41549760,3645,44347440,3879,11988
1779,4,0,23,2,41579580,3643,44638020,3903,11992
1780,1,0,22,3,41588460,3643,44638020,3902,11993
1781,7,0,24,1,41605680,3643,44638020,3900,12000
1782,3,0,23,2,41615040,3642,44638020,3899,12003
1783,6,0,22,3,41641380,3642,44639400,3897,12009
1784,7,0,23,2,41649120,3641,44639700,3895,12016
1785,10,4,25,0,41665080,3641,44640360,3892,12026
1786,10,10,25,0,41679900,3641,44644920,3890,12036
1787,10,16,24,1,41711100,3642,44655360,3886,12046
1788,10,23,25,0,41721720,3643,44661180,3884,12056
1789,10,31,23,2,41746680,3644,44669640,3881,12066
1790,8,38,22,3,41761620,3644,44670780,3880,12074
1791,6,40,21,4,41767440,3644,44670780,3880,12080
1792,7,40,21,4,41767440,3644,44670780,3880,12087
1793,8,39,25,0,41792160,3646,44761980,3884,12095
1794,9,40,25,0,41792160,3646,44761980,3884,12104
1795,7,40,25,0,41811720,3646,44803800,3886,12111
1796,6,39,24,1,41851440,3648,44829360,3886,12117
1797,6,40,24,1,41859360,3648,44831400,3886,12123
1798,5,39,25,0,41888580,3650,44889780,3889,12128
1799,3,37,25,0,41912700,3650,44965980,3895,12131
1800,7,39,25,0,41933280,3650,45020160,3898,12138
1801,5,40,25,0,41940720,3650,45061200,3900,12143
1802,4,36,25,0,41981580,3651,45238560,3914,12147
1803,8,37,25,0,42000660,3651,45356520,3921,12155
1804,5,38,25,0,42018060,3651,45361440,3920,12160
1805,7,39,25,0,42028800,3651,45424020,3924,12167
1806,4,38,25,0,42047820,3652,45435120,3924,12171
1807,5,38,25,0,42080280,3653,45510120,3930,12176
1808,7,39,25,0,42097200,3653,45513480,3927,12183
1809,12,39,25,0,42116520,3653,45604560,3934,12195
1810,2,31,25,0,42151020,3653,45972480,3965,12197
1811,12,32,25,0,42173880,3652,46046460,3968,12209
1812,7,36,25,0,42186000,3652,46050180,3966,12216
1813,9,39,25,0,42207540,3652,46055280,3963,12225
1814,4,38,25,0,42235680,3653,46073460,3964,12229
1815,7,37,25,0,42257520,3653,46129980,3967,12236
1816,9,34,25,0,42279060,3651,46422960,3989,12245
1817,15,38,25,0,42304440,3651,46511040,3993,12260
1818,10,39,25,0,42320160,3650,46517040,3991,12270
1819,7,36,25,0,42346080,3650,46580220,3995,12277
1820,6,31,25,0,42362640,3648,46729560,4005,12283
1821,7,27,25,0,42388800,3647,47043120,4029,12290
1822,4,29,25,0,42395700,3647,47043300,4028,12294
1823,6,30,25,0,42426600,3648,47053920,4027,12300
1824,6,33,25,0,42442440,3648,47059500,4025,12306
1825,7,37,25,0,42462420,3649,47062920,4023,12313
1826,5,36,25,0,42495360,3650,47084520,4023,12318
1827,3,29,25,0,42519600,3649,47372580,4047,12321
1828,2,17,25,0,42540420,3646,48540840,4146,12323
1829,4,9,25,0,42557340,3644,49109100,4193,12327
1830,8,11,25,0,42572160,3643,49113960,4190,12335
1831,7,15,25,0,42581280,3643,49276200,4204,12342
1832,14,25,24,1,42615540,3645,49283460,4200,12356
1833,6,28,24,1,42634560,3645,49294860,4196,12362
1834,8,33,24,1,42653040,3646,49303200,4195,12370
1835,11,40,23,2,42658860,3646,49303200,4195,12381
1836,9,40,24,1,42674580,3647,49318320,4193,12390
1837,10,40,25,0,42702600,3648,49372980,4195,12400
1838,10,40,25,0,42716340,3648,49418820,4198,12410
1839,9,39,25,0,42752520,3649,49436880,4197,12419
1840,10,40,25,0,42764400,3649,49438920,4196,12429
1841,2,38,25,0,42785460,3650,49494060,4200,12431
1842,7,39,25,0,42811380,3650,49569360,4204,12438
1843,4,36,25,0,42837960,3651,49719600,4216,12442
1844,8,38,25,0,42855540,3650,49847880,4225,12450
1845,5,36,25,0,42880560,3650,49898100,4226,12455
1846,7,34,25,0,42900960,3649,50002320,4232,12462
1847,9,37,25,0,42915540,3648,50214120,4247,12471
1848,3,38,23,2,42945300,3650,50223120,4246,12474
1849,3,39,24,1,42952020,3650,50232180,4246,12477
1850,3,38,25,0,42969300,3651,50255880,4247,12480
1851,3,34,25,0,42995280,3651,50327040,4252,12483
1852,1,24,25,0,43017960,3649,51194640,4325,12484
1853,7,8,25,0,43052160,3645,52262460,4412,12491
1854,4,0,22,3,43066860,3642,52852440,4461,12495
1855,3,0,23,2,43077120,3642,52852440,4460,12498
1856,8,2,25,0,43085880,3641,52853880,4457,12506
1857,7,6,25,0,43104060,3642,52855020,4454,12513
1858,7,9,25,0,43129380,3643,52867020,4453,12520
1859,8,15,23,2,43148400,3643,52871400,4450,12528
1860,10,21,25,0,43160760,3644,52885560,4450,12538
1861,14,28,25,0,43190640,3644,52908600,4445,12552
1862,15,40,24,1,43206960,3644,52912560,4440,12567
1863,10,38,23,2,43229340,3645,52922160,4440,12577
1864,6,39,25,0,43244820,3646,52950420,4441,12583
1865,9,38,25,0,43273740,3647,52978920,4441,12592
1866,6,40,25,0,43283940,3647,52980960,4440,12598
1867,13,40,25,0,43304400,3647,53030400,4442,12611
1868,7,38,25,0,43328700,3647,53084580,4445,12618
1869,5,37,25,0,43347900,3647,53170740,4452,12623
1870,8,37,25,0,43375140,3647,53294100,4458,12631
1871,6,36,25,0,43399980,3647,53336220,4459,12637
1872,4,34,25,0,43422060,3647,53458740,4468,12641
1873,4,28,25,0,43437120,3645,53655480,4483,12645
1874,2,29,25,0,43438080,3645,53655600,4482,12647
1875,3,19,25,0,43490100,3645,54136500,4521,12650
1876,6,14,25,0,43502100,3643,54415980,4543,12656
1877,4,11,25,0,43523040,3643,54541200,4551,12660
1878,5,8,25,0,43543860,3642,54662700,4559,12665
1879,10,13,25,0,43550940,3641,54811740,4569,12675
1880,7,17,24,1,43580280,3642,54816120,4566,12682
1881,7,19,25,0,43612740,3644,54823800,4564,12689
1882,12,29,25,0,43621740,3644,54824760,4562,12701
1883,9,35,25,0,43641480,3644,54829020,4559,12710
1884,7,40,24,1,43661640,3645,54832860,4556,12717
1885,15,40,23,2,43685700,3646,54842880,4554,12732
1886,7,40,22,3,43697160,3647,54849720,4554,12739
1887,7,39,25,0,43711740,3647,54909600,4557,12746
1888,10,40,25,0,43725060,3648,54912840,4557,12756
1889,10,40,25,0,43755240,3649,54964080,4560,12766
1890,7,40,25,0,43777140,3649,54968820,4557,12773
1891,1,38,25,0,43788300,3649,54997020,4559,12774
1892,9,38,25,0,43820160,3650,55103580,4566,12783
1893,6,39,25,0,43832580,3650,55187280,4571,12789
1894,4,36,25,0,43864500,3650,55206600,4571,12793
1895,5,39,24,1,43876080,3650,55210260,4571,12798
1896,6,40,23,2,43892280,3651,55213440,4569,12804
1897,3,39,25,0,43899900,3651,55261620,4572,12807
1898,4,33,25,0,43942500,3652,55646400,4603,12811
1899,10,37,25,0,43957380,3651,55648860,4599,12821
1900,1,37,23,2,43973760,3652,55651740,4598,12822
1901,9,40,22,3,43989480,3652,55656960,4598,12831
1902,7,39,23,2,44004420,3653,55674060,4598,12838
1903,5,38,24,1,44021220,3653,55686840,4598,12843
1904,3,36,25,0,44037660,3653,55741200,4601,12846
1905,6,39,25,0,44044080,3653,55745220,4600,12852
1906,8,40,25,0,44068260,3654,55764660,4600,12860
1907,9,40,25,0,44094720,3655,55784700,4600,12869
1908,14,39,25,0,44122140,3655,55797240,4598,12883
1909,11,39,25,0,44135820,3655,55873380,4603,12894
1910,8,38,25,0,44160120,3655,56253420,4632,12902
1911,5,35,25,0,44183460,3654,56289600,4632,12907
1912,10,32,25,0,44211420,3652,56700660,4662,12917
1913,11,38,25,0,44222580,3652,56704500,4659,12928
1914,8,38,25,0,44244480,3652,56713920,4658,12936
1915,4,26,25,0,44280120,3651,57552780,4725,12940
1916,2,9,25,0,44299920,3646,59225220,4862,12942
1917,4,0,22,3,44318220,3643,59832780,4910,12946
1918,7,0,25,0,44329320,3643,59833080,4907,12953
1919,4,2,25,0,44339220,3643,59835300,4906,12957
1920,7,4,25,0,44366520,3644,59844060,4904,12964
1921,8,8,25,0,44383080,3644,59846820,4902,12972
1922,11,15,25,0,44401740,3644,59854620,4897,12983
1923,10,20,25,0,44428440,3645,59856540,4893,12993
1924,8,24,25,0,44454360,3646,59863320,4891,13001
1925,5,28,25,0,44457120,3646,59865660,4890,13006
1926,5,27,25,0,44497680,3647,59904060,4890,13011
1927,4,26,25,0,44515380,3647,59938740,4891,13015
1928,4,22,25,0,44547720,3648,60011580,4895,13019
1929,8,25,25,0,44560680,3647,60047580,4895,13027
1930,7,24,25,0,44587920,3647,60088260,4895,13034
1931,10,29,25,0,44608860,3647,60122340,4894,13044
1932,9,35,25,0,44622780,3648,60127140,4891,13053
1933,11,40,24,1,44641740,3648,60128280,4889,13064
1934,12,40,24,1,44654340,3649,60134700,4889,13076
1935,13,40,25,0,44676900,3650,60142140,4888,13089
1936,12,39,23,2,44697420,3650,60147780,4888,13101
1937,4,38,25,0,44723040,3652,60196500,4890,13105
1938,9,39,25,0,44744220,3652,60225360,4891,13114
1939,9,40,24,1,44760360,3652,60227880,4890,13123
1940,7,40,25,0,44779920,3653,60235140,4888,13130
1941,4,38,25,0,44806800,3653,60253620,4888,13134
1942,4,36,25,0,44833740,3654,60340800,4893,13138
1943,5,34,25,0,44852100,3653,60429660,4899,13143
1944,6,33,25,0,44879220,3653,60516960,4903,13149
1945,1,24,25,0,44900160,3652,61041780,4945,13150
1946,6,15,25,0,44912940,3649,62032500,5024,13156
1947,6,3,25,0,44944320,3646,62501340,5059,13162
1948,6,0,23,2,44963700,3644,62672160,5070,13168
1949,3,0,22,3,44976120,3644,62672160,5069,13171
1950,2,0,21,4,44988660,3644,62672160,5068,13173
1951,7,0,24,1,44999640,3644,62672160,5065,13180
1952,6,0,25,0,45015420,3644,62672820,5063,13186
1953,7,0,24,1,45040860,3643,62675100,5060,13193
1954,11,6,25,0,45048840,3643,62676120,5056,13204
1955,8,11,25,0,45067320,3643,62681220,5053,13212
1956,6,11,25,0,45093840,3644,62688240,5051,13218
1957,7,13,25,0,45115080,3644,62707980,5050,13225
1958,9,15,25,0,45141900,3644,62726580,5048,13234
1959,16,28,25,0,45150000,3644,62728260,5045,13250
1960,8,36,22,3,45165540,3644,62728260,5045,13258
1961,12,40,25,0,45193860,3646,62754600,5039,13270
1962,13,39,25,0,45208620,3646,62765940,5036,13283
1963,6,39,25,0,45236520,3647,62792760,5037,13289
1964,1,35,25,0,45255000,3647,62851800,5041,13290
1965,7,34,25,0,45284160,3647,62938080,5046,13297
1966,3,30,25,0,45303300,3647,62999520,5049,13300
1967,4,28,25,0,45329700,3647,63108300,5056,13304
1968,5,30,25,0,45342600,3647,63111960,5054,13309
1969,8,32,25,0,45368100,3647,63195120,5059,13317
1970,7,37,22,3,45389340,3648,63197460,5056,13324
1971,8,39,23,2,45400500,3648,63213000,5054,13332
1972,8,40,25,0,45419640,3649,63242880,5055,13340
1973,4,39,25,0,45432540,3649,63257820,5055,13344
1974,7,36,25,0,45467040,3650,63334500,5059,13351
1975,4,35,25,0,45478200,3649,63484920,5070,13355
1976,2,21,25,0,45512220,3647,64202820,5126,13357
1977,7,10,25,0,45528000,3643,64782840,5171,13364
1978,15,15,25,0,45540720,3641,64803540,5166,13379
1979,7,18,23,2,45567540,3642,64806120,5163,13386
1980,7,23,24,1,45573540,3642,64809180,5161,13393
1981,9,28,25,0,45598440,3643,64819680,5158,13402
1982,16,40,25,0,45618180,3644,64823640,5152,13418
1983,9,40,23,2,45629760,3644,64823640,5152,13427
1984,10,38,25,0,45665280,3646,64855440,5152,13437
1985,7,40,25,0,45667260,3646,64857300,5151,13444
1986,3,38,25,0,45697200,3647,64942320,5157,13447
1987,2,34,25,0,45725700,3647,65021160,5162,13449
1988,6,34,25,0,45741660,3647,65119860,5168,13455
1989,1,29,25,0,45763980,3647,65235720,5176,13456
1990,4,24,25,0,45793320,3646,65522580,5197,13460
1991,7,23,25,0,45807180,3645,65569380,5198,13467
1992,12,32,23,2,45830700,3646,65572500,5194,13479
1993,6,38,22,3,45837360,3646,65572500,5194,13485
1994,6,38,25,0,45864720,3647,65585460,5189,13491
1995,0,37,25,0,45868740,3647,65589300,5190,13491
1996,5,36,25,0,45903600,3648,65637180,5191,13496
1997,6,40,25,0,45906420,3648,65652900,5192,13502
1998,5,37,25,0,45943260,3649,65691180,5192,13507
1999,11,40,25,0,45955980,3649,65698800,5191,13518
2000,8,40,25,0,45981660,3649,65814960,5197,13526
2001,6,37,25,0,46005600,3649,65918040,5203,13532
2002,9,36,25,0,46028040,3648,65946420,5202,13541
2003,9,40,25,0,46036020,3648,65950320,5199,13550
2004,11,40,25,0,46062300,3649,65967480,5200,13561
2005,8,40,25,0,46085460,3649,65981460,5199,13569
2006,5,37,25,0,46112880,3649,65994960,5197,13574
2007,10,40,25,0,46123980,3649,66046500,5199,13584
2008,10,36,25,0,46161600,3650,66199860,5210,13594
2009,14,38,25,0,46175940,3647,66538320,5233,13608
2010,8,40,23,2,46186260,3648,66538320,5233,13616
2011,7,39,23,2,46207440,3649,66554160,5230,13623
2012,7,40,25,0,46218840,3649,66569400,5229,13630
2013,6,40,25,0,46248180,3650,66587640,5229,13636
2014,6,30,25,0,46278540,3648,67147560,5271,13642
2015,3,11,25,0,46303620,3644,68898840,5407,13645
2016,4,7,25,0,46313760,3642,69257940,5434,13649
2017,3,10,25,0,46313760,3642,69257940,5434,13652
2018,3,13,25,0,46313760,3642,69257940,5434,13655
2019,11,24,25,0,46313760,3642,69257940,5434,13666
2020,6,30,25,0,46313760,3642,69257940,5434,13672
2021,7,37,25,0,46313760,3642,69257940,5434,13679
2022,5,40,25,0,46313760,3642,69257940,5434,13684
2023,9,40,25,0,46313760,3642,69257940,5434,13693
2024,6,40,25,0,46313760,3642,69257940,5434,13699
2025,7,40,25,0,46313760,3642,69257940,5434,13706
2026,5,40,25,0,46313760,3642,69257940,5434,13711
2027,9,40,25,0,46313760,3642,69257940,5434,13720
2028,12,40,25,0,46313760,3642,69257940,5434,13732
2029,12,40,25,0,46313760,3642,69257940,5434,13744
2030,6,40,25,0,46313760,3642,69257940,5434,13750
2031,9,40,25,0,46313760,3642,69257940,5434,13759
2032,6,40,25,0,46313760,3642,69257940,5434,13765
2033,10,40,25,0,46313760,3642,69257940,5434,13775
2034,12,40,25,0,46313760,3642,69257940,5434,13787
2035,2,40,25,0,46313760,3642,69257940,5434,13789
2036,6,40,25,0,46313760,3642,69257940,5434,13795
2037,6,40,25,0,46313760,3642,69257940,5434,13801
2038,6,40,25,0,46313760,3642,69257940,5434,13807
2039,5,40,25,0,46313760,3642,69257940,5434,13812
2040,7,40,25,0,46313760,3642,69257940,5434,13819
2041,5,40,25,0,46313760,3642,69257940,5434,13824
2042,2,40,25,0,46313760,3642,69257940,5434,13826
2043,4,40,25,0,46313760,3642,69257940,5434,13830
2044,10,40,25,0,46313760,3642,69257940,5434,13840
2045,6,40,25,0,46313760,3642,69257940,5434,13846
2046,4,40,25,0,46313760,3642,69257940,5434,13850
2047,6,40,25,0,46313760,3642,69257940,5434,13856
2048,4,40,25,0,46313760,3642,69257940,5434,13860
2049,6,40,25,0,46313760,3642,69257940,5434,13866
2050,8,40,25,0,46313760,3642,69257940,5434,13874
2051,6,40,25,0,46313760,3642,69257940,5434,13880
2052,10,40,25,0,46313760,3642,69257940,5434,13890
2053,10,40,25,0,46313760,3642,69257940,5434,13900
2054,12,40,25,0,46313760,3642,69257940,5434,13912
2055,9,40,25,0,46313760,3642,69257940,5434,13921
2056,9,40,25,0,46313760,3642,69257940,5434,13930
2057,10,40,25,0,46313760,3642,69257940,5434,13940
2058,7,40,25,0,46313760,3642,69257940,5434,13947
2059,7,40,25,0,46313760,3642,69257940,5434,13954
2060,6,40,25,0,46313760,3642,69257940,5434,13960
2061,5,40,25,0,46313760,3642,69257940,5434,13965
2062,8,40,25,0,46313760,3642,69257940,5434,13973
2063,5,40,25,0,46313760,3642,69257940,5434,13978
2064,4,40,25,0,46313760,3642,69257940,5434,13982
2065,7,40,25,0,46313760,3642,69257940,5434,13989
2066,4,40,25,0,46313760,3642,69257940,5434,13993
2067,4,40,25,0,46313760,3642,69257940,5434,13997
2068,8,40,25,0,46313760,3642,69257940,5434,14005
2069,4,40,25,0,46313760,3642,69257940,5434,14009
2070,3,40,25,0,46313760,3642,69257940,5434,14012
2071,7,40,25,0,46313760,3642,69257940,5434,14019
2072,10,40,25,0,46313760,3642,69257940,5434,14029
2073,11,40,25,0,46313760,3642,69257940,5434,14040
2074,9,40,25,0,46313760,3642,69257940,5434,14049
2075,8,40,25,0,46313760,3642,69257940,5434,14057
2076,10,40,25,0,46313760,3642,69257940,5434,14067
2077,5,40,25,0,46313760,3642,69257940,5434,14072
2078,5,40,25,0,46313760,3642,69257940,5434,14077
2079,6,40,25,0,46313760,3642,69257940,5434,14083
2080,13,40,25,0,46313760,3642,69257940,5434,14096
2081,1,40,25,0,46313760,3642,69257940,5434,14097
2082,7,40,25,0,46313760,3642,69257940,5434,14104
2083,8,40,25,0,46313760,3642,69257940,5434,14112
2084,2,40,25,0,46313760,3642,69257940,5434,14114
2085,6,40,25,0,46313760,3642,69257940,5434,14120
2086,6,40,25,0,46313760,3642,69257940,5434,14126
2087,4,40,25,0,46313760,3642,69257940,5434,14130
2088,1,40,25,0,46313760,3642,69257940,5434,14131
2089,5,40,25,0,46313760,3642,69257940,5434,14136
2090,4,40,25,0,46313760,3642,69257940,5434,14140
2091,5,40,25,0,46313760,3642,69257940,5434,14145
2092,5,40,25,0,46313760,3642,69257940,5434,14150
2093,2,40,25,0,46313760,3642,69257940,5434,14152
2094,8,40,25,0,46313760,3642,69257940,5434,14160
2095,9,40,25,0,46313760,3642,69257940,5434,14169
2096,5,40,25,0,46313760,3642,69257940,5434,14174
2097,10,40,25,0,46313760,3642,69257940,5434,14184
2098,8,40,25,0,46313760,3642,69257940,5434,14192
2099,10,40,25,0,46313760,3642,69257940,5434,14202
2100,7,40,25,0,46313760,3642,69257940,5434,14209
2101,8,40,25,0,46313760,3642,69257940,5434,14217
2102,10,40,25,0,46313760,3642,69257940,5434,14227
2103,8,40,25,0,46313760,3642,69257940,5434,14235
2104,13,40,25,0,46313760,3642,69257940,5434,14248
2105,4,40,25,0,46313760,3642,69257940,5434,14252
2106,7,40,25,0,46313760,3642,69257940,5434,14259
2107,6,40,25,0,46313760,3642,69257940,5434,14265
2108,5,40,25,0,46313760,3642,69257940,5434,14270
2109,7,40,25,0,46313760,3642,69257940,5434,14277
2110,7,40,25,0,46313760,3642,69257940,5434,14284
2111,6,40,25,0,46313760,3642,69257940,5434,14290
2112,3,40,25,0,46313760,3642,69257940,5434,14293
2113,6,40,25,0,46313760,3642,69257940,5434,14299
2114,4,40,25,0,46313760,3642,69257940,5434,14303
2115,3,40,25,0,46313760,3642,69257940,5434,14306
2116,2,40,25,0,46313760,3642,69257940,5434,14308
2117,3,40,25,0,46313760,3642,69257940,5434,14311
2118,5,40,25,0,46313760,3642,69257940,5434,14316
2119,10,40,25,0,46313760,3642,69257940,5434,14326
2120,10,40,25,0,46313760,3642,69257940,5434,14336
2121,3,40,25,0,46313760,3642,69257940,5434,14339
2122,5,40,25,0,46313760,3642,69257940,5434,14344
2123,9,40,25,0,46313760,3642,69257940,5434,14353
2124,6,40,25,0,46313760,3642,69257940,5434,14359
2125,11,40,25,0,46313760,3642,69257940,5434,14370
2126,11,40,25,0,46313760,3642,69257940,5434,14381
2127,13,40,25,0,46313760,3642,69257940,5434,14394
2128,11,40,25,0,46313760,3642,69257940,5434,14405
2129,10,40,25,0,46313760,3642,69257940,5434,14415
2130,10,40,25,0,46313760,3642,69257940,5434,14425
2131,6,40,25,0,46313760,3642,69257940,5434,14431
2132,5,40,25,0,46313760,3642,69257940,5434,14436
2133,7,40,25,0,46313760,3642,69257940,5434,14443
2134,7,40,25,0,46313760,3642,69257940,5434,14450
2135,2,40,25,0,46313760,3642,69257940,5434,14452
2136,4,40,25,0,46313760,3642,69257940,5434,14456
2137,1,40,25,0,46313760,3642,69257940,5434,14457
2139,4,40,25,0,46313760,3642,69257940,5434,14461
2138,0,40,25,0,46313760,3642,69257940,5434,14461
2140,6,40,25,0,46313760,3642,69257940,5434,14467
2141,4,40,25,0,46313760,3642,69257940,5434,14471
2142,11,40,25,0,46313760,3642,69257940,5434,14482
2143,6,40,25,0,46313760,3642,69257940,5434,14488
2144,8,40,25,0,46313760,3642,69257940,5434,14496
2145,13,40,25,0,46313760,3642,69257940,5434,14509
2146,4,40,25,0,46313760,3642,69257940,5434,14513
2147,5,40,25,0,46313760,3642,69257940,5434,14518
2148,16,40,25,0,46313760,3642,69257940,5434,14534
2149,6,40,25,0,46313760,3642,69257940,5434,14540
2150,15,40,25,0,46313760,3642,69257940,5434,14555
2151,12,40,25,0,46313760,3642,69257940,5434,14567
2152,10,40,25,0,46313760,3642,69257940,5434,14577
2153,2,40,25,0,46313760,3642,69257940,5434,14579
2154,4,40,25,0,46313760,3642,69257940,5434,14583
2155,8,40,25,0,46313760,3642,69257940,5434,14591
2156,5,40,25,0,46313760,3642,69257940,5434,14596
2157,7,40,25,0,46313760,3642,69257940,5434,14603
2158,3,40,25,0,46313760,3642,69257940,5434,14606
2159,7,40,25,0,46313760,3642,69257940,5434,14613
2160,1,40,25,0,46313760,3642,69257940,5434,14614
2161,4,40,25,0,46313760,3642,69257940,5434,14618
2162,3,40,25,0,46313760,3642,69257940,5434,14621
2163,4,40,25,0,46313760,3642,69257940,5434,14625
2164,6,40,25,0,46313760,3642,69257940,5434,14631
2165,4,40,25,0,46313760,3642,69257940,5434,14635
2166,11,40,25,0,46313760,3642,69257940,5434,14646
2167,8,40,25,0,46313760,3642,69257940,5434,14654
2168,7,40,25,0,46313760,3642,69257940,5434,14661
2169,8,40,25,0,46313760,3642,69257940,5434,14669
2170,10,40,25,0,46313760,3642,69257940,5434,14679
2171,8,40,25,0,46313760,3642,69257940,5434,14687
2172,4,40,25,0,46313760,3642,69257940,5434,14691
2173,7,40,25,0,46313760,3642,69257940,5434,14698
2174,8,40,25,0,46313760,3642,69257940,5434,14706
2175,13,40,25,0,46313760,3642,69257940,5434,14719
2176,18,40,25,0,46313760,3642,69257940,5434,14737
2177,10,40,25,0,46313760,3642,69257940,5434,14747
2178,10,40,25,0,46313760,3642,69257940,5434,14757
2179,4,40,25,0,46313760,3642,69257940,5434,14761
2180,5,40,25,0,46313760,3642,69257940,5434,14766
2181,4,40,25,0,46313760,3642,69257940,5434,14770
2182,7,40,25,0,46313760,3642,69257940,5434,14777
2183,7,40,25,0,46313760,3642,69257940,5434,14784
2184,1,40,25,0,46313760,3642,69257940,5434,14785
2185,6,40,25,0,46313760,3642,69257940,5434,14791
2186,8,40,25,0,46313760,3642,69257940,5434,14799
2187,3,40,25,0,46313760,3642,69257940,5434,14802
2188,9,40,25,0,46313760,3642,69257940,5434,14811
2189,4,40,25,0,46313760,3642,69257940,5434,14815
2190,4,40,25,0,46313760,3642,69257940,5434,14819
2191,7,40,25,0,46313760,3642,69257940,5434,14826
2192,8,40,25,0,46313760,3642,69257940,5434,14834
2193,9,40,25,0,46313760,3642,69257940,5434,14843
2194,11,40,25,0,46313760,3642,69257940,5434,14854
2195,6,40,25,0,46313760,3642,69257940,5434,14860
2196,6,40,25,0,46313760,3642,69257940,5434,14866
2197,8,40,25,0,46313760,3642,69257940,5434,14874
2198,10,40,25,0,46313760,3642,69257940,5434,14884
2199,11,40,25,0,46313760,3642,69257940,5434,14895
2200,8,40,25,0,46313760,3642,69257940,5434,14903
2201,7,40,25,0,46313760,3642,69257940,5434,14910
2202,4,40,25,0,46313760,3642,69257940,5434,14914
2203,10,40,25,0,46313760,3642,69257940,5434,14924
2204,8,40,25,0,46313760,3642,69257940,5434,14932
2205,7,40,25,0,46313760,3642,69257940,5434,14939
2206,4,40,25,0,46313760,3642,69257940,5434,14943
2207,5,40,25,0,46313760,3642,69257940,5434,14948
2208,12,40,25,0,46313760,3642,69257940,5434,14960
2209,4,40,25,0,46313760,3642,69257940,5434,14964
2210,3,40,25,0,46313760,3642,69257940,5434,14967
2211,12,40,25,0,46313760,3642,69257940,5434,14979
2212,9,40,25,0,46313760,3642,69257940,5434,14988
2213,9,40,25,0,46313760,3642,69257940,5434,14997
2214,3,40,25,0,46313760,3642,69257940,5434,15000
2215,10,40,25,0,46313760,3642,69257940,5434,15010
2216,6,40,25,0,46313760,3642,69257940,5434,15016
2217,8,40,25,0,46313760,3642,69257940,5434,15024
2218,13,40,25,0,46313760,3642,69257940,5434,15037
2219,16,40,25,0,46313760,3642,69257940,5434,15053
2220,9,40,25,0,46313760,3642,69257940,5434,15062
2221,7,40,25,0,46313760,3642,69257940,5434,15069
2222,9,40,25,0,46313760,3642,69257940,5434,15078
2223,10,40,25,0,46313760,3642,69257940,5434,15088
2224,11,40,25,0,46313760,3642,69257940,5434,15099
2225,7,40,25,0,46313760,3642,69257940,5434,15106
2226,5,40,25,0,46313760,3642,69257940,5434,15111
2227,6,40,25,0,46313760,3642,69257940,5434,15117
2228,7,40,25,0,46313760,3642,69257940,5434,15124
2229,4,40,25,0,46313760,3642,69257940,5434,15128
2230,1,40,25,0,46313760,3642,69257940,5434,15129
2231,5,40,25,0,46313760,3642,69257940,5434,15134
2232,2,40,25,0,46313760,3642,69257940,5434,15136
2233,8,40,25,0,46313760,3642,69257940,5434,15144
2234,2,40,25,0,46313760,3642,69257940,5434,15146
2235,4,40,25,0,46313760,3642,69257940,5434,15150
2236,6,40,25,0,46313760,3642,69257940,5434,15156
2237,5,40,25,0,46313760,3642,69257940,5434,15161
2238,6,40,25,0,46313760,3642,69257940,5434,15167
2239,6,40,25,0,46313760,3642,69257940,5434,15173
2240,8,40,25,0,46313760,3642,69257940,5434,15181
2241,11,40,25,0,46313760,3642,69257940,5434,15192
2242,13,40,25,0,46313760,3642,69257940,5434,15205
2243,3,40,25,0,46313760,3642,69257940,5434,15208
2244,5,40,25,0,46313760,3642,69257940,5434,15213
2245,6,40,25,0,46313760,3642,69257940,5434,15219
2246,9,40,25,0,46313760,3642,69257940,5434,15228
2247,9,40,25,0,46313760,3642,69257940,5434,15237
2248,6,40,25,0,46313760,3642,69257940,5434,15243
2249,13,40,25,0,46313760,3642,69257940,5434,15256
2250,6,40,25,0,46313760,3642,69257940,5434,15262
2251,4,40,25,0,46313760,3642,69257940,5434,15266
2252,5,40,25,0,46313760,3642,69257940,5434,15271
2253,6,40,25,0,46313760,3642,69257940,5434,15277
2254,6,40,25,0,46313760,3642,69257940,5434,15283
2255,9,40,25,0,46313760,3642,69257940,5434,15292
2256,2,40,25,0,46313760,3642,69257940,5434,15294
2257,4,40,25,0,46313760,3642,69257940,5434,15298
2258,8,40,25,0,46313760,3642,69257940,5434,15306
2259,9,40,25,0,46313760,3642,69257940,5434,15315
2260,6,40,25,0,46313760,3642,69257940,5434,15321
2261,8,40,25,0,46313760,3642,69257940,5434,15329
2262,9,40,25,0,46313760,3642,69257940,5434,15338
2263,2,40,25,0,46313760,3642,69257940,5434,15340
2264,6,40,25,0,46313760,3642,69257940,5434,15346
2265,4,40,25,0,46313760,3642,69257940,5434,15350
2266,9,40,25,0,46313760,3642,69257940,5434,15359
2267,15,40,25,0,46313760,3642,69257940,5434,15374
2268,5,40,25,0,46313760,3642,69257940,5434,15379
2269,6,40,25,0,46313760,3642,69257940,5434,15385
2270,8,40,25,0,46313760,3642,69257940,5434,15393
2271,11,40,25,0,46313760,3642,69257940,5434,15404
2272,5,40,25,0,46313760,3642,69257940,5434,15409
2273,7,40,25,0,46313760,3642,69257940,5434,15416
2274,10,40,25,0,46313760,3642,69257940,5434,15426
2275,4,40,25,0,46313760,3642,69257940,5434,15430
2276,3,40,25,0,46313760,3642,69257940,5434,15433
2277,8,40,25,0,46313760,3642,69257940,5434,15441
2278,3,40,25,0,46313760,3642,69257940,5434,15444
2279,7,40,25,0,46313760,3642,69257940,5434,15451
2280,7,40,25,0,46313760,3642,69257940,5434,15458
2281,7,40,25,0,46313760,3642,69257940,5434,15465
2282,5,40,25,0,46313760,3642,69257940,5434,15470
2283,5,40,25,0,46313760,3642,69257940,5434,15475
2284,7,40,25,0,46313760,3642,69257940,5434,15482
2285,3,40,25,0,46313760,3642,69257940,5434,15485
2286,6,40,25,0,46313760,3642,69257940,5434,15491
2287,2,40,25,0,46313760,3642,69257940,5434,15493
2288,5,40,25,0,46313760,3642,69257940,5434,15498
2289,8,40,25,0,46313760,3642,69257940,5434,15506
2290,6,40,25,0,46313760,3642,69257940,5434,15512
2291,7,40,25,0,46313760,3642,69257940,5434,15519
2292,5,40,25,0,46313760,3642,69257940,5434,15524
2293,4,40,25,0,46313760,3642,69257940,5434,15528
2294,6,40,25,0,46313760,3642,69257940,5434,15534
2295,9,40,25,0,46313760,3642,69257940,5434,15543
2296,8,40,25,0,46313760,3642,69257940,5434,15551
2297,4,40,25,0,46313760,3642,69257940,5434,15555
2298,8,40,25,0,46313760,3642,69257940,5434,15563
2299,7,40,25,0,46313760,3642,69257940,5434,15570
2300,11,40,25,0,46313760,3642,69257940,5434,15581
2301,4,40,25,0,46313760,3642,69257940,5434,15585
2302,6,40,25,0,46313760,3642,69257940,5434,15591
2303,6,40,25,0,46313760,3642,69257940,5434,15597
2304,3,40,25,0,46313760,3642,69257940,5434,15600
2305,13,40,25,0,46313760,3642,69257940,5434,15613
2307,1,40,25,0,46313760,3642,69257940,5434,15614
2306,0,40,25,0,46313760,3642,69257940,5434,15614
2308,9,40,25,0,46313760,3642,69257940,5434,15623
2309,2,40,25,0,46313760,3642,69257940,5434,15625
2310,6,40,25,0,46313760,3642,69257940,5434,15631
2311,4,40,25,0,46313760,3642,69257940,5434,15635
2312,5,40,25,0,46313760,3642,69257940,5434,15640
2313,2,40,25,0,46313760,3642,69257940,5434,15642
2314,15,40,25,0,46313760,3642,69257940,5434,15657
2315,15,40,25,0,46313760,3642,69257940,5434,15672
2316,12,40,25,0,46313760,3642,69257940,5434,15684
2317,8,40,25,0,46313760,3642,69257940,5434,15692
2318,14,40,25,0,46313760,3642,69257940,5434,15706
2319,14,40,25,0,46313760,3642,69257940,5434,15720
2320,8,40,25,0,46313760,3642,69257940,5434,15728
2321,6,40,25,0,46313760,3642,69257940,5434,15734
2322,6,40,25,0,46313760,3642,69257940,5434,15740
2323,4,40,25,0,46313760,3642,69257940,5434,15744
2324,7,40,25,0,46313760,3642,69257940,5434,15751
2325,6,40,25,0,46313760,3642,69257940,5434,15757
2326,4,40,25,0,46313760,3642,69257940,5434,15761
2327,4,40,25,0,46313760,3642,69257940,5434,15765
2328,7,40,25,0,46313760,3642,69257940,5434,15772
2329,5,40,25,0,46313760,3642,69257940,5434,15777
2330,3,40,25,0,46313760,3642,69257940,5434,15780
2331,5,40,25,0,46313760,3642,69257940,5434,15785
2332,5,40,25,0,46313760,3642,69257940,5434,15790
2333,2,40,25,0,46313760,3642,69257940,5434,15792
2334,9,40,25,0,46313760,3642,69257940,5434,15801
2335,7,40,25,0,46313760,3642,69257940,5434,15808
2336,9,40,25,0,46313760,3642,69257940,5434,15817
2337,5,40,25,0,46313760,3642,69257940,5434,15822
2338,13,40,25,0,46313760,3642,69257940,5434,15835
2339,4,40,25,0,46313760,3642,69257940,5434,15839
2340,11,40,25,0,46313760,3642,69257940,5434,15850
2341,8,40,25,0,46313760,3642,69257940,5434,15858
2342,18,40,25,0,46313760,3642,69257940,5434,15876
2343,4,40,25,0,46313760,3642,69257940,5434,15880
2344,6,40,25,0,46313760,3642,69257940,5434,15886
2345,10,40,25,0,46313760,3642,69257940,5434,15896
2346,7,40,25,0,46313760,3642,69257940,5434,15903
2347,4,40,25,0,46313760,3642,69257940,5434,15907
2348,8,40,25,0,46313760,3642,69257940,5434,15915
2349,11,40,25,0,46313760,3642,69257940,5434,15926
2350,4,40,25,0,46313760,3642,69257940,5434,15930
2351,3,40,25,0,46313760,3642,69257940,5434,15933
2352,4,40,25,0,46313760,3642,69257940,5434,15937
2353,3,40,25,0,46313760,3642,69257940,5434,15940
2354,2,40,25,0,46313760,3642,69257940,5434,15942
2355,1,40,25,0,46313760,3642,69257940,5434,15943
2356,3,40,25,0,46313760,3642,69257940,5434,15946
2357,2,40,25,0,46313760,3642,69257940,5434,15948
2358,4,40,25,0,46313760,3642,69257940,5434,15952
2359,2,40,25,0,46313760,3642,69257940,5434,15954
2360,5,40,25,0,46313760,3642,69257940,5434,15959
2361,8,40,25,0,46313760,3642,69257940,5434,15967
2362,7,40,25,0,46313760,3642,69257940,5434,15974
2363,8,40,25,0,46313760,3642,69257940,5434,15982
2364,7,40,25,0,46313760,3642,69257940,5434,15989
2365,11,40,25,0,46313760,3642,69257940,5434,16000
2366,7,40,25,0,46313760,3642,69257940,5434,16007
2367,4,40,25,0,46313760,3642,69257940,5434,16011
2368,8,40,25,0,46313760,3642,69257940,5434,16019
2369,4,40,25,0,46313760,3642,69257940,5434,16023
2370,10,40,25,0,46313760,3642,69257940,5434,16033
2371,2,40,25,0,46313760,3642,69257940,5434,16035
2372,10,40,25,0,46313760,3642,69257940,5434,16045
2373,6,40,25,0,46313760,3642,69257940,5434,16051
2374,12,40,25,0,46313760,3642,69257940,5434,16063
2375,6,40,25,0,46313760,3642,69257940,5434,16069
2376,3,40,25,0,46313760,3642,69257940,5434,16072
2377,4,40,25,0,46313760,3642,69257940,5434,16076
2378,8,40,25,0,46313760,3642,69257940,5434,16084
2379,5,40,25,0,46313760,3642,69257940,5434,16089
2380,8,40,25,0,46313760,3642,69257940,5434,16097
2381,8,40,25,0,46313760,3642,69257940,5434,16105
2382,4,40,25,0,46313760,3642,69257940,5434,16109
2383,9,40,25,0,46313760,3642,69257940,5434,16118
2384,9,40,25,0,46313760,3642,69257940,5434,16127
2385,8,40,25,0,46313760,3642,69257940,5434,16135
2386,10,40,25,0,46313760,3642,69257940,5434,16145
2387,5,40,25,0,46313760,3642,69257940,5434,16150
2388,9,40,25,0,46313760,3642,69257940,5434,16159
2389,12,40,25,0,46313760,3642,69257940,5434,16171
2390,12,40,25,0,46313760,3642,69257940,5434,16183
2391,17,40,25,0,46313760,3642,69257940,5434,16200
2392,6,40,25,0,46313760,3642,69257940,5434,16206
2393,6,40,25,0,46313760,3642,69257940,5434,16212
2394,9,40,25,0,46313760,3642,69257940,5434,16221
2395,7,40,25,0,46313760,3642,69257940,5434,16228
2396,6,40,25,0,46313760,3642,69257940,5434,16234
2397,7,40,25,0,46313760,3642,69257940,5434,16241
2398,3,40,25,0,46313760,3642,69257940,5434,16244
2399,7,40,25,0,46313760,3642,69257940,5434,16251
2400,5,40,25,0,46313760,3642,69257940,5434,16256
2401,3,40,25,0,46313760,3642,69257940,5434,16259
2402,4,40,25,0,46313760,3642,69257940,5434,16263
2403,7,40,25,0,46313760,3642,69257940,5434,16270
2404,9,40,25,0,46313760,3642,69257940,5434,16279
2405,1,40,25,0,46313760,3642,69257940,5434,16280
2406,8,40,25,0,46313760,3642,69257940,5434,16288
2407,10,40,25,0,46313760,3642,69257940,5434,16298
2408,4,40,25,0,46313760,3642,69257940,5434,16302
2409,15,40,25,0,46313760,3642,69257940,5434,16317
2410,6,40,25,0,46313760,3642,69257940,5434,16323
2411,10,40,25,0,46313760,3642,69257940,5434,16333
2412,9,40,25,0,46313760,3642,69257940,5434,16342
2413,9,40,25,0,46313760,3642,69257940,5434,16351
2414,11,40,25,0,46313760,3642,69257940,5434,16362
2415,7,40,25,0,46313760,3642,69257940,5434,16369
2416,5,40,25,0,46313760,3642,69257940,5434,16374
2417,9,40,25,0,46313760,3642,69257940,5434,16383
2418,4,40,25,0,46313760,3642,69257940,5434,16387
2419,8,40,25,0,46313760,3642,69257940,5434,16395
2420,7,40,25,0,46313760,3642,69257940,5434,16402
2421,7,40,25,0,46313760,3642,69257940,5434,16409
2422,10,40,25,0,46313760,3642,69257940,5434,16419
2423,7,40,25,0,46313760,3642,69257940,5434,16426
2424,3,40,25,0,46313760,3642,69257940,5434,16429
2425,5,40,25,0,46313760,3642,69257940,5434,16434
2426,1,40,25,0,46313760,3642,69257940,5434,16435
2427,4,40,25,0,46313760,3642,69257940,5434,16439
2428,6,40,25,0,46313760,3642,69257940,5434,16445
2429,3,40,25,0,46313760,3642,69257940,5434,16448
2430,8,40,25,0,46313760,3642,69257940,5434,16456
2431,4,40,25,0,46313760,3642,69257940,5434,16460
2432,6,40,25,0,46313760,3642,69257940,5434,16466
2433,7,40,25,0,46313760,3642,69257940,5434,16473
2434,8,40,25,0,46313760,3642,69257940,5434,16481
2435,10,40,25,0,46313760,3642,69257940,5434,16491
2436,7,40,25,0,46313760,3642,69257940,5434,16498
2437,8,40,25,0,46313760,3642,69257940,5434,16506
2438,14,40,25,0,46313760,3642,69257940,5434,16520
2439,7,40,25,0,46313760,3642,69257940,5434,16527
2440,14,40,25,0,46313760,3642,69257940,5434,16541
2441,5,40,25,0,46313760,3642,69257940,5434,16546
2442,10,40,25,0,46313760,3642,69257940,5434,16556
2443,9,40,25,0,46313760,3642,69257940,5434,16565
2444,7,40,25,0,46313760,3642,69257940,5434,16572
2445,6,40,25,0,46313760,3642,69257940,5434,16578
2446,5,40,25,0,46313760,3642,69257940,5434,16583
2447,9,40,25,0,46313760,3642,69257940,5434,16592
2448,4,40,25,0,46313760,3642,69257940,5434,16596
2449,6,40,25,0,46313760,3642,69257940,5434,16602
2450,4,40,25,0,46313760,3642,69257940,5434,16606
2451,8,40,25,0,46313760,3642,69257940,5434,16614
2452,8,40,25,0,46313760,3642,69257940,5434,16622
2453,4,40,25,0,46313760,3642,69257940,5434,16626
2454,8,40,25,0,46313760,3642,69257940,5434,16634
2455,10,40,25,0,46313760,3642,69257940,5434,16644
2456,10,40,25,0,46313760,3642,69257940,5434,16654
2457,12,40,25,0,46313760,3642,69257940,5434,16666
2458,9,40,25,0,46313760,3642,69257940,5434,16675
2459,10,40,25,0,46313760,3642,69257940,5434,16685
2460,11,40,25,0,46313760,3642,69257940,5434,16696
2461,12,40,25,0,46313760,3642,69257940,5434,16708
2462,11,40,25,0,46313760,3642,69257940,5434,16719
2463,8,40,25,0,46313760,3642,69257940,5434,16727
2464,7,40,25,0,46313760,3642,69257940,5434,16734
2465,10,40,25,0,46313760,3642,69257940,5434,16744
2466,8,40,25,0,46313760,3642,69257940,5434,16752
2467,10,40,25,0,46313760,3642,69257940,5434,16762
2468,10,40,25,0,46313760,3642,69257940,5434,16772
2469,5,40,25,0,46313760,3642,69257940,5434,16777
2470,7,40,25,0,46313760,3642,69257940,5434,16784
2471,1,40,25,0,46313760,3642,69257940,5434,16785
2472,3,40,25,0,46313760,3642,69257940,5434,16788
2473,7,40,25,0,46313760,3642,69257940,5434,16795
2474,3,40,25,0,46313760,3642,69257940,5434,16798
2475,4,40,25,0,46313760,3642,69257940,5434,16802
2476,5,40,25,0,46313760,3642,69257940,5434,16807
2477,6,40,25,0,46313760,3642,69257940,5434,16813
2478,11,40,25,0,46313760,3642,69257940,5434,16824
2479,4,40,25,0,46313760,3642,69257940,5434,16828
2480,6,40,25,0,46313760,3642,69257940,5434,16834
2481,7,40,25,0,46313760,3642,69257940,5434,16841
2482,8,40,25,0,46313760,3642,69257940,5434,16849
2483,7,40,25,0,46313760,3642,69257940,5434,16856
2484,13,40,25,0,46313760,3642,69257940,5434,16869
2485,8,40,25,0,46313760,3642,69257940,5434,16877
2486,6,40,25,0,46313760,3642,69257940,5434,16883
2487,10,40,25,0,46313760,3642,69257940,5434,16893
2488,11,40,25,0,46313760,3642,69257940,5434,16904
2489,4,40,25,0,46313760,3642,69257940,5434,16908
2490,9,40,25,0,46313760,3642,69257940,5434,16917
2491,5,40,25,0,46313760,3642,69257940,5434,16922
2492,10,40,25,0,46313760,3642,69257940,5434,16932
2493,8,40,25,0,46313760,3642,69257940,5434,16940
2494,7,40,25,0,46313760,3642,69257940,5434,16947
2495,4,40,25,0,46313760,3642,69257940,5434,16951
2496,5,40,25,0,46313760,3642,69257940,5434,16956
2497,4,40,25,0,46313760,3642,69257940,5434,16960
2498,3,40,25,0,46313760,3642,69257940,5434,16963
2499,7,40,25,0,46313760,3642,69257940,5434,16970
2500,3,40,25,0,46313760,3642,69257940,5434,16973
2501,9,40,25,0,46313760,3642,69257940,5434,16982
2502,5,40,25,0,46313760,3642,69257940,5434,16987
2503,6,40,25,0,46313760,3642,69257940,5434,16993
2504,5,40,25,0,46313760,3642,69257940,5434,16998
2505,3,40,25,0,46313760,3642,69257940,5434,17001
2506,16,40,25,0,46313760,3642,69257940,5434,17017
2507,6,40,25,0,46313760,3642,69257940,5434,17023
2508,10,40,25,0,46313760,3642,69257940,5434,17033
2509,9,40,25,0,46313760,3642,69257940,5434,17042
2510,11,40,25,0,46313760,3642,69257940,5434,17053
2511,14,40,25,0,46313760,3642,69257940,5434,17067
2512,8,40,25,0,46313760,3642,69257940,5434,17075
2513,15,40,25,0,46313760,3642,69257940,5434,17090
2514,5,40,25,0,46313760,3642,69257940,5434,17095
2515,3,40,25,0,46313760,3642,69257940,5434,17098
2516,4,40,25,0,46313760,3642,69257940,5434,17102
2517,9,40,25,0,46313760,3642,69257940,5434,17111
2518,5,40,25,0,46313760,3642,69257940,5434,17116
2519,3,40,25,0,46313760,3642,69257940,5434,17119
2520,6,40,25,0,46313760,3642,69257940,5434,17125
2521,3,40,25,0,46313760,3642,69257940,5434,17128
2522,1,40,25,0,46313760,3642,69257940,5434,17129
2523,8,40,25,0,46313760,3642,69257940,5434,17137
2524,5,40,25,0,46313760,3642,69257940,5434,17142
2525,7,40,25,0,46313760,3642,69257940,5434,17149
2526,6,40,25,0,46313760,3642,69257940,5434,17155
2527,4,40,25,0,46313760,3642,69257940,5434,17159
2528,9,40,25,0,46313760,3642,69257940,5434,17168
2529,6,40,25,0,46313760,3642,69257940,5434,17174
2530,11,40,25,0,46313760,3642,69257940,5434,17185
2531,17,40,25,0,46313760,3642,69257940,5434,17202
2532,14,40,25,0,46313760,3642,69257940,5434,17216
2533,5,40,25,0,46313760,3642,69257940,5434,17221
2534,8,40,25,0,46313760,3642,69257940,5434,17229
2535,7,40,25,0,46313760,3642,69257940,5434,17236
2536,5,40,25,0,46313760,3642,69257940,5434,17241
2537,12,40,25,0,46313760,3642,69257940,5434,17253
2538,5,40,25,0,46313760,3642,69257940,5434,17258
2539,12,40,25,0,46313760,3642,69257940,5434,17270
2540,4,40,25,0,46313760,3642,69257940,5434,17274
2541,2,40,25,0,46313760,3642,69257940,5434,17276
2542,5,40,25,0,46313760,3642,69257940,5434,17281
2543,1,40,25,0,46313760,3642,69257940,5434,17282
2544,7,40,25,0,46313760,3642,69257940,5434,17289
2545,4,40,25,0,46313760,3642,69257940,5434,17293
2546,4,40,25,0,46313760,3642,69257940,5434,17297
2547,4,40,25,0,46313760,3642,69257940,5434,17301
2548,1,40,25,0,46313760,3642,69257940,5434,17302
2549,7,40,25,0,46313760,3642,69257940,5434,17309
2550,2,40,25,0,46313760,3642,69257940,5434,17311
2551,7,40,25,0,46313760,3642,69257940,5434,17318
2552,5,40,25,0,46313760,3642,69257940,5434,17323
2553,8,40,25,0,46313760,3642,69257940,5434,17331
2554,9,40,25,0,46313760,3642,69257940,5434,17340
2555,12,40,25,0,46313760,3642,69257940,5434,17352
2556,8,40,25,0,46313760,3642,69257940,5434,17360
2557,8,40,25,0,46313760,3642,69257940,5434,17368
2558,11,40,25,0,46313760,3642,69257940,5434,17379
2559,6,40,25,0,46313760,3642,69257940,5434,17385
2560,9,40,25,0,46313760,3642,69257940,5434,17394
2561,6,40,25,0,46313760,3642,69257940,5434,17400
2562,7,40,25,0,46313760,3642,69257940,5434,17407
2563,6,40,25,0,46313760,3642,69257940,5434,17413
2564,6,40,25,0,46313760,3642,69257940,5434,17419
2565,3,40,25,0,46313760,3642,69257940,5434,17422
2566,2,40,25,0,46313760,3642,69257940,5434,17424
2567,5,40,25,0,46313760,3642,69257940,5434,17429
2568,3,40,25,0,46313760,3642,69257940,5434,17432
2569,8,40,25,0,46313760,3642,69257940,5434,17440
2570,3,40,25,0,46313760,3642,69257940,5434,17443
2571,3,40,25,0,46313760,3642,69257940,5434,17446
2572,2,40,25,0,46313760,3642,69257940,5434,17448
2573,4,40,25,0,46313760,3642,69257940,5434,17452
2574,7,40,25,0,46313760,3642,69257940,5434,17459
2575,10,40,25,0,46313760,3642,69257940,5434,17469
2576,10,40,25,0,46313760,3642,69257940,5434,17479
2577,6,40,25,0,46313760,3642,69257940,5434,17485
2578,6,40,25,0,46313760,3642,69257940,5434,17491
2579,10,40,25,0,46313760,3642,69257940,5434,17501
2580,8,40,25,0,46313760,3642,69257940,5434,17509
2581,11,40,25,0,46313760,3642,69257940,5434,17520
2582,12,40,25,0,46313760,3642,69257940,5434,17532
2583,6,40,25,0,46313760,3642,69257940,5434,17538
2584,13,40,25,0,46313760,3642,69257940,5434,17551
2585,5,40,25,0,46313760,3642,69257940,5434,17556
2586,10,40,25,0,46313760,3642,69257940,5434,17566
2587,8,40,25,0,46313760,3642,69257940,5434,17574
2588,7,40,25,0,46313760,3642,69257940,5434,17581
2589,5,40,25,0,46313760,3642,69257940,5434,17586
2590,4,40,25,0,46313760,3642,69257940,5434,17590
2591,6,40,25,0,46313760,3642,69257940,5434,17596
2592,2,40,25,0,46313760,3642,69257940,5434,17598
2594,10,40,25,0,46313760,3642,69257940,5434,17608
2593,0,40,25,0,46313760,3642,69257940,5434,17608
2595,4,40,25,0,46313760,3642,69257940,5434,17612
2596,3,40,25,0,46313760,3642,69257940,5434,17615
2597,3,40,25,0,46313760,3642,69257940,5434,17618
2598,6,40,25,0,46313760,3642,69257940,5434,17624
2599,7,40,25,0,46313760,3642,69257940,5434,17631
2600,11,40,25,0,46313760,3642,69257940,5434,17642
2601,9,40,25,0,46313760,3642,69257940,5434,17651
2602,11,40,25,0,46313760,3642,69257940,5434,17662
2603,11,40,25,0,46313760,3642,69257940,5434,17673
2604,7,40,25,0,46313760,3642,69257940,5434,17680
2605,7,40,25,0,46313760,3642,69257940,5434,17687
2606,8,40,25,0,46313760,3642,69257940,5434,17695
2607,11,40,25,0,46313760,3642,69257940,5434,17706
2608,10,40,25,0,46313760,3642,69257940,5434,17716
2609,4,40,25,0,46313760,3642,69257940,5434,17720
2610,12,40,25,0,46313760,3642,69257940,5434,17732
2611,11,40,25,0,46313760,3642,69257940,5434,17743
2612,9,40,25,0,46313760,3642,69257940,5434,17752
2613,4,40,25,0,46313760,3642,69257940,5434,17756
2614,7,40,25,0,46313760,3642,69257940,5434,17763
2615,9,40,25,0,46313760,3642,69257940,5434,17772
2616,1,40,25,0,46313760,3642,69257940,5434,17773
2617,8,40,25,0,46313760,3642,69257940,5434,17781
2618,7,40,25,0,46313760,3642,69257940,5434,17788
2619,3,40,25,0,46313760,3642,69257940,5434,17791
2620,5,40,25,0,46313760,3642,69257940,5434,17796
2621,4,40,25,0,46313760,3642,69257940,5434,17800
2622,4,40,25,0,46313760,3642,69257940,5434,17804
2623,7,40,25,0,46313760,3642,69257940,5434,17811
2624,8,40,25,0,46313760,3642,69257940,5434,17819
2625,4,40,25,0,46313760,3642,69257940,5434,17823
2626,9,40,25,0,46313760,3642,69257940,5434,17832
2627,7,40,25,0,46313760,3642,69257940,5434,17839
2628,7,40,25,0,46313760,3642,69257940,5434,17846
2629,6,40,25,0,46313760,3642,69257940,5434,17852
2630,11,40,25,0,46313760,3642,69257940,5434,17863
2631,6,40,25,0,46313760,3642,69257940,5434,17869
2632,13,40,25,0,46313760,3642,69257940,5434,17882
2633,10,40,25,0,46313760,3642,69257940,5434,17892
2634,6,40,25,0,46313760,3642,69257940,5434,17898
2635,4,40,25,0,46313760,3642,69257940,5434,17902
2636,6,40,25,0,46313760,3642,69257940,5434,17908
2637,7,40,25,0,46313760,3642,69257940,5434,17915
2638,4,40,25,0,46313760,3642,69257940,5434,17919
2639,4,40,25,0,46313760,3642,69257940,5434,17923
2640,8,40,25,0,46313760,3642,69257940,5434,17931
2641,2,40,25,0,46313760,3642,69257940,5434,17933
2642,4,40,25,0,46313760,3642,69257940,5434,17937
2643,3,40,25,0,46313760,3642,69257940,5434,17940
2644,2,40,25,0,46313760,3642,69257940,5434,17942
2645,5,40,25,0,46313760,3642,69257940,5434,17947
2646,3,40,25,0,46313760,3642,69257940,5434,17950
2647,5,40,25,0,46313760,3642,69257940,5434,17955
2648,4,40,25,0,46313760,3642,69257940,5434,17959
2649,5,40,25,0,46313760,3642,69257940,5434,17964
2650,11,40,25,0,46313760,3642,69257940,5434,17975
2651,10,40,25,0,46313760,3642,69257940,5434,17985
2652,5,40,25,0,46313760,3642,69257940,5434,17990
2653,11,40,25,0,46313760,3642,69257940,5434,18001
2654,12,40,25,0,46313760,3642,69257940,5434,18013
2655,7,40,25,0,46313760,3642,69257940,5434,18020
2656,12,40,25,0,46313760,3642,69257940,5434,18032
2657,4,40,25,0,46313760,3642,69257940,5434,18036
2658,11,40,25,0,46313760,3642,69257940,5434,18047
2659,7,40,25,0,46313760,3642,69257940,5434,18054
2660,8,40,25,0,46313760,3642,69257940,5434,18062
2661,5,40,25,0,46313760,3642,69257940,5434,18067
2662,7,40,25,0,46313760,3642,69257940,5434,18074
2663,4,40,25,0,46313760,3642,69257940,5434,18078
2664,8,40,25,0,46313760,3642,69257940,5434,18086
2665,3,40,25,0,46313760,3642,69257940,5434,18089
2666,6,40,25,0,46313760,3642,69257940,5434,18095
2667,3,40,25,0,46313760,3642,69257940,5434,18098
2668,3,40,25,0,46313760,3642,69257940,5434,18101
2669,8,40,25,0,46313760,3642,69257940,5434,18109
2670,7,40,25,0,46313760,3642,69257940,5434,18116
2671,8,40,25,0,46313760,3642,69257940,5434,18124
2672,4,40,25,0,46313760,3642,69257940,5434,18128
2673,9,40,25,0,46313760,3642,69257940,5434,18137
2674,8,40,25,0,46313760,3642,69257940,5434,18145
2675,5,40,25,0,46313760,3642,69257940,5434,18150
2676,8,40,25,0,46313760,3642,69257940,5434,18158
2677,2,40,25,0,46313760,3642,69257940,5434,18160
2678,10,40,25,0,46313760,3642,69257940,5434,18170
2679,11,40,25,0,46313760,3642,69257940,5434,18181
2680,11,40,25,0,46313760,3642,69257940,5434,18192
2681,2,40,25,0,46313760,3642,69257940,5434,18194
2682,3,40,25,0,46313760,3642,69257940,5434,18197
2683,10,40,25,0,46313760,3642,69257940,5434,18207
2684,4,40,25,0,46313760,3642,69257940,5434,18211
2685,5,40,25,0,46313760,3642,69257940,5434,18216
2686,5,40,25,0,46313760,3642,69257940,5434,18221
2687,7,40,25,0,46313760,3642,69257940,5434,18228

