Hour,Arrivals,Waiting,Treating,Available Rooms,Total Treatment Time,Average Treatment Time,Total Wait Time,Average Wait Time,Total Arrivals
1,5,0,3,22,1560,780,0,0,5
2,8,0,8,17,10260,2052,0,0,13
3,8,0,8,17,29700,2284,0,0,21
4,5,0,7,18,47460,2497,0,0,26
5,12,0,6,19,94440,2951,0,0,38
6,5,0,2,23,115800,2824,0,0,43
7,4,0,3,22,122160,2776,0,0,47
8,9,0,9,16,133440,2839,0,0,56
9,7,0,4,21,171240,2902,0,0,63
10,11,0,8,17,191160,2896,0,0,74
11,12,0,13,12,202620,2775,0,0,86
12,10,0,11,14,242820,2856,0,0,96
13,6,0,6,19,282960,2947,0,0,102
14,6,0,9,16,289260,2921,0,0,108
15,8,0,9,16,327060,3056,0,0,116
16,16,0,15,10,360720,3083,0,0,132
17,7,0,9,16,413880,3183,0,0,139
18,6,0,8,17,450240,3286,0,0,145
19,9,0,9,16,482220,3325,0,0,154
20,9,0,9,16,509400,3307,0,0,163
21,9,0,11,14,548940,3409,0,0,172
22,4,0,4,21,595020,3459,0,0,176
23,8,0,6,19,612120,3438,0,0,184
24,6,0,8,17,622740,3421,0,0,190
25,7,0,6,19,656880,3439,0,0,197
26,5,0,6,19,673740,3437,0,0,202
27,5,0,9,16,685980,3464,0,0,207
28,4,0,2,23,725580,3471,0,0,211
29,6,0,5,20,737460,3478,0,0,217
30,7,0,8,17,744780,3448,0,0,224
31,14,0,16,9,770520,3470,0,0,238
32,8,0,12,13,820260,3505,0,0,246
33,10,0,13,12,864660,3558,0,0,256
34,10,0,8,17,913680,3541,0,0,266
35,12,0,11,14,946800,3546,0,0,278
36,15,0,21,4,962340,3538,0,0,293
37,7,0,10,15,1035480,3570,0,0,300
38,9,0,7,18,1083420,3587,0,0,309
39,13,0,10,15,1111440,3562,0,0,322
40,11,0,13,12,1131840,3537,0,0,333
41,5,0,5,20,1193220,3583,0,0,338
42,12,0,12,13,1206480,3569,0,0,350
43,0,0,1,24,1252020,3587,0,0,350
44,11,0,7,18,1264860,3573,0,0,361
45,2,0,4,21,1274880,3551,0,0,363
46,4,0,4,21,1294080,3564,0,0,367
47,3,0,2,23,1316160,3576,0,0,370
48,3,0,3,22,1324920,3580,0,0,373
49,2,0,2,23,1341600,3596,0,0,375
50,4,0,3,22,1345560,3578,0,0,379
51,3,0,3,22,1359120,3586,0,0,382
52,4,0,3,22,1369620,3576,0,0,386
53,3,0,3,22,1386180,3591,0,0,389
54,3,0,2,23,1399680,3588,0,0,392
55,12,0,7,18,1415760,3566,0,0,404
56,13,0,9,16,1436880,3521,0,0,417
57,9,0,5,20,1468920,3489,0,0,426
58,8,0,7,18,1485300,3478,0,0,434
59,12,0,11,14,1505580,3461,0,0,446
60,8,0,7,18,1548780,3464,0,0,454
61,7,0,7,18,1578600,3477,0,0,461
62,12,0,7,18,1611840,3458,0,0,473
63,7,0,7,18,1627620,3441,0,0,480
64,9,0,8,17,1652460,3435,0,0,489
65,17,0,16,9,1685700,3440,0,0,506
66,10,0,13,12,1723740,3426,0,0,516
67,8,0,10,15,1783500,3469,0,0,524
68,10,0,10,15,1827420,3487,0,0,534
69,10,0,13,12,1850760,3485,0,0,544
70,9,0,5,20,1915020,3494,0,0,553
71,4,0,5,20,1934940,3505,0,0,557
72,4,0,5,20,1948980,3505,0,0,561
73,3,0,4,21,1961580,3502,0,0,564
74,6,0,6,19,1982820,3515,0,0,570
75,6,0,6,19,2005800,3518,0,0,576
76,9,0,7,18,2021640,3497,0,0,585
77,4,0,4,21,2044860,3495,0,0,589
78,6,0,3,22,2064000,3486,0,0,595
79,11,0,8,17,2076420,3472,0,0,606
80,11,0,11,14,2097000,3460,0,0,617
81,7,0,10,15,2131320,3471,0,0,624
82,5,0,6,19,2181540,3501,0,0,629
83,15,0,9,16,2203140,3469,0,0,644
84,15,0,12,13,2232420,3450,0,0,659
85,9,0,7,18,2265120,3426,0,0,668
86,11,0,12,13,2288760,3431,0,0,679
87,7,0,9,16,2336820,3451,0,0,686
88,15,0,14,11,2374920,3456,0,0,701
89,11,0,15,10,2412180,3460,0,0,712
90,9,0,15,10,2447640,3466,0,0,721
91,8,0,12,13,2511420,3502,0,0,729
92,3,0,9,16,2550000,3526,0,0,732
93,4,0,4,21,2604240,3557,0,0,736
94,6,0,8,17,2611440,3557,0,0,742
95,4,0,5,20,2636160,3557,0,0,746
96,7,0,5,20,2665440,3563,0,0,753
97,0,0,1,24,2683620,3568,0,0,753
98,1,0,1,24,2692320,3575,0,0,754
99,6,0,6,19,2693220,3571,0,0,760
100,8,0,8,17,2710500,3566,0,0,768
101,7,0,6,19,2740560,3563,0,0,775
102,3,0,5,20,2752800,3561,0,0,778
103,9,0,6,19,2777940,3556,0,0,787
104,13,0,11,14,2798160,3546,0,0,800
105,11,0,12,13,2831460,3543,0,0,811
106,8,0,13,12,2861580,3550,0,0,819
107,7,0,10,15,2909220,3565,0,0,826
108,12,0,12,13,2958420,3581,0,0,838
109,7,0,7,18,2998680,3578,0,0,845
110,13,0,9,16,3023640,3561,0,0,858
111,5,0,8,17,3046980,3563,0,0,863
112,14,0,10,15,3086940,3560,0,0,877
113,10,0,7,18,3123720,3549,0,0,887
114,8,0,6,19,3152580,3546,0,0,895
115,7,0,3,22,3179700,3536,0,0,902
116,5,0,6,19,3181140,3530,0,0,907
117,5,0,4,21,3206520,3531,0,0,912
118,12,0,12,13,3218100,3528,0,0,924
119,3,0,6,19,3262860,3542,0,0,927
120,8,0,10,15,3280260,3546,0,0,935
121,7,0,9,16,3317700,3555,0,0,942
122,5,0,7,18,3337380,3550,0,0,947
123,6,0,7,18,3360120,3551,0,0,953
124,5,0,3,22,3393900,3553,0,0,958
125,6,0,7,18,3400380,3553,0,0,964
126,12,0,8,17,3423840,3537,0,0,976
127,7,0,7,18,3442440,3527,0,0,983
128,4,0,2,23,3477660,3530,0,0,987
129,12,0,6,19,3489360,3513,0,0,999
130,14,0,13,12,3501960,3501,0,0,1013
131,14,0,13,12,3543180,3494,0,0,1027
132,13,0,14,11,3594600,3503,0,0,1040
133,5,0,7,18,3640560,3507,0,0,1045
134,11,0,10,15,3667980,3506,0,0,1056
135,9,0,8,17,3697080,3497,0,0,1065
136,14,0,8,17,3733920,3486,0,0,1079
137,11,0,11,14,3757020,3481,0,0,1090
138,11,0,8,17,3812460,3488,0,0,1101
139,9,0,9,16,3836820,3484,0,0,1110
140,6,0,6,19,3875280,3491,0,0,1116
141,6,0,5,20,3900300,3491,0,0,1122
142,5,0,5,20,3918900,3492,0,0,1127
143,3,0,6,19,3927540,3494,0,0,1130
144,6,0,6,19,3953040,3498,0,0,1136
145,4,0,8,17,3961260,3499,0,0,1140
146,5,0,7,18,3996960,3512,0,0,1145
147,4,0,5,20,4017960,3512,0,0,1149
148,11,0,11,14,4029960,3507,0,0,1160
149,10,0,9,16,4070700,3506,0,0,1170
150,2,0,2,23,4110480,3513,0,0,1172
151,8,0,6,19,4125720,3514,0,0,1180
152,9,0,5,20,4154820,3509,0,0,1189
153,9,0,8,17,4168440,3502,0,0,1198
154,9,0,6,19,4207140,3503,0,0,1207
155,5,0,6,19,4224600,3502,0,0,1212
156,9,0,9,16,4249260,3505,0,0,1221
157,11,0,10,15,4280400,3502,0,0,1232
158,12,0,8,17,4318020,3493,0,0,1244
159,9,0,6,19,4351980,3489,0,0,1253
160,11,0,8,17,4375200,3483,0,0,1264
161,11,0,12,13,4386900,3473,0,0,1275
162,9,0,7,18,4426680,3466,0,0,1284
163,9,0,10,15,4448220,3467,0,0,1293
164,7,0,9,16,4465320,3458,0,0,1300
165,12,0,10,15,4519860,3471,0,0,1312
166,10,0,12,13,4539600,3465,0,0,1322
167,2,0,3,22,4588860,3473,0,0,1324
168,6,0,4,21,4602000,3470,0,0,1330
169,2,0,4,21,4615860,3475,0,0,1332
170,6,0,5,20,4638420,3479,0,0,1338
171,5,0,6,19,4653420,3480,0,0,1343
172,6,0,5,20,4680120,3482,0,0,1349
173,7,0,6,19,4689900,3474,0,0,1356
174,10,0,9,16,4708320,3469,0,0,1366
175,10,0,13,12,4733940,3473,0,0,1376
176,19,0,11,14,4794300,3464,0,0,1395
177,10,0,11,14,4822380,3459,0,0,1405
178,4,0,7,18,4862940,3468,0,0,1409
179,13,0,9,16,4895160,3464,0,0,1422
180,17,4,16,9,4907100,3458,60,0,1439
181,19,6,23,2,4966260,3475,11100,7,1458
182,3,0,14,11,5027040,3474,32100,21,1461
183,6,0,9,16,5091000,3491,32100,21,1467
184,11,0,9,16,5126700,3489,32100,21,1478
185,12,0,11,14,5160120,3488,32100,21,1490
186,5,0,5,20,5210100,3496,32100,21,1495
187,12,0,12,13,5222700,3493,32100,21,1507
188,5,0,5,20,5248200,3482,32100,21,1512
189,15,0,11,14,5287680,3487,32100,21,1527
190,4,0,8,17,5305800,3483,32100,20,1531
191,3,0,5,20,5331480,3486,32100,20,1534
192,4,0,3,22,5365680,3495,32100,20,1538
193,5,0,6,19,5375340,3497,32100,20,1543
194,5,0,6,19,5392920,3497,32100,20,1548
195,5,0,3,22,5418240,3495,32100,20,1553
196,5,0,7,18,5419260,3494,32100,20,1558
197,5,0,9,16,5439420,3500,32100,20,1563
198,5,0,9,16,5463240,3504,32100,20,1568
199,7,0,9,16,5498100,3510,32100,20,1575
200,12,0,6,19,5545320,3507,32100,20,1587
201,7,0,10,15,5551020,3504,32100,20,1594
202,5,0,10,15,5579940,3511,32100,20,1599
203,7,0,7,18,5617500,3513,32100,19,1606
204,10,0,12,13,5644020,3518,32100,19,1616
205,12,0,9,16,5698320,3519,32100,19,1628
206,9,0,10,15,5723100,3517,32100,19,1637
207,10,0,10,15,5763180,3520,32100,19,1647
208,2,0,4,21,5788740,3518,32100,19,1649
209,10,0,5,20,5813220,3514,32100,19,1659
210,8,0,8,17,5837580,3518,32100,19,1667
211,6,0,8,17,5863320,3521,32100,19,1673
212,8,0,9,16,5889120,3522,32100,19,1681
213,4,0,9,16,5910360,3526,32100,19,1685
214,8,0,7,18,5940180,3523,32100,18,1693
215,5,0,6,19,5971500,3529,32100,18,1698
216,9,0,7,18,6001200,3530,32100,18,1707
217,1,0,3,22,6022980,3532,32100,18,1708
218,6,0,6,19,6032340,3531,32100,18,1714
219,5,0,5,20,6048540,3528,32100,18,1719
220,8,0,9,16,6064200,3529,32100,18,1727
221,8,0,9,16,6092520,3529,32100,18,1735
222,4,0,5,20,6126360,3533,32100,18,1739
223,9,0,5,20,6159960,3534,32100,18,1748
224,7,0,9,16,6173880,3536,32100,18,1755
225,16,0,15,10,6203760,3532,32100,18,1771
226,7,0,11,14,6239820,3531,32100,18,1778
227,9,0,9,16,6310260,3549,32100,17,1787
228,8,0,7,18,6342900,3547,32100,17,1795
229,10,0,7,18,6368760,3542,32100,17,1805
230,6,0,6,19,6393960,3542,32100,17,1811
231,11,0,13,12,6404700,3540,32100,17,1822
232,7,0,13,12,6430980,3541,32100,17,1829
233,9,0,8,17,6497580,3550,32100,17,1838
234,8,0,8,17,6541920,3559,32100,17,1846
235,8,0,12,13,6558780,3560,32100,17,1854
236,10,0,11,14,6600120,3561,32100,17,1864
237,12,0,12,13,6635880,3560,32100,17,1876
238,6,0,8,17,6671160,3559,32100,17,1882
239,6,0,4,21,6720900,3567,32100,17,1888
240,5,0,4,21,6728280,3561,32100,16,1893
241,3,0,4,21,6739020,3561,32100,16,1896
242,5,0,3,22,6762240,3562,32100,16,1901
243,3,0,3,22,6776160,3564,32100,16,1904
244,11,0,8,17,6787620,3559,32100,16,1915
245,12,0,8,17,6815400,3551,32100,16,1927
246,6,0,8,17,6841680,3554,32100,16,1933
247,6,0,8,17,6861720,3553,32100,16,1939
248,20,0,19,6,6882600,3547,32100,16,1959
249,11,0,12,13,6945000,3546,32100,16,1970
250,8,0,8,17,6992400,3549,32100,16,1978
251,13,0,14,11,7017840,3549,32100,16,1991
252,18,0,15,10,7077240,3549,32100,15,2009
253,14,0,14,11,7120560,3544,32100,15,2023
254,12,0,10,15,7180920,3546,32100,15,2035
255,11,0,12,13,7210200,3544,32100,15,2046
256,10,0,7,18,7268880,3547,32100,15,2056
257,9,0,8,17,7294500,3546,32100,15,2065
258,10,0,9,16,7319580,3542,32100,15,2075
259,6,0,11,14,7335660,3543,32100,15,2081
260,10,0,10,15,7380120,3546,32100,15,2091
261,9,0,9,16,7412100,3544,32100,15,2100
262,6,0,8,17,7444860,3548,32100,15,2106
263,3,0,3,22,7480620,3552,32100,15,2109
264,5,0,4,21,7497120,3553,32100,15,2114
265,1,0,3,22,7502940,3552,32100,15,2115
266,7,0,6,19,7517340,3552,32100,15,2122
267,4,0,4,21,7542960,3554,32100,15,2126
268,9,0,7,18,7556220,3550,32100,15,2135
269,8,0,7,18,7578000,3547,32100,14,2143
270,8,0,9,16,7596900,3546,32100,14,2151
271,9,0,5,20,7644240,3547,32100,14,2160
272,7,0,6,19,7652940,3541,32100,14,2167
273,3,0,2,23,7677960,3541,32100,14,2170
274,10,0,9,16,7685520,3540,32100,14,2180
275,10,0,9,16,7713660,3536,32100,14,2190
276,13,0,15,10,7743420,3539,32100,14,2203
277,11,0,13,12,7782780,3536,32100,14,2214
278,8,0,9,16,7845300,3545,32100,14,2222
279,17,0,15,10,7879140,3542,32100,14,2239
280,16,0,21,4,7928100,3548,32100,14,2255
281,8,0,11,14,7988880,3547,32100,14,2263
282,8,0,9,16,8042160,3555,32100,14,2271
283,5,0,6,19,8059680,3550,32100,14,2276
284,7,0,9,16,8097000,3560,32100,14,2283
285,5,0,4,21,8129340,3559,32100,14,2288
286,4,0,5,20,8144880,3561,32100,14,2292
287,5,0,7,18,8149320,3558,32100,13,2297
288,2,0,3,22,8173200,3559,32100,13,2299
289,6,0,5,20,8185680,3558,32100,13,2305
290,1,0,1,24,8199060,3557,32100,13,2306
291,1,0,0,25,8205720,3556,32100,13,2307
292,4,0,4,21,8205720,3556,32100,13,2311
293,6,0,3,22,8215200,3550,32100,13,2317
294,7,0,9,16,8216100,3549,32100,13,2324
295,5,0,7,18,8235900,3546,32100,13,2329
296,13,0,14,11,8254980,3545,32100,13,2342
297,7,0,9,16,8297760,3546,32100,13,2349
298,8,0,6,19,8357280,3554,32100,13,2357
299,7,0,7,18,8387160,3558,32100,13,2364
300,7,0,8,17,8403720,3556,32100,13,2371
301,11,0,8,17,8428860,3550,32100,13,2382
302,15,0,12,13,8458980,3546,32100,13,2397
303,17,0,18,7,8499540,3547,32100,13,2414
304,10,0,12,13,8563320,3550,32100,13,2424
305,10,0,6,19,8609400,3545,32100,13,2434
306,7,0,6,19,8635680,3546,32100,13,2441
307,9,0,10,15,8656020,3547,32100,13,2450
308,6,0,8,17,8688960,3549,32100,13,2456
309,3,0,4,21,8717700,3550,32100,13,2459
310,6,0,6,19,8743860,3555,32100,13,2465
311,4,0,9,16,8750100,3556,32100,13,2469
312,5,0,7,18,8785080,3561,32100,12,2474
313,6,0,7,18,8815620,3564,32100,12,2480
314,6,0,10,15,8836860,3569,32100,12,2486
315,5,0,7,18,8870700,3571,32100,12,2491
316,5,0,8,17,8897820,3576,32100,12,2496
317,12,0,10,15,8937960,3578,32100,12,2508
318,5,0,6,19,8973000,3579,32100,12,2513
319,6,0,6,19,9005580,3583,32100,12,2519
320,13,0,10,15,9021000,3576,32100,12,2532
321,7,0,8,17,9049440,3575,32100,12,2539
322,12,0,15,10,9076440,3579,32100,12,2551
323,10,0,13,12,9121200,3579,32100,12,2561
324,9,0,9,16,9170640,3580,32100,12,2570
325,15,0,17,8,9205500,3584,32100,12,2585
326,7,0,11,14,9270120,3591,32100,12,2592
327,10,0,11,14,9311880,3593,32100,12,2602
328,4,0,6,19,9344340,3593,32100,12,2606
329,11,0,7,18,9379860,3593,32100,12,2617
330,10,0,6,19,9411480,3590,32100,12,2627
331,4,0,5,20,9429540,3590,32100,12,2631
332,7,0,5,20,9449460,3588,32100,12,2638
333,7,0,5,20,9473340,3588,32100,12,2645
334,7,0,8,17,9486000,3587,32100,12,2652
335,7,0,7,18,9511560,3586,32100,12,2659
336,3,0,3,22,9538860,3587,32100,12,2662
337,4,0,5,20,9550380,3589,32100,12,2666
338,4,0,4,21,9565080,3587,32100,12,2670
339,7,0,5,20,9583980,3586,32100,11,2677
340,6,0,5,20,9601380,3585,32100,11,2683
341,5,0,5,20,9617820,3584,32100,11,2688
342,5,0,5,20,9632040,3583,32100,11,2693
343,7,0,8,17,9646800,3583,32100,11,2700
344,4,0,7,18,9666780,3584,32100,11,2704
345,11,0,9,16,9697380,3583,32100,11,2715
346,8,0,10,15,9734760,3588,32100,11,2723
347,5,0,7,18,9768600,3590,32100,11,2728
348,8,0,9,16,9789240,3589,32100,11,2736
349,8,0,6,19,9829320,3589,32100,11,2744
350,12,0,12,13,9847380,3588,32100,11,2756
351,8,0,15,10,9861060,3587,32100,11,2764
352,9,0,8,17,9939840,3594,32100,11,2773
353,11,0,12,13,9957960,3592,32100,11,2784
354,12,0,10,15,10005900,3591,32100,11,2796
355,13,0,15,10,10032540,3590,32100,11,2809
356,10,0,14,11,10072260,3590,32100,11,2819
357,4,0,7,18,10118040,3593,32100,11,2823
358,7,0,4,21,10155120,3593,32100,11,2830
359,5,0,4,21,10171860,3593,32100,11,2835
360,6,0,5,20,10180800,3589,32100,11,2841
361,5,0,3,22,10210560,3591,32100,11,2846
362,3,0,6,19,10210560,3591,32100,11,2849
363,3,0,3,22,10237020,3593,32100,11,2852
364,7,0,6,19,10249320,3592,32100,11,2859
365,8,0,7,18,10270140,3590,32100,11,2867
366,2,0,2,23,10296720,3591,32100,11,2869
367,9,0,8,17,10306560,3591,32100,11,2878
368,12,0,10,15,10330140,3586,32100,11,2890
369,6,0,4,21,10373400,3586,32100,11,2896
370,11,0,10,15,10383000,3584,32100,11,2907
371,10,0,13,12,10405320,3583,32100,11,2917
372,11,0,7,18,10458480,3580,32100,10,2928
373,8,0,7,18,10478640,3577,32100,10,2936
374,12,0,8,17,10503180,3572,32100,10,2948
375,10,0,11,14,10535040,3574,32100,10,2958
376,10,0,8,17,10579200,3574,32100,10,2968
377,12,0,10,15,10602660,3569,32100,10,2980
378,5,0,6,19,10634340,3569,32100,10,2985
379,4,0,4,21,10656540,3570,32100,10,2989
380,7,0,5,20,10673940,3568,32100,10,2996
381,8,0,8,17,10687620,3567,32100,10,3004
382,6,0,5,20,10710600,3564,32100,10,3010
383,8,0,3,22,10737480,3561,32100,10,3018
384,1,0,3,22,10738260,3560,32100,10,3019
385,2,0,1,24,10757400,3562,32100,10,3021
386,5,0,4,21,10761240,3560,32100,10,3026
387,6,0,8,17,10766760,3560,32100,10,3032
388,8,0,12,13,10781820,3560,32100,10,3040
389,9,0,10,15,10818720,3559,32100,10,3049
390,9,0,10,15,10837140,3555,32100,10,3058
391,11,0,8,17,10897320,3560,32100,10,3069
392,3,0,2,23,10934880,3561,32100,10,3072
393,9,0,7,18,10948260,3561,32100,10,3081
394,13,0,15,10,10962060,3560,32100,10,3094
395,14,0,16,9,11004420,3558,32100,10,3108
396,11,0,10,15,11068380,3560,32100,10,3119
397,14,0,11,14,11102160,3556,32100,10,3133
398,10,0,8,17,11136360,3552,32100,10,3143
399,5,0,6,19,11163840,3553,32100,10,3148
400,5,0,7,18,11184240,3555,32100,10,3153
401,9,0,9,16,11208960,3555,32100,10,3162
402,6,0,12,13,11219940,3555,32100,10,3168
403,10,0,11,14,11264700,3556,32100,10,3178
404,11,0,14,11,11293740,3557,32100,10,3189
405,7,0,12,13,11334240,3559,32100,10,3196
406,10,0,11,14,11395980,3566,32100,10,3206
407,5,0,7,18,11430780,3567,32100,9,3211
408,4,0,5,20,11463420,3571,32100,9,3215
409,7,0,5,20,11487360,3570,32100,9,3222
410,8,0,5,20,11509680,3568,32100,9,3230
411,7,0,4,21,11529300,3566,32100,9,3237
412,6,0,5,20,11548500,3566,32100,9,3243
413,2,0,5,20,11555400,3566,32100,9,3245
414,4,0,4,21,11576880,3567,32100,9,3249
415,8,0,5,20,11590860,3564,32100,9,3257
416,11,0,10,15,11602080,3561,32100,9,3268
417,5,0,10,15,11632140,3564,32100,9,3273
418,9,0,7,18,11668500,3562,32100,9,3282
419,13,0,14,11,11687820,3562,32100,9,3295
420,13,0,17,8,11723700,3562,32100,9,3308
421,10,0,11,14,11783040,3563,32100,9,3318
422,9,0,7,18,11825640,3561,32100,9,3327
423,8,0,7,18,11847660,3559,32100,9,3335
424,5,0,5,20,11877000,3561,32100,9,3340
425,10,0,11,14,11886480,3559,32100,9,3350
426,9,0,7,18,11935920,3560,32100,9,3359
427,13,0,12,13,11951820,3557,32100,9,3372
428,7,0,9,16,11982300,3555,32100,9,3379
429,2,0,5,20,12010980,3557,32100,9,3381
430,9,0,10,15,12027120,3558,32100,9,3390
431,6,0,7,18,12055800,3557,32100,9,3396
432,5,0,4,21,12082320,3556,32100,9,3401
433,4,0,7,18,12090360,3558,32100,9,3405
434,4,0,6,19,12108780,3558,32100,9,3409
435,5,0,5,20,12128220,3557,32100,9,3414
436,4,0,5,20,12145260,3558,32100,9,3418
437,6,0,7,18,12171660,3562,32100,9,3424
438,5,0,4,21,12197820,3561,32100,9,3429
439,7,0,7,18,12214860,3562,32100,9,3436
440,4,0,7,18,12231000,3562,32100,9,3440
441,11,0,12,13,12262320,3565,32100,9,3451
442,6,0,11,14,12289260,3566,32100,9,3457
443,9,0,12,13,12331920,3570,32100,9,3466
444,11,0,12,13,12381000,3573,32100,9,3477
445,6,0,8,17,12434520,3578,32100,9,3483
446,5,0,8,17,12457680,3579,32100,9,3488
447,5,0,3,22,12495540,3580,32100,9,3493
448,6,0,2,23,12513360,3578,32100,9,3499
449,12,0,10,15,12521280,3576,32100,9,3511
450,9,0,6,19,12565260,3575,32100,9,3520
451,8,0,5,20,12587700,3573,32100,9,3528
452,13,0,12,13,12609420,3573,32100,9,3541
453,8,0,10,15,12646320,3573,32100,9,3549
454,7,0,6,19,12687420,3573,32100,9,3556
455,6,0,8,17,12704100,3574,32100,9,3562
456,4,0,6,19,12737280,3577,32100,9,3566
457,9,0,6,19,12761520,3575,32100,8,3575
458,1,0,5,20,12776400,3577,32100,8,3576
459,4,0,3,22,12804660,3579,32100,8,3580
460,8,0,5,20,12817620,3577,32100,8,3588
461,2,0,2,23,12839340,3578,32100,8,3590
462,4,0,5,20,12840180,3577,32100,8,3594
463,11,0,6,19,12865500,3574,32100,8,3605
464,11,0,9,16,12886800,3572,32100,8,3616
465,18,0,16,9,12921600,3571,32100,8,3634
466,14,0,12,13,12982140,3570,32100,8,3648
467,5,0,9,16,13018860,3572,32100,8,3653
468,12,0,5,20,13058880,3568,32100,8,3665
469,8,0,5,20,13089180,3568,32100,8,3673
470,12,0,13,12,13095060,3566,32100,8,3685
471,4,0,7,18,13138800,3568,32100,8,3689
472,9,0,5,20,13178820,3568,32100,8,3698
473,10,0,12,13,13188180,3568,32100,8,3708
474,5,0,10,15,13213260,3568,32100,8,3713
475,10,0,12,13,13253640,3571,32100,8,3723
476,7,0,7,18,13292160,3570,32100,8,3730
477,3,0,3,22,13327980,3573,32100,8,3733
478,6,0,7,18,13332300,3572,32100,8,3739
479,8,0,9,16,13351020,3571,32100,8,3747
480,3,0,5,20,13385040,3574,32100,8,3750
481,6,0,5,20,13406160,3574,32100,8,3756
482,6,0,5,20,13429920,3574,32100,8,3762
483,5,0,5,20,13442820,3573,32100,8,3767
484,7,0,8,17,13461840,3574,32100,8,3774
485,3,0,5,20,13488600,3575,32100,8,3777
486,2,0,3,22,13509960,3577,32100,8,3779
487,5,0,3,22,13536360,3580,32100,8,3784
488,7,0,6,19,13546680,3579,32100,8,3791
489,8,0,9,16,13568100,3579,32100,8,3799
490,9,0,12,13,13583160,3578,32100,8,3808
491,13,0,15,10,13624620,3579,32100,8,3821
492,11,0,10,15,13684980,3580,32100,8,3832
493,12,0,11,14,13723140,3580,32100,8,3844
494,9,0,10,15,13772760,3583,32100,8,3853
495,14,0,12,13,13808460,3581,32100,8,3867
496,12,0,13,12,13848120,3582,32100,8,3879
497,5,0,8,17,13889880,3583,32100,8,3884
498,6,0,5,20,13913460,3581,32100,8,3890
499,11,0,11,14,13933440,3581,32100,8,3901
500,5,0,8,17,13949580,3578,32100,8,3906
501,12,0,8,17,13994340,3579,32100,8,3918
502,4,0,6,19,14017680,3579,32100,8,3922
503,7,0,6,19,14044500,3580,32100,8,3929
504,8,0,8,17,14073120,3581,32100,8,3937
505,7,0,6,19,14095200,3579,32100,8,3944
506,7,0,8,17,14115120,3579,32100,8,3951
507,3,0,5,20,14133360,3578,32100,8,3954
508,4,0,5,20,14150040,3579,32100,8,3958
509,9,0,8,17,14183040,3582,32100,8,3967
510,11,0,12,13,14201940,3580,32100,8,3978
511,6,0,7,18,14238360,3580,32100,8,3984
512,9,0,9,16,14267760,3581,32100,8,3993
513,4,0,5,20,14301060,3582,32100,8,3997
514,8,0,12,13,14305380,3582,32100,8,4005
515,12,0,11,14,14344860,3580,32100,7,4017
516,7,0,5,20,14382240,3578,32100,7,4024
517,6,0,5,20,14416560,3581,32100,7,4030
518,16,0,11,14,14433060,3576,32100,7,4046
519,16,0,15,10,14461980,3573,32100,7,4062
520,13,0,12,13,14507940,3570,32100,7,4075
521,9,0,7,18,14555400,3570,32100,7,4084
522,7,0,6,19,14587560,3571,32100,7,4091
523,9,0,8,17,14614860,3571,32100,7,4100
524,4,0,5,20,14639880,3571,32100,7,4104
525,9,0,5,20,14656800,3567,32100,7,4113
526,7,0,7,18,14682060,3569,32100,7,4120
527,3,0,3,22,14704920,3569,32100,7,4123
528,4,0,3,22,14716740,3568,32100,7,4127
529,7,0,9,16,14719500,3568,32100,7,4134
530,10,0,8,17,14747100,3565,32100,7,4144
531,7,0,5,20,14772840,3563,32100,7,4151
532,6,0,5,20,14792400,3562,32100,7,4157
533,8,0,7,18,14810760,3561,32100,7,4165
534,9,0,6,19,14831520,3558,32100,7,4174
535,9,0,9,16,14862660,3560,32100,7,4183
536,11,0,8,17,14896440,3558,32100,7,4194
537,16,0,17,8,14920200,3558,32100,7,4210
538,14,0,18,7,14968920,3558,32100,7,4224
539,17,4,14,11,15023280,3557,33720,7,4241
540,10,0,14,11,15086640,3560,38100,8,4251
541,10,0,16,9,15124740,3562,38100,8,4261
542,10,0,18,7,15174300,3567,38100,8,4271
543,5,0,6,19,15258060,3573,38100,8,4276
544,9,0,7,18,15291360,3574,38100,8,4285
545,9,0,11,14,15318060,3576,38100,8,4294
546,8,0,7,18,15366480,3577,38100,8,4302
547,5,0,6,19,15387900,3577,38100,8,4307
548,4,0,4,21,15418200,3579,38100,8,4311
549,7,0,9,16,15431340,3581,38100,8,4318
550,6,0,6,19,15461340,3580,38100,8,4324
551,8,0,10,15,15478080,3581,38100,8,4332
552,6,0,8,17,15512100,3582,38100,8,4338
553,7,0,7,18,15547140,3583,38100,8,4345
554,5,0,4,21,15581760,3585,38100,8,4350
555,1,0,4,21,15592320,3586,38100,8,4351
556,4,0,4,21,15617760,3589,38100,8,4355
557,9,0,6,19,15633360,3587,38100,8,4364
558,8,0,10,15,15646140,3586,38100,8,4372
559,3,0,6,19,15689100,3591,38100,8,4375
560,15,0,15,10,15714420,3591,38100,8,4390
561,5,0,12,13,15736500,3590,38100,8,4395
562,11,0,14,11,15778200,3592,38100,8,4406
563,8,0,12,13,15834720,3597,38100,8,4414
564,5,0,10,15,15861240,3597,38100,8,4419
565,10,0,12,13,15900420,3599,38100,8,4429
566,7,0,6,19,15957960,3602,38100,8,4436
567,11,0,8,17,15988320,3601,38100,8,4447
568,8,0,11,14,16003620,3601,38100,8,4455
569,6,0,8,17,16047000,3603,38100,8,4461
570,8,0,9,16,16073460,3603,38100,8,4469
571,10,0,11,14,16099920,3603,38100,8,4479
572,10,0,12,13,16135620,3604,38100,8,4489
573,8,0,10,15,16181280,3606,38100,8,4497
574,8,0,8,17,16222800,3607,38100,8,4505
575,5,0,4,21,16251720,3606,38100,8,4510
576,2,0,3,22,16269060,3608,38100,8,4512
577,8,0,7,18,16280580,3607,38100,8,4520
578,8,0,7,18,16302360,3605,38100,8,4528
579,3,0,5,20,16333320,3608,38100,8,4531
580,10,0,9,16,16357980,3609,38100,8,4541
581,10,0,9,16,16380780,3606,38100,8,4551
582,8,0,10,15,16413180,3608,38100,8,4559
583,7,0,8,17,16450920,3609,38100,8,4566
584,2,0,5,20,16466820,3608,38100,8,4568
585,10,0,8,17,16492800,3608,38100,8,4578
586,7,0,5,20,16530300,3609,38100,8,4585
587,8,0,7,18,16544520,3607,38100,8,4593
588,12,0,13,12,16568160,3608,38100,8,4605
589,8,0,11,14,16607700,3608,38100,8,4613
590,11,0,13,12,16642680,3609,38100,8,4624
591,12,0,18,7,16680240,3612,38100,8,4636
592,6,0,11,14,16732560,3613,38100,8,4642
593,5,0,6,19,16795740,3618,38100,8,4647
594,7,0,8,17,16812660,3618,38100,8,4654
595,8,0,10,15,16831740,3618,38100,8,4662
596,6,0,5,20,16876560,3619,38100,8,4668
597,7,0,6,19,16885500,3616,38100,8,4675
598,4,0,5,20,16908000,3617,38100,8,4679
599,6,0,5,20,16932300,3618,38100,8,4685
600,5,0,6,19,16939500,3616,38100,8,4690
601,5,0,6,19,16956600,3616,38100,8,4695
602,7,0,6,19,16985280,3616,38100,8,4702
603,7,0,7,18,17008620,3617,38100,8,4709
604,6,0,9,16,17015220,3615,38100,8,4715
605,15,0,13,12,17061480,3617,38100,8,4730
606,8,0,10,15,17093400,3615,38100,8,4738
607,7,0,5,20,17141340,3616,38100,8,4745
608,5,0,5,20,17161440,3616,38100,8,4750
609,7,0,8,17,17165040,3614,38100,8,4757
610,13,0,13,12,17208060,3617,38100,7,4770
611,11,0,12,13,17248380,3616,38100,7,4781
612,15,0,17,8,17289420,3617,38100,7,4796
613,6,0,11,14,17356440,3622,38100,7,4802
614,8,0,8,17,17402340,3623,38100,7,4810
615,13,0,12,13,17433120,3623,38100,7,4823
616,4,0,5,20,17463540,3621,38100,7,4827
617,12,0,7,18,17502660,3622,38100,7,4839
618,9,0,10,15,17523960,3622,38100,7,4848
619,6,0,5,20,17562120,3621,38100,7,4854
620,6,0,6,19,17578980,3621,38100,7,4860
621,5,0,5,20,17597460,3620,38100,7,4865
622,6,0,6,19,17619540,3621,38100,7,4871
623,4,0,3,22,17641440,3620,38100,7,4875
624,1,0,3,22,17647380,3621,38100,7,4876
625,3,0,2,23,17665740,3622,38100,7,4879
626,4,0,5,20,17666460,3621,38100,7,4883
627,4,0,6,19,17675760,3621,38100,7,4887
628,5,0,5,20,17696880,3621,38100,7,4892
629,4,0,4,21,17725620,3623,38100,7,4896
630,6,0,5,20,17735460,3621,38100,7,4902
631,18,0,12,13,17759880,3618,38100,7,4920
632,6,0,9,16,17799480,3619,38100,7,4926
633,15,0,12,13,17838780,3619,38100,7,4941
634,10,0,9,16,17887500,3619,38100,7,4951
635,8,0,7,18,17925060,3619,38100,7,4959
636,12,0,9,16,17959500,3619,38100,7,4971
637,11,0,11,14,17980080,3616,38100,7,4982
638,8,0,8,17,18022920,3617,38100,7,4990
639,10,0,15,10,18029700,3616,38100,7,5000
640,9,0,9,16,18097500,3619,38100,7,5009
641,9,0,12,13,18117180,3619,38100,7,5018
642,11,0,11,14,18168480,3620,38100,7,5029
643,5,0,8,17,18193740,3619,38100,7,5034
644,6,0,7,18,18228000,3621,38100,7,5040
645,4,0,5,20,18252240,3622,38100,7,5044
646,4,0,5,20,18261900,3621,38100,7,5048
647,6,0,6,19,18275340,3620,38100,7,5054
648,3,0,5,20,18308220,3623,38100,7,5057
649,8,0,8,17,18323580,3623,38100,7,5065
650,3,0,6,19,18352200,3625,38100,7,5068
651,7,0,4,21,18388440,3626,38100,7,5075
652,3,0,5,20,18391680,3625,38100,7,5078
653,10,0,8,17,18414600,3624,38100,7,5088
654,7,0,11,14,18434400,3625,38100,7,5095
655,7,0,10,15,18469200,3627,38100,7,5102
656,9,0,9,16,18521460,3630,38100,7,5111
657,5,0,4,21,18559560,3630,38100,7,5116
658,5,0,4,21,18576660,3630,38100,7,5121
659,9,0,8,17,18590580,3629,38100,7,5130
660,10,0,10,15,18609900,3627,38100,7,5140
661,7,0,9,16,18641520,3628,38100,7,5147
662,7,0,7,18,18672600,3627,38100,7,5154
663,7,0,9,16,18693720,3628,38100,7,5161
664,13,0,12,13,18727380,3627,38100,7,5174
665,9,0,9,16,18762600,3626,38100,7,5183
666,13,0,13,12,18793200,3625,38100,7,5196
667,7,0,14,11,18826920,3628,38100,7,5203
668,8,0,8,17,18889380,3630,38100,7,5211
669,9,0,10,15,18928920,3633,38100,7,5220
670,4,0,7,18,18953700,3633,38100,7,5224
671,3,0,2,23,18986040,3633,38100,7,5227
672,2,0,2,23,18999120,3634,38100,7,5229
673,12,0,11,14,19005360,3633,38100,7,5241
674,8,0,10,15,19029360,3632,38100,7,5249
675,7,0,10,15,19059660,3633,38100,7,5256
676,6,0,7,18,19091040,3632,38100,7,5262
677,5,0,7,18,19114860,3634,38100,7,5267
678,9,0,7,18,19145880,3633,38100,7,5276
679,7,0,7,18,19167360,3632,38100,7,5283
680,7,0,10,15,19180920,3632,38100,7,5290
681,12,0,14,11,19213020,3633,38100,7,5302
682,9,0,8,17,19260960,3632,38100,7,5311
683,14,0,13,12,19293960,3632,38100,7,5325
684,7,0,12,13,19323240,3632,38100,7,5332
685,18,0,15,10,19368840,3630,38100,7,5350
686,15,0,22,3,19405020,3631,38100,7,5365
687,13,0,16,9,19474920,3632,38100,7,5378
688,10,0,11,14,19544040,3634,38100,7,5388
689,10,0,11,14,19587060,3635,38100,7,5398
690,8,0,12,13,19613340,3636,38100,7,5406
691,4,0,6,19,19664400,3638,38100,7,5410
692,8,0,7,18,19692180,3639,38100,7,5418
693,5,0,5,20,19712040,3638,38100,7,5423
694,7,0,7,18,19727940,3637,38100,7,5430
695,14,0,13,12,19755900,3637,38100,6,5444
696,1,0,5,20,19790880,3638,38100,6,5445
697,4,0,3,22,19819260,3639,38100,6,5449
698,3,0,3,22,19827720,3638,38100,6,5452
699,2,0,5,20,19827720,3638,38100,6,5454
700,4,0,5,20,19833240,3637,38100,6,5458
701,5,0,5,20,19847820,3636,38100,6,5463
702,5,0,7,18,19854360,3635,38100,6,5468
703,4,0,3,22,19887120,3636,38100,6,5472
704,6,0,5,20,19894020,3634,38100,6,5478
705,8,0,7,18,19908120,3633,38100,6,5486
706,8,0,11,14,19916820,3632,38100,6,5494
707,16,0,19,6,19940700,3631,38100,6,5510
708,11,0,17,8,19990560,3632,38100,6,5521
709,9,0,12,13,20066160,3636,38100,6,5530
710,5,0,8,17,20103960,3637,38100,6,5535
711,6,0,4,21,20136360,3636,38100,6,5541
712,15,0,11,14,20156400,3635,38100,6,5556
713,12,0,11,14,20183040,3632,38100,6,5568
714,11,0,13,12,20215860,3632,38100,6,5579
715,9,0,10,15,20260620,3632,38100,6,5588
716,7,0,6,19,20301180,3632,38100,6,5595
717,11,0,13,12,20316480,3632,38100,6,5606
718,8,0,9,16,20358900,3632,38100,6,5614
719,4,0,8,17,20383860,3633,38100,6,5618
720,3,0,4,21,20417700,3634,38100,6,5621
721,5,0,3,22,20437800,3634,38100,6,5626
722,7,0,6,19,20446500,3633,38100,6,5633
723,2,0,3,22,20465580,3633,38100,6,5635
724,4,0,4,21,20478960,3634,38100,6,5639
725,4,0,6,19,20483760,3633,38100,6,5643
726,5,0,2,23,20510460,3632,38100,6,5648
727,8,0,6,19,20517360,3631,38100,6,5656
728,8,0,9,16,20527740,3630,38100,6,5664
729,7,0,14,11,20533980,3629,38100,6,5671
730,9,0,14,11,20581380,3632,38100,6,5680
731,9,0,12,13,20628420,3633,38100,6,5689
732,11,0,8,17,20679900,3633,38100,6,5700
733,10,0,9,16,20702460,3631,38100,6,5710
734,13,0,16,9,20718060,3630,38100,6,5723
735,7,0,9,16,20775000,3631,38100,6,5730
736,14,0,12,13,20804100,3629,38100,6,5744
737,7,0,9,16,20841780,3629,38100,6,5751
738,13,0,11,14,20884440,3630,38100,6,5764
739,6,0,7,18,20913660,3628,38100,6,5770
740,9,0,11,14,20935620,3629,38100,6,5779
741,5,0,5,20,20981940,3630,38100,6,5784
742,6,0,6,19,20990100,3628,38100,6,5790
743,10,0,9,16,21017340,3629,38100,6,5800
744,5,0,5,20,21040980,3627,38100,6,5805
745,4,0,4,21,21064260,3628,38100,6,5809
746,4,0,5,20,21074520,3628,38100,6,5813
747,8,0,9,16,21092880,3629,38100,6,5821
748,6,0,11,14,21102960,3628,38100,6,5827
749,4,0,8,17,21132000,3629,38100,6,5831
750,7,0,6,19,21181320,3631,38100,6,5838
751,3,0,4,21,21208860,3633,38100,6,5841
752,11,0,9,16,21217860,3631,38100,6,5852
753,12,0,14,11,21236280,3630,38100,6,5864
754,7,0,9,16,21282720,3630,38100,6,5871
755,14,0,10,15,21328020,3630,38100,6,5885
756,8,0,8,17,21352920,3628,38100,6,5893
757,11,0,11,14,21369060,3626,38100,6,5904
758,12,0,12,13,21426840,3629,38100,6,5916
759,6,0,8,17,21456300,3628,38100,6,5922
760,13,0,12,13,21481380,3626,38100,6,5935
761,16,0,15,10,21511080,3623,38100,6,5951
762,5,0,9,16,21553980,3624,38100,6,5956
763,11,0,10,15,21601320,3626,38100,6,5967
764,5,0,7,18,21626220,3625,38100,6,5972
765,7,0,6,19,21649800,3624,38100,6,5979
766,4,0,6,19,21657960,3623,38100,6,5983
767,6,0,7,18,21681960,3624,38100,6,5989
768,4,0,6,19,21699060,3624,38100,6,5993
769,10,0,13,12,21711780,3624,38100,6,6003
770,5,0,6,19,21758520,3625,38100,6,6008
771,8,0,9,16,21777660,3625,38100,6,6016
772,3,0,7,18,21795960,3625,38100,6,6019
773,8,0,6,19,21833160,3626,38100,6,6027
774,6,0,8,17,21845100,3625,38100,6,6033
775,6,0,6,19,21866400,3624,38100,6,6039
776,6,0,5,20,21886380,3623,38100,6,6045
777,11,0,9,16,21910560,3623,38100,6,6056
778,5,0,5,20,21937200,3622,38100,6,6061
779,13,0,14,11,21952920,3622,38100,6,6074
780,12,0,10,15,21992700,3619,38100,6,6086
781,10,0,11,14,22022580,3619,38100,6,6096
782,10,0,12,13,22045800,3617,38100,6,6106
783,14,0,13,12,22093860,3617,38100,6,6120
784,10,0,13,12,22131000,3617,38100,6,6130
785,11,0,11,14,22177980,3617,38100,6,6141
786,7,0,8,17,22225860,3619,38100,6,6148
787,5,0,5,20,22259640,3620,38100,6,6153
788,4,0,4,21,22278120,3620,38100,6,6157
789,6,0,7,18,22287420,3620,38100,6,6163
790,6,0,8,17,22311960,3621,38100,6,6169
791,10,0,10,15,22339920,3621,38100,6,6179
792,5,0,9,16,22368780,3622,38100,6,6184
793,4,0,6,19,22397400,3623,38100,6,6188
794,6,0,6,19,22419240,3623,38100,6,6194
795,17,0,14,11,22439220,3620,38100,6,6211
796,10,0,19,6,22459620,3621,39300,6,6221
797,5,0,5,20,22531920,3621,39300,6,6226
798,7,0,6,19,22559400,3622,39300,6,6233
799,13,0,14,11,22582680,3623,39300,6,6246
800,13,0,18,7,22603140,3621,39300,6,6259
801,10,0,17,8,22664640,3625,39300,6,6269
802,11,0,12,13,22734480,3627,39300,6,6280
803,14,0,16,9,22768980,3626,39300,6,6294
804,15,0,22,3,22798260,3626,39300,6,6309
805,7,0,12,13,22888200,3630,39300,6,6316
806,10,0,11,14,22933200,3631,39300,6,6326
807,16,0,14,11,22974060,3630,39300,6,6342
808,9,0,10,15,23026140,3631,39300,6,6351
809,7,0,6,19,23075400,3632,39300,6,6358
810,9,0,10,15,23090400,3632,39300,6,6367
811,4,0,8,17,23122020,3633,39300,6,6371
812,5,0,5,20,23159820,3635,39300,6,6376
813,6,0,5,20,23172780,3633,39300,6,6382
814,4,0,5,20,23184240,3633,39300,6,6386
815,4,0,6,19,23202780,3634,39300,6,6390
816,10,0,10,15,23215800,3633,39300,6,6400
817,5,0,7,18,23241480,3632,39300,6,6405
818,10,0,10,15,23264880,3632,39300,6,6415
819,4,0,7,18,23292120,3632,39300,6,6419
820,10,0,11,14,23317440,3633,39300,6,6429
821,11,0,10,15,23358480,3632,39300,6,6440
822,7,0,11,14,23386380,3633,39300,6,6447
823,12,0,13,12,23424540,3633,39300,6,6459
824,10,0,14,11,23470860,3636,39300,6,6469
825,12,0,13,12,23515800,3635,39300,6,6481
826,6,0,8,17,23558220,3636,39300,6,6487
827,8,0,11,14,23569860,3635,39300,6,6495
828,10,0,11,14,23610960,3635,39300,6,6505
829,10,0,7,18,23653680,3634,39300,6,6515
830,5,0,6,19,23668260,3633,39300,6,6520
831,13,0,15,10,23678340,3632,39300,6,6533
832,10,0,14,11,23717520,3632,39300,6,6543
833,11,0,15,10,23774400,3635,39300,5,6554
834,5,0,9,16,23818200,3636,39300,5,6559
835,4,0,4,21,23860320,3637,39300,5,6563
836,7,0,6,19,23878140,3637,39300,5,6570
837,5,0,6,19,23895420,3637,39300,5,6575
838,8,0,9,16,23913120,3637,39300,5,6583
839,6,0,11,14,23933280,3638,39300,5,6589
840,6,0,7,18,23977560,3639,39300,5,6595
841,2,0,6,19,23984940,3639,39300,5,6597
842,4,0,4,21,24003480,3638,39300,5,6601
843,8,0,8,17,24020160,3638,39300,5,6609
844,6,0,8,17,24041520,3638,39300,5,6615
845,8,0,8,17,24073860,3639,39300,5,6623
846,4,0,9,16,24094200,3640,39300,5,6627
847,5,0,6,19,24128760,3641,39300,5,6632
848,9,0,7,18,24147300,3639,39300,5,6641
849,10,0,9,16,24166260,3638,39300,5,6651
850,7,0,6,19,24197340,3637,39300,5,6658
851,16,0,14,11,24221400,3636,39300,5,6674
852,17,0,18,7,24260460,3635,39300,5,6691
853,16,0,18,7,24326640,3636,39300,5,6707
854,9,0,15,10,24372540,3637,39300,5,6716
855,7,0,9,16,24429420,3638,39300,5,6723
856,5,0,6,19,24465420,3639,39300,5,6728
857,13,0,12,13,24473340,3636,39300,5,6741
858,12,0,19,6,24496200,3637,39300,5,6753
859,4,0,7,18,24579180,3641,39300,5,6757
860,6,0,9,16,24599220,3642,39300,5,6763
861,8,0,9,16,24631020,3642,39300,5,6771
862,5,0,8,17,24656460,3643,39300,5,6776
863,7,0,7,18,24683160,3642,39300,5,6783
864,5,0,8,17,24696720,3642,39300,5,6788
865,4,0,5,20,24724680,3642,39300,5,6792
866,7,0,4,21,24745980,3641,39300,5,6799
867,9,0,9,16,24755160,3641,39300,5,6808
868,5,0,5,20,24776880,3639,39300,5,6813
869,10,0,13,12,24789960,3640,39300,5,6823
870,3,0,4,21,24833580,3640,39300,5,6826
871,11,0,13,12,24841500,3640,39300,5,6837
872,2,0,8,17,24865920,3640,39300,5,6839
873,8,0,9,16,24903180,3641,39300,5,6847
874,7,0,9,16,24937260,3643,39300,5,6854
875,13,0,14,11,24966660,3643,39300,5,6867
876,13,0,13,12,25011060,3642,39300,5,6880
877,8,0,11,14,25043220,3641,39300,5,6888
878,8,0,7,18,25089360,3641,39300,5,6896
879,11,0,11,14,25123500,3643,39300,5,6907
880,6,0,9,16,25151280,3643,39300,5,6913
881,14,0,9,16,25191960,3641,39300,5,6927
882,3,0,6,19,25219620,3642,39300,5,6930
883,7,0,6,19,25251420,3643,39300,5,6937
884,4,0,5,20,25274880,3644,39300,5,6941
885,8,0,8,17,25293420,3644,39300,5,6949
886,3,0,5,20,25306860,3642,39300,5,6952
887,6,0,7,18,25320060,3642,39300,5,6958
888,5,0,4,21,25346760,3642,39300,5,6963
889,10,0,7,18,25361580,3640,39300,5,6973
890,4,0,5,20,25379760,3640,39300,5,6977
891,4,0,6,19,25393740,3640,39300,5,6981
892,6,0,11,14,25400100,3641,39300,5,6987
893,14,0,19,6,25423860,3641,39300,5,7001
894,4,0,7,18,25484220,3641,39300,5,7005
895,6,0,7,18,25522620,3644,39300,5,7011
896,6,0,6,19,25535760,3642,39300,5,7017
897,4,0,5,20,25555920,3642,39300,5,7021
898,13,0,14,11,25566240,3641,39300,5,7034
899,9,0,9,16,25613160,3641,39300,5,7043
900,11,0,13,12,25639620,3641,39300,5,7054
901,14,0,17,8,25682220,3642,39300,5,7068
902,9,0,9,16,25743960,3642,39300,5,7077
903,5,0,8,17,25769220,3642,39300,5,7082
904,14,0,14,11,25795500,3642,39300,5,7096
905,11,0,15,10,25826880,3641,39300,5,7107
906,16,0,17,8,25871520,3640,39300,5,7123
907,7,0,12,13,25917540,3641,39300,5,7130
908,7,0,11,14,25961280,3643,39300,5,7137
909,3,0,5,20,26010060,3645,39300,5,7140
910,3,0,5,20,26016540,3644,39300,5,7143
911,9,0,10,15,26042220,3646,39300,5,7152
912,7,0,9,16,26057880,3644,39300,5,7159
913,5,0,7,18,26094240,3645,39300,5,7164
914,5,0,5,20,26124540,3646,39300,5,7169
915,6,0,7,18,26131860,3645,39300,5,7175
916,5,0,6,19,26155920,3645,39300,5,7180
917,7,0,8,17,26174400,3645,39300,5,7187
918,10,0,9,16,26197020,3644,39300,5,7197
919,2,0,8,17,26206560,3644,39300,5,7199
920,13,0,11,14,26246220,3644,39300,5,7212
921,6,0,9,16,26283300,3645,39300,5,7218
922,8,0,8,17,26316060,3645,39300,5,7226
923,8,0,8,17,26343960,3645,39300,5,7234
924,11,0,13,12,26372160,3646,39300,5,7245
925,10,0,12,13,26421480,3647,39300,5,7255
926,9,0,11,14,26452380,3647,39300,5,7264
927,10,0,10,15,26491260,3646,39300,5,7274
928,6,0,8,17,26522100,3647,39300,5,7280
929,8,0,6,19,26557260,3646,39300,5,7288
930,15,0,16,9,26571840,3646,39300,5,7303
931,11,0,16,9,26612460,3646,39300,5,7314
932,9,0,9,16,26678580,3647,39300,5,7323
933,4,0,5,20,26711760,3648,39300,5,7327
934,4,0,6,19,26718960,3647,39300,5,7331
935,3,0,4,21,26737140,3647,39300,5,7334
936,7,0,9,16,26747160,3648,39300,5,7341
937,6,0,10,15,26763300,3647,39300,5,7347
938,7,0,10,15,26785980,3647,39300,5,7354
939,9,0,11,14,26817840,3647,39300,5,7363
940,8,0,13,12,26836980,3647,39300,5,7371
941,4,0,5,20,26899500,3649,39300,5,7375
942,7,0,10,15,26907420,3649,39300,5,7382
943,5,0,6,19,26943960,3650,39300,5,7387
944,8,0,9,16,26962020,3650,39300,5,7395
945,5,0,5,20,27006300,3651,39300,5,7400
946,7,0,7,18,27023340,3651,39300,5,7407
947,4,0,5,20,27037320,3650,39300,5,7411
948,9,0,9,16,27051660,3650,39300,5,7420
949,8,0,9,16,27078300,3649,39300,5,7428
950,12,0,11,14,27104640,3648,39300,5,7440
951,7,0,7,18,27141960,3648,39300,5,7447
952,12,0,11,14,27162600,3646,39300,5,7459
953,16,0,13,12,27207840,3646,39300,5,7475
954,7,0,7,18,27244740,3644,39300,5,7482
955,5,0,4,21,27284040,3646,39300,5,7487
956,8,0,9,16,27293280,3645,39300,5,7495
957,5,0,11,14,27304440,3645,39300,5,7500
958,4,0,7,18,27349200,3648,39300,5,7504
959,5,0,9,16,27357780,3647,39300,5,7509
960,7,0,11,14,27376680,3647,39300,5,7516
961,4,0,7,18,27430320,3651,39300,5,7520
962,6,0,6,19,27452400,3650,39300,5,7526
963,6,0,5,20,27476100,3650,39300,5,7532
964,5,0,7,18,27484800,3650,39300,5,7537
965,7,0,11,14,27495780,3650,39300,5,7544
966,6,0,3,22,27541620,3649,39300,5,7550
967,8,0,7,18,27547920,3648,39300,5,7558
968,11,0,11,14,27575340,3648,39300,5,7569
969,3,0,4,21,27607320,3647,39300,5,7572
970,11,0,7,18,27627480,3646,39300,5,7583
971,9,0,10,15,27640800,3645,39300,5,7592
972,9,0,9,16,27673440,3645,39300,5,7601
973,8,0,7,18,27708360,3644,39300,5,7609
974,9,0,11,14,27726720,3644,39300,5,7618
975,7,0,11,14,27763500,3646,39300,5,7625
976,15,0,17,8,27801060,3646,39300,5,7640
977,12,0,19,6,27832980,3646,39300,5,7652
978,6,0,8,17,27903180,3647,39300,5,7658
979,10,0,14,11,27909780,3646,39300,5,7668
980,5,0,8,17,27986040,3651,39300,5,7673
981,11,0,10,15,28015020,3650,39300,5,7684
982,6,0,8,17,28033440,3649,39300,5,7690
983,5,0,5,20,28069320,3650,39300,5,7695
984,7,0,9,16,28081320,3650,39300,5,7702
985,4,0,7,18,28098300,3649,39300,5,7706
986,6,0,5,20,28135620,3650,39300,5,7712
987,7,0,9,16,28138980,3649,39300,5,7719
988,2,0,4,21,28162200,3649,39300,5,7721
989,4,0,6,19,28170240,3649,39300,5,7725
990,9,0,10,15,28191000,3649,39300,5,7734
991,9,0,12,13,28212660,3649,39300,5,7743
992,9,0,10,15,28244760,3648,39300,5,7752
993,6,0,9,16,28272300,3648,39300,5,7758
994,8,0,13,12,28293000,3649,39300,5,7766
995,11,0,12,13,28335060,3649,39300,5,7777
996,12,0,8,17,28389060,3648,39300,5,7789
997,10,0,10,15,28417200,3648,39300,5,7799
998,14,0,18,7,28443060,3648,39300,5,7813
999,8,0,11,14,28488660,3647,39300,5,7821
1000,8,0,5,20,28536600,3647,39300,5,7829
1001,6,0,9,16,28549560,3648,39300,5,7835
1002,7,0,9,16,28563420,3646,39300,5,7842
1003,6,0,8,17,28605540,3648,39300,5,7848
1004,8,0,8,17,28628700,3647,39300,5,7856
1005,5,0,9,16,28649640,3648,39300,4,7861
1006,8,0,10,15,28675860,3648,39300,4,7869
1007,5,0,6,19,28719180,3650,39300,4,7874
1008,4,0,7,18,28724160,3649,39300,4,7878
1009,12,0,12,13,28753200,3649,39300,4,7890
1010,9,0,10,15,28796160,3650,39300,4,7899
1011,7,0,9,16,28821780,3649,39300,4,7906
1012,4,0,7,18,28850700,3650,39300,4,7910
1013,4,0,7,18,28869540,3651,39300,4,7914
1014,11,0,9,16,28912260,3652,39300,4,7925
1015,4,0,7,18,28924500,3651,39300,4,7929
1016,7,0,9,16,28943220,3651,39300,4,7936
1017,7,0,8,17,28970400,3650,39300,4,7943
1018,11,0,10,15,28994340,3649,39300,4,7954
1019,8,0,8,17,29032440,3650,39300,4,7962
1020,8,0,9,16,29065440,3650,39300,4,7970
1021,12,0,13,12,29085240,3649,39300,4,7982
1022,12,0,10,15,29136000,3649,39300,4,7994
1023,10,0,10,15,29160180,3647,39300,4,8004
1024,6,0,8,17,29202000,3649,39300,4,8010
1025,8,0,8,17,29234760,3649,39300,4,8018
1026,10,0,8,17,29253660,3647,39300,4,8028
1027,4,0,6,19,29283540,3648,39300,4,8032
1028,5,0,6,19,29304660,3648,39300,4,8037
1029,4,0,8,17,29317020,3649,39300,4,8041
1030,6,0,7,18,29350680,3650,39300,4,8047
1031,6,0,7,18,29372280,3650,39300,4,8053
1032,4,0,8,17,29388900,3651,39300,4,8057
1033,8,0,7,18,29419380,3650,39300,4,8065
1034,7,0,8,17,29439540,3650,39300,4,8072
1035,5,0,7,18,29465520,3651,39300,4,8077
1036,5,0,5,20,29483040,3650,39300,4,8082
1037,10,0,9,16,29504280,3650,39300,4,8092
1038,10,0,13,12,29528580,3650,39300,4,8102
1039,7,0,12,13,29561280,3650,39300,4,8109
1040,6,0,8,17,29602620,3651,39300,4,8115
1041,9,0,10,15,29627760,3651,39300,4,8124
1042,8,0,10,15,29659740,3651,39300,4,8132
1043,10,0,13,12,29681640,3651,39300,4,8142
1044,7,0,8,17,29729160,3651,39300,4,8149
1045,8,0,10,15,29753160,3652,39300,4,8157
1046,5,0,9,16,29784900,3653,39300,4,8162
1047,16,0,13,12,29817900,3651,39300,4,8178
1048,6,0,10,15,29845320,3651,39300,4,8184
1049,10,0,8,17,29887920,3651,39300,4,8194
1050,7,0,8,17,29905800,3650,39300,4,8201
1051,10,0,12,13,29934240,3650,39300,4,8211
1052,6,0,9,16,29964840,3650,39300,4,8217
1053,7,0,10,15,29988060,3650,39300,4,8224
1054,3,0,3,22,30027480,3651,39300,4,8227
1055,3,0,5,20,30036540,3651,39300,4,8230
1056,8,0,7,18,30052860,3651,39300,4,8238
1057,8,0,9,16,30072120,3650,39300,4,8246
1058,5,0,5,20,30095940,3649,39300,4,8251
1059,6,0,4,21,30113520,3648,39300,4,8257
1060,6,0,6,19,30119700,3647,39300,4,8263
1061,5,0,9,16,30132120,3648,39300,4,8268
1062,6,0,9,16,30149820,3647,39300,4,8274
1063,2,0,4,21,30188220,3649,39300,4,8276
1064,13,0,12,13,30205740,3649,39300,4,8289
1065,8,0,12,13,30226980,3648,39300,4,8297
1066,9,0,8,17,30270720,3647,39300,4,8306
1067,10,0,8,17,30297600,3646,39300,4,8316
1068,13,0,11,14,30334200,3646,39300,4,8329
1069,7,0,8,17,30371760,3646,39300,4,8336
1070,8,0,9,16,30399120,3647,39300,4,8344
1071,10,0,13,12,30421740,3647,39300,4,8354
1072,9,0,14,11,30456480,3647,39300,4,8363
1073,16,0,18,7,30510180,3649,39300,4,8379
1074,9,0,12,13,30557340,3648,39300,4,8388
1075,5,0,8,17,30604080,3649,39300,4,8393
1076,12,0,11,14,30631440,3649,39300,4,8405
1077,16,0,18,7,30659820,3648,39300,4,8421
1078,2,0,7,18,30704280,3648,39300,4,8423
1079,6,0,5,20,30748680,3650,39300,4,8429
1080,8,0,7,18,30765300,3649,39300,4,8437
1081,4,0,4,21,30783180,3648,39300,4,8441
1082,3,0,3,22,30801780,3649,39300,4,8444
1083,4,0,6,19,30804000,3648,39300,4,8448
1084,4,0,5,20,30818400,3648,39300,4,8452
1085,5,0,5,20,30835380,3648,39300,4,8457
1086,6,0,5,20,30849060,3647,39300,4,8463
1087,6,0,8,17,30853740,3646,39300,4,8469
1088,7,0,9,16,30878880,3646,39300,4,8476
1089,7,0,7,18,30909960,3646,39300,4,8483
1090,9,0,10,15,30934200,3647,39300,4,8492
1091,12,0,13,12,30966480,3646,39300,4,8504
1092,10,0,13,12,31002420,3646,39300,4,8514
1093,12,0,12,13,31046760,3646,39300,4,8526
1094,8,0,13,12,31067700,3646,39300,4,8534
1095,10,0,14,11,31104540,3646,39300,4,8544
1096,6,0,10,15,31158480,3648,39300,4,8550
1097,14,0,14,11,31193280,3648,39300,4,8564
1098,7,0,10,15,31241760,3649,39300,4,8571
1099,12,0,14,11,31274220,3649,39300,4,8583
1100,6,0,9,16,31320840,3650,39300,4,8589
1101,5,0,4,21,31360200,3650,39300,4,8594
1102,3,0,4,21,31375920,3651,39300,4,8597
1103,4,0,4,21,31385400,3650,39300,4,8601
1104,4,0,5,20,31392420,3650,39300,4,8605
1105,3,0,5,20,31405200,3650,39300,4,8608
1106,7,0,9,16,31418460,3650,39300,4,8615
1107,3,0,5,20,31450500,3651,39300,4,8618
1108,5,0,5,20,31465680,3651,39300,4,8623
1109,7,0,7,18,31474860,3650,39300,4,8630
1110,6,0,9,16,31491360,3650,39300,4,8636
1111,8,0,12,13,31508460,3650,39300,4,8644
1112,7,0,9,16,31541640,3649,39300,4,8651
1113,11,0,11,14,31571820,3649,39300,4,8662
1114,13,0,15,10,31599720,3648,39300,4,8675
1115,10,0,11,14,31645860,3648,39300,4,8685
1116,8,0,10,15,31676160,3648,39300,4,8693
1117,8,0,11,14,31707660,3648,39300,4,8701
1118,7,0,9,16,31746660,3649,39300,4,8708
1119,9,0,10,15,31775460,3649,39300,4,8717
1120,4,0,4,21,31822080,3650,39300,4,8721
1121,12,0,12,13,31833600,3650,39300,4,8733
1122,7,0,13,12,31854420,3650,39300,4,8740
1123,5,0,6,19,31898940,3650,39300,4,8745
1124,7,0,6,19,31921620,3649,39300,4,8752
1125,6,0,8,17,31944180,3650,39300,4,8758
1126,10,0,9,16,31967520,3649,39300,4,8768
1127,3,0,6,19,31999020,3650,39300,4,8771
1128,6,0,6,19,32013540,3649,39300,4,8777
1129,4,0,5,20,32034120,3650,39300,4,8781
1130,3,0,4,21,32053680,3650,39300,4,8784
1131,16,0,14,11,32069220,3650,39300,4,8800
1132,9,0,12,13,32103840,3649,39300,4,8809
1133,7,0,10,15,32144220,3650,39300,4,8816
1134,3,0,3,22,32182080,3650,39300,4,8819
1135,6,0,7,18,32189820,3650,39300,4,8825
1136,7,0,10,15,32205420,3650,39300,4,8832
1137,14,0,15,10,32232060,3649,39300,4,8846
1138,9,0,7,18,32283600,3648,39300,4,8855
1139,12,0,9,16,32315760,3648,39300,4,8867
1140,6,0,6,19,32346780,3647,39300,4,8873
1141,9,0,10,15,32353800,3646,39300,4,8882
1142,9,0,9,16,32385240,3646,39300,4,8891
1143,10,0,10,15,32411940,3645,39300,4,8901
1144,7,0,6,19,32447760,3644,39300,4,8908
1145,16,0,13,12,32466780,3643,39300,4,8924
1146,9,0,11,14,32507640,3643,39300,4,8933
1147,6,0,11,14,32530620,3643,39300,4,8939
1148,6,0,6,19,32574900,3644,39300,4,8945
1149,8,0,7,18,32595660,3643,39300,4,8953
1150,4,0,6,19,32611800,3643,39300,4,8957
1151,10,0,7,18,32631600,3641,39300,4,8967
1152,8,0,7,18,32668200,3642,39300,4,8975
1153,7,0,11,14,32676780,3642,39300,4,8982
1154,3,0,4,21,32717580,3642,39300,4,8985
1155,6,0,5,20,32730540,3642,39300,4,8991
1156,6,0,7,18,32744880,3642,39300,4,8997
1157,4,0,6,19,32770320,3643,39300,4,9001
1158,5,0,7,18,32781900,3642,39300,4,9006
1159,12,0,9,16,32818740,3642,39300,4,9018
1160,8,0,10,15,32837940,3642,39300,4,9026
1161,5,0,7,18,32868480,3642,39300,4,9031
1162,5,0,6,19,32893560,3642,39300,4,9036
1163,15,0,12,13,32920260,3642,39300,4,9051
1164,10,0,11,14,32949900,3640,39300,4,9061
1165,2,0,3,22,32986800,3640,39300,4,9063
1166,8,0,6,19,33005520,3640,39300,4,9071
1167,10,0,11,14,33013260,3639,39300,4,9081
1168,10,0,12,13,33053520,3640,39300,4,9091
1169,10,0,11,14,33085980,3639,39300,4,9101
1170,10,0,14,11,33121200,3640,39300,4,9111
1171,12,0,15,10,33165120,3641,39300,4,9123
1172,7,0,10,15,33202080,3640,39300,4,9130
1173,5,0,4,21,33245940,3640,39300,4,9135
1174,6,0,8,17,33248340,3640,39300,4,9141
1175,6,0,3,22,33276240,3639,39300,4,9147
1176,5,0,6,19,33283620,3639,39300,4,9152
1177,7,0,9,16,33296220,3638,39300,4,9159
1178,2,0,5,20,33317220,3638,39300,4,9161
1179,7,0,9,16,33336840,3639,39300,4,9168
1180,5,0,9,16,33353940,3639,39300,4,9173
1181,5,0,5,20,33386820,3639,39300,4,9178
1182,5,0,5,20,33405660,3639,39300,4,9183
1183,10,0,11,14,33417540,3639,39300,4,9193
1184,8,0,16,9,33426480,3639,39300,4,9201
1185,13,0,15,10,33488700,3640,39300,4,9214
1186,10,0,15,10,33548340,3642,39540,4,9224
1187,17,7,14,11,33593340,3643,42120,4,9241
1188,6,0,16,9,33647340,3645,62160,6,9247
1189,12,0,9,16,33717540,3645,62160,6,9259
1190,18,0,16,9,33748620,3644,62160,6,9277
1191,12,0,14,11,33786240,3642,62160,6,9289
1192,10,0,14,11,33826860,3643,62160,6,9299
1193,5,0,8,17,33869040,3643,62160,6,9304
1194,8,0,10,15,33892440,3643,62160,6,9312
1195,11,0,9,16,33937560,3643,62160,6,9323
1196,5,0,7,18,33963660,3643,62160,6,9328
1197,10,0,10,15,33993240,3644,62160,6,9338
1198,5,0,10,15,34023660,3645,62160,6,9343
1199,6,0,5,20,34062900,3645,62160,6,9349
1200,1,0,5,20,34073040,3646,62160,6,9350
1201,7,0,6,19,34095780,3646,62160,6,9357
1202,5,0,4,21,34115160,3645,62160,6,9362
1203,9,0,7,18,34133760,3645,62160,6,9371
1204,5,0,8,17,34146060,3644,62160,6,9376
1205,4,0,7,18,34162320,3644,62160,6,9380
1206,6,0,5,20,34198200,3645,62160,6,9386
1207,6,0,5,20,34216140,3645,62160,6,9392
1208,11,0,11,14,34230240,3644,62160,6,9403
1209,11,0,13,12,34259520,3644,62160,6,9414
1210,11,0,9,16,34315200,3644,62160,6,9425
1211,7,0,8,17,34353780,3645,62160,6,9432
1212,7,0,8,17,34380780,3645,62160,6,9439
1213,11,0,14,11,34393200,3644,62160,6,9450
1214,10,0,12,13,34450260,3646,62160,6,9460
1215,9,0,10,15,34481640,3645,62160,6,9469
1216,9,0,12,13,34514040,3646,62160,6,9478
1217,11,0,15,10,34547100,3646,62160,6,9489
1218,3,0,6,19,34597740,3647,62160,6,9492
1219,10,0,8,17,34622700,3646,62160,6,9502
1220,7,0,10,15,34643520,3647,62160,6,9509
1221,11,0,8,17,34674180,3645,62160,6,9520
1222,5,0,6,19,34701540,3645,62160,6,9525
1223,8,0,7,18,34726200,3645,62160,6,9533
1224,3,0,3,22,34747440,3644,62160,6,9536
1225,6,0,6,19,34749960,3644,62160,6,9542
1226,2,0,4,21,34766580,3644,62160,6,9544
1227,7,0,5,20,34780200,3643,62160,6,9551
1228,7,0,7,18,34794000,3642,62160,6,9558
1229,4,0,4,21,34814160,3642,62160,6,9562
1230,5,0,6,19,34828080,3642,62160,6,9567
1231,9,0,9,16,34848540,3642,62160,6,9576
1232,7,0,10,15,34870860,3642,62160,6,9583
1233,4,0,5,20,34909080,3643,62160,6,9587
1234,10,0,9,16,34929240,3643,62160,6,9597
1235,14,0,15,10,34952940,3642,62160,6,9611
1236,11,0,16,9,34997160,3643,62160,6,9622
1237,6,0,9,16,35047860,3643,62160,6,9628
1238,15,0,17,8,35077980,3644,62160,6,9643
1239,8,0,10,15,35136600,3644,62160,6,9651
1240,8,0,8,17,35168520,3644,62160,6,9659
1241,11,0,14,11,35189280,3644,62160,6,9670
1242,10,0,11,14,35231160,3643,62160,6,9680
1243,8,0,9,16,35265660,3643,62160,6,9688
1244,6,0,10,15,35292840,3644,62160,6,9694
1245,5,0,6,19,35341320,3646,62160,6,9699
1246,5,0,7,18,35356920,3646,62160,6,9704
1247,5,0,10,15,35363100,3646,62160,6,9709
1248,5,0,5,20,35412360,3647,62160,6,9714
1249,7,0,8,17,35426460,3647,62160,6,9721
1250,5,0,8,17,35446380,3647,62160,6,9726
1251,6,0,9,16,35469600,3648,62160,6,9732
1252,8,0,9,16,35503560,3648,62160,6,9740
1253,6,0,11,14,35524860,3649,62160,6,9746
1254,6,0,5,20,35565000,3648,62160,6,9752
1255,7,0,8,17,35578020,3648,62160,6,9759
1256,11,0,14,11,35598360,3648,62160,6,9770
1257,11,0,13,12,35630820,3647,62160,6,9781
1258,5,0,10,15,35670180,3648,62160,6,9786
1259,9,0,12,13,35692320,3648,62160,6,9795
1260,12,0,9,16,35744760,3648,62160,6,9807
1261,5,0,8,17,35768100,3648,62160,6,9812
1262,7,0,10,15,35785980,3648,62160,6,9819
1263,6,0,7,18,35815800,3647,62160,6,9825
1264,9,0,9,16,35845020,3648,62160,6,9834
1265,5,0,3,22,35866380,3646,62160,6,9839
1266,7,0,8,17,35874480,3646,62160,6,9846
1267,5,0,5,20,35899860,3646,62160,6,9851
1268,4,0,4,21,35917440,3646,62160,6,9855
1269,8,0,12,13,35917440,3646,62160,6,9863
1270,5,0,8,17,35953800,3646,62160,6,9868
1271,6,0,7,18,35976840,3646,62160,6,9874
1272,1,0,4,21,35992980,3646,62160,6,9875
1273,2,0,2,23,36017280,3647,62160,6,9877
1274,3,0,3,22,36019560,3646,62160,6,9880
1275,3,0,3,22,36030300,3646,62160,6,9883
1276,6,0,7,18,36038940,3646,62160,6,9889
1277,6,0,9,16,36051360,3646,62160,6,9895
1278,5,0,9,16,36067620,3646,62160,6,9900
1279,10,0,10,15,36109800,3647,62160,6,9910
1280,13,0,17,8,36126720,3646,62160,6,9923
1281,10,0,10,15,36186300,3646,62160,6,9933
1282,7,0,8,17,36223440,3647,62160,6,9940
1283,9,0,9,16,36251580,3647,62160,6,9949
1284,6,0,10,15,36272880,3647,62160,6,9955
1285,17,0,16,9,36298980,3645,62160,6,9972
1286,7,0,9,16,36356640,3646,62160,6,9979
1287,11,0,10,15,36383340,3645,62160,6,9990
1288,8,0,8,17,36412920,3644,62160,6,9998
1289,14,0,13,12,36450480,3645,62160,6,10012
1290,10,0,11,14,36479640,3643,62160,6,10022
1291,6,0,9,16,36505560,3643,62160,6,10028
1292,11,0,12,13,36554340,3645,62160,6,10039
1293,12,0,13,12,36587220,3644,62160,6,10051
1294,2,0,3,22,36631620,3644,62160,6,10053
1295,2,0,3,22,36641160,3645,62160,6,10055
1296,7,0,6,19,36647580,3644,62160,6,10062
1297,5,0,8,17,36666720,3645,62160,6,10067
1298,4,0,8,17,36683100,3645,62160,6,10071
1299,5,0,8,17,36699240,3645,62160,6,10076
1300,7,0,6,19,36736500,3645,62160,6,10083
1301,6,0,6,19,36760620,3645,62160,6,10089
1302,5,0,4,21,36787020,3645,62160,6,10094
1303,13,0,13,12,36792120,3644,62160,6,10107
1304,8,0,13,12,36812460,3644,62160,6,10115
1305,10,0,12,13,36846540,3643,62160,6,10125
1306,15,0,14,11,36895440,3643,62160,6,10140
1307,12,0,14,11,36926700,3642,62160,6,10152
1308,8,0,10,15,36987780,3644,62160,6,10160
1309,8,0,10,15,37009320,3643,62160,6,10168
1310,7,0,9,16,37045020,3644,62160,6,10175
1311,13,0,15,10,37059180,3642,62160,6,10188
1312,12,0,13,12,37100400,3641,62160,6,10200
1313,8,0,9,16,37139880,3641,62160,6,10208
1314,5,0,4,21,37184700,3642,62160,6,10213
1315,3,0,3,22,37203000,3642,62160,6,10216
1316,5,0,5,20,37209720,3642,62160,6,10221
1317,6,0,7,18,37221120,3641,62160,6,10227
1318,5,0,7,18,37241400,3642,62160,6,10232
1319,5,0,7,18,37259760,3642,62160,6,10237
1320,8,0,10,15,37284240,3642,62160,6,10245
1321,6,0,8,17,37311000,3642,62160,6,10251
1322,3,0,6,19,37341600,3643,62160,6,10254
1323,6,0,7,18,37361220,3643,62160,6,10260
1324,4,0,5,20,37378860,3643,62160,6,10264
1325,7,0,10,15,37388160,3643,62160,6,10271
1326,14,0,12,13,37426080,3643,62160,6,10285
1327,7,0,9,16,37450260,3641,62160,6,10292
1328,4,0,7,18,37479480,3642,62160,6,10296
1329,6,0,6,19,37508880,3643,62160,6,10302
1330,6,0,7,18,37521360,3642,62160,6,10308
1331,11,0,7,18,37555560,3641,62160,6,10319
1332,9,0,12,13,37574100,3642,62160,6,10328
1333,7,0,13,12,37596840,3642,62160,6,10335
1334,7,0,12,13,37626240,3642,62160,6,10342
1335,10,0,9,16,37674780,3642,62160,6,10352
1336,3,0,5,20,37701780,3642,62160,6,10355
1337,4,0,7,18,37714740,3643,62160,6,10359
1338,8,0,7,18,37734960,3642,62160,5,10367
1339,7,0,7,18,37759500,3642,62160,5,10374
1340,6,0,7,18,37776540,3641,62160,5,10380
1341,5,0,6,19,37809360,3642,62160,5,10385
1342,6,0,4,21,37829160,3641,62160,5,10391
1343,10,0,7,18,37842840,3640,62160,5,10401
1344,10,0,9,16,37864980,3640,62160,5,10411
1345,5,0,11,14,37873200,3639,62160,5,10416
1346,3,0,11,14,37886400,3640,62160,5,10419
1347,7,0,12,13,37897080,3639,62160,5,10426
1348,5,0,12,13,37909500,3638,62160,5,10431
1349,9,0,17,8,37924500,3638,62160,5,10440
1350,5,0,14,11,37945860,3637,62160,5,10445
1351,6,0,14,11,37972860,3638,62160,5,10451
1352,11,0,20,5,37986780,3637,62160,5,10462
1353,10,0,20,5,38022060,3637,62160,5,10472
1354,3,0,16,9,38045580,3637,62160,5,10475
1355,8,0,20,5,38072520,3638,62160,5,10483
1356,6,0,14,11,38130600,3640,62160,5,10489
1357,9,0,16,9,38169360,3641,62160,5,10498
1358,10,0,19,6,38185620,3640,62160,5,10508
1359,11,0,21,4,38218980,3640,62160,5,10519
1360,13,0,24,1,38257140,3640,64260,6,10532
1361,9,0,17,8,38326140,3641,64260,6,10541
1362,10,0,19,6,38357760,3642,64260,6,10551
1363,5,0,18,7,38385540,3642,64260,6,10556
1364,9,0,12,13,38449920,3643,64260,6,10565
1365,4,0,13,12,38460780,3643,64260,6,10569
1366,5,0,15,10,38480340,3644,64260,6,10574
1367,9,0,19,6,38500380,3644,64260,6,10583
1368,3,0,15,10,38539320,3645,64260,6,10586
1369,8,0,18,7,38561820,3646,64260,6,10594
1370,7,0,15,10,38617740,3648,64260,6,10601
1371,4,0,12,13,38646960,3648,64260,6,10605
1372,3,0,12,13,38663460,3648,64260,6,10608
1373,4,0,13,12,38672280,3648,64260,6,10612
1374,12,0,18,7,38693280,3648,64260,6,10624
1375,9,0,18,7,38723460,3647,64260,6,10633
1376,10,0,21,4,38756580,3648,64260,6,10643
1377,9,0,17,8,38791320,3647,64260,6,10652
1378,10,0,20,5,38826840,3648,64260,6,10662
1379,12,0,20,5,38855220,3647,64260,6,10674
1380,13,0,24,1,38893560,3647,64260,6,10687
1381,10,0,21,4,38936040,3647,64260,6,10697
1382,13,0,24,1,38978880,3647,64260,6,10710
1383,13,0,20,5,39026700,3646,65820,6,10723
1384,9,0,17,8,39082320,3647,65820,6,10732
1385,10,0,20,5,39109680,3647,65820,6,10742
1386,9,0,18,7,39147900,3647,65820,6,10751
1387,9,0,16,9,39195900,3648,65820,6,10760
1388,5,0,11,14,39224400,3647,65820,6,10765
1389,10,0,18,7,39226920,3646,65820,6,10775
1390,5,0,11,14,39275460,3647,65820,6,10780
1391,9,0,15,10,39282660,3646,65820,6,10789
1392,4,0,14,11,39294900,3645,65820,6,10793
1393,7,0,14,11,39339900,3647,65820,6,10800
1394,4,0,14,11,39353160,3647,65820,6,10804
1395,5,0,14,11,39381660,3648,65820,6,10809
1396,14,0,19,6,39408480,3647,65820,6,10823
1397,5,0,14,11,39442380,3647,65820,6,10828
1398,7,0,14,11,39455340,3646,65820,6,10835
1399,8,0,12,13,39492060,3646,65820,6,10843
1400,6,0,11,14,39509580,3645,65820,6,10849
1401,4,0,14,11,39511080,3645,65820,6,10853
1402,9,0,14,11,39536100,3644,65820,6,10862
1403,3,0,14,11,39553740,3645,65820,6,10865
1404,10,0,14,11,39589920,3645,65820,6,10875
1405,7,0,11,14,39611640,3643,65820,6,10882
1406,15,0,18,7,39623580,3642,65820,6,10897
1407,11,0,19,6,39650580,3641,65820,6,10908
1408,9,0,16,9,39695100,3641,65880,6,10917
1409,8,0,18,7,39726780,3642,65880,6,10925
1410,10,0,18,7,39767520,3642,65880,6,10935
1411,6,0,14,11,39806760,3642,65880,6,10941
1412,4,0,14,11,39824040,3643,65880,6,10945
1413,4,0,11,14,39852300,3643,65880,6,10949
1414,2,0,10,15,39863460,3643,65880,6,10951
1415,4,0,10,15,39871320,3642,65880,6,10955
1416,6,0,13,12,39876840,3642,65880,6,10961
1417,8,0,17,8,39890160,3642,65880,6,10969
1418,11,0,22,3,39905880,3641,65880,6,10980
1419,9,0,21,4,39945960,3642,65880,5,10989
1420,6,0,16,9,40007520,3644,65880,5,10995
1421,7,0,16,9,40039140,3644,65880,5,11002
1422,5,0,12,13,40075920,3644,65880,5,11007
1423,8,0,18,7,40080240,3644,65880,5,11015
1424,7,0,13,12,40116360,3643,65880,5,11022
1425,9,0,13,12,40147740,3643,65880,5,11031
1426,9,0,15,10,40168260,3643,65880,5,11040
1427,7,0,16,9,40182960,3642,65880,5,11047
1428,15,0,19,6,40226040,3642,65880,5,11062
1429,7,0,18,7,40255440,3642,65880,5,11069
1430,9,0,15,10,40301820,3642,65880,5,11078
1431,12,0,17,8,40326060,3641,65880,5,11090
1432,7,0,15,10,40362000,3642,65880,5,11097
1433,10,0,17,8,40387680,3641,65880,5,11107
1434,8,0,17,8,40418340,3641,65880,5,11115
1435,4,0,13,12,40453800,3642,65880,5,11119
1436,13,0,18,7,40478760,3642,65880,5,11132
1437,12,0,21,4,40506300,3641,65880,5,11144
1438,3,0,11,14,40554300,3641,65880,5,11147
1439,4,0,11,14,40574400,3642,65880,5,11151
1440,3,0,10,15,40590000,3642,65880,5,11154
1441,8,0,14,11,40602180,3642,65880,5,11162
1442,5,0,16,9,40609740,3641,65880,5,11167
1443,7,0,15,10,40642620,3642,65880,5,11174
1444,6,0,16,9,40659120,3641,65880,5,11180
1445,5,0,14,11,40690080,3642,65880,5,11185
1446,4,0,15,10,40706400,3642,65880,5,11189
1447,7,0,15,10,40737240,3643,65880,5,11196
1448,19,13,20,5,40740000,3643,65940,5,11215
1449,6,15,15,10,40794180,3645,77700,6,11221
1450,13,17,23,2,40815420,3646,107880,9,11234
1451,4,16,21,4,40859700,3647,122760,10,11238
1452,16,14,25,0,40930860,3649,201240,17,11254
1453,12,12,25,0,40973520,3648,245880,21,11266
1454,8,0,13,12,41054100,3645,380580,33,11274
1455,3,0,13,12,41072100,3646,380580,33,11277
1456,13,0,16,9,41089140,3644,380580,33,11290
1457,6,0,16,9,41117220,3645,380580,33,11296
1458,11,0,19,6,41139900,3644,380580,33,11307
1459,6,0,16,9,41176200,3644,380580,33,11313
1460,6,0,15,10,41211660,3645,380580,33,11319
1461,5,0,13,12,41250900,3646,380580,33,11324
1462,10,0,17,8,41261760,3645,380580,33,11334
1463,3,0,15,10,41280300,3646,380580,33,11337
1464,6,0,14,11,41322120,3647,380580,33,11343
1465,3,0,13,12,41338860,3647,380580,33,11346
1466,3,0,11,14,41369220,3648,380580,33,11349
1467,2,0,11,14,41375760,3648,380580,33,11351
1468,7,0,15,10,41388360,3648,380580,33,11358
1469,6,0,14,11,41408400,3648,380580,33,11364
1470,3,0,13,12,41424000,3648,380580,33,11367
1471,9,0,14,11,41450340,3648,380580,33,11376
1472,13,0,24,1,41458080,3647,380580,33,11389
1473,6,0,16,9,41519880,3648,380580,33,11395
1474,9,0,13,12,41572860,3649,380580,33,11404
1475,12,0,19,6,41594160,3649,380580,33,11416
1476,6,0,15,10,41621280,3648,380580,33,11422
1477,11,0,13,12,41652540,3647,380580,33,11433
1478,12,0,16,9,41679480,3646,380580,33,11445
1479,11,0,21,4,41694240,3646,380580,33,11456
1480,9,0,17,8,41740740,3646,380580,33,11465
1481,15,0,17,8,41787600,3645,380580,33,11480
1482,7,0,21,4,41800320,3645,380580,33,11487
1483,10,0,21,4,41839500,3645,380580,33,11497
1484,9,0,18,7,41895840,3646,380580,33,11506
1485,7,0,13,12,41937840,3646,380580,33,11513
1486,6,0,14,11,41972220,3648,380580,33,11519
1487,8,0,16,9,41995980,3648,380580,33,11527
1488,8,0,14,11,42021900,3647,380580,32,11535
1489,6,0,15,10,42050340,3648,380580,32,11541
1490,3,0,13,12,42067440,3648,380580,32,11544
1491,1,0,9,16,42098340,3649,380580,32,11545
1492,5,0,14,11,42098340,3649,380580,32,11550
1493,2,0,14,11,42099900,3648,380580,32,11552
1494,9,0,17,8,42128940,3649,380580,32,11561
1495,9,0,19,6,42147360,3648,380580,32,11570
1496,7,0,17,8,42197940,3650,380580,32,11577
1497,9,0,16,9,42235800,3650,380580,32,11586
1498,8,0,14,11,42262800,3649,380580,32,11594
1499,7,0,10,15,42292080,3648,380580,32,11601
1500,8,0,17,8,42295020,3648,380580,32,11609
1501,11,0,20,5,42316920,3648,380580,32,11620
1502,9,0,20,5,42348660,3647,380580,32,11629
1503,12,0,17,8,42391800,3646,380580,32,11641
1504,11,0,20,5,42416280,3646,380580,32,11652
1505,9,0,18,7,42464880,3647,380580,32,11661
1506,8,0,15,10,42498060,3646,380580,32,11669
1507,17,2,25,0,42514260,3646,381000,32,11686
1508,5,0,20,5,42571320,3647,382080,32,11691
1509,6,0,14,11,42628620,3648,382080,32,11697
1510,3,0,12,13,42651300,3649,382080,32,11700
1511,4,0,12,13,42663120,3648,382080,32,11704
1512,10,0,17,8,42685560,3649,382080,32,11714
1513,7,0,17,8,42709260,3649,382080,32,11721
1514,7,0,14,11,42753660,3649,382080,32,11728
1515,4,0,13,12,42778800,3650,382080,32,11732
1516,6,0,14,11,42801060,3650,382080,32,11738
1517,7,0,15,10,42820140,3650,382080,32,11745
1518,9,0,16,9,42850500,3650,382080,32,11754
1519,6,0,17,8,42869040,3650,382080,32,11760
1520,5,0,13,12,42901020,3650,382080,32,11765
1521,6,0,15,10,42910200,3650,382080,32,11771
1522,10,0,18,7,42941760,3650,382080,32,11781
1523,7,0,17,8,42973920,3650,382080,32,11788
1524,11,0,17,8,43020060,3651,382080,32,11799
1525,12,0,18,7,43052280,3650,382080,32,11811
1526,16,0,24,1,43083660,3650,382080,32,11827
1527,14,5,21,4,43150620,3652,392580,33,11841
1528,14,15,19,6,43191240,3653,396780,33,11855
1529,9,20,18,7,43229580,3655,402420,33,11864
1530,10,23,21,4,43258680,3656,429000,36,11874
1531,4,14,25,0,43317060,3658,537360,45,11878
1532,4,0,15,10,43388340,3656,670740,56,11882
1533,9,0,14,11,43424640,3656,670740,56,11891
1534,11,0,17,8,43443060,3655,670740,56,11902
1535,5,0,13,12,43476180,3655,670740,56,11907
1536,9,0,17,8,43484820,3654,670740,56,11916
1537,2,0,11,14,43514640,3654,670740,56,11918
1538,5,0,12,13,43529820,3654,670740,56,11923
1539,5,0,14,11,43539600,3654,670740,56,11928
1540,3,0,11,14,43559040,3654,670740,56,11931
1541,3,0,11,14,43569540,3654,670740,56,11934
1542,5,0,12,13,43579980,3653,670740,56,11939
1543,7,0,15,10,43592100,3653,670740,56,11946
1544,8,0,13,12,43619040,3652,670740,56,11954
1545,3,0,14,11,43628100,3653,670740,56,11957
1546,10,0,18,7,43653600,3653,670740,56,11967
1547,11,0,21,4,43676880,3652,670740,55,11978
1548,5,0,17,8,43705200,3652,670740,55,11983
1549,7,0,15,10,43740120,3652,670740,55,11990
1550,16,0,22,3,43776360,3652,670740,55,12006
1551,18,13,18,7,43807380,3652,672060,55,12024
1552,8,10,24,1,43838340,3653,700920,58,12032
1553,9,9,25,0,43884000,3654,727860,60,12041
1554,5,0,14,11,43972680,3654,775920,64,12046
1555,12,0,16,9,43999620,3653,775920,64,12058
1556,8,0,13,12,44022720,3652,775920,64,12066
1557,4,0,14,11,44038020,3652,775920,64,12070
1558,8,0,17,8,44049600,3652,775920,64,12078
1559,7,0,16,9,44091060,3653,775920,64,12085
1560,6,0,13,12,44122080,3653,775920,64,12091
1561,9,0,15,10,44141760,3652,775920,64,12100
1562,4,0,13,12,44163360,3652,775920,64,12104
1563,3,0,12,13,44186700,3653,775920,64,12107
1564,6,0,15,10,44198340,3653,775920,64,12113
1565,8,0,15,10,44219940,3652,775920,64,12121
1566,9,0,18,7,44247720,3653,775920,63,12130
1567,6,0,14,11,44285100,3653,775920,63,12136
1568,8,0,17,8,44305260,3653,775920,63,12144
1569,11,0,17,8,44339580,3652,775920,63,12155
1570,13,0,20,5,44370300,3652,775920,63,12168
1571,9,0,15,10,44407140,3651,775920,63,12177
1572,10,0,18,7,44432640,3651,775920,63,12187
1573,5,0,15,10,44454900,3650,775920,63,12192
1574,11,0,18,7,44487300,3650,775920,63,12203
1575,11,0,16,9,44520420,3649,775920,63,12214
1576,6,0,15,10,44543760,3649,775920,63,12220
1577,12,0,17,8,44570040,3648,775920,63,12232
1578,10,0,18,7,44600040,3648,775920,63,12242
1579,6,0,18,7,44619420,3648,775920,63,12248
1580,3,0,12,13,44661960,3649,775920,63,12251
1581,6,0,11,14,44690280,3649,775920,63,12257
1582,8,0,13,12,44701920,3648,775920,63,12265
1583,8,0,17,8,44713800,3648,775920,63,12273
1584,8,0,19,6,44733960,3648,775920,63,12281
1585,3,0,15,10,44764200,3648,775920,63,12284
1586,5,0,12,13,44802120,3649,775920,63,12289
1587,2,0,10,15,44825340,3649,775920,63,12291
1588,5,0,13,12,44836320,3650,775920,63,12296
1589,4,0,15,10,44842740,3650,775920,63,12300
1590,11,0,17,8,44871120,3649,775920,63,12311
1591,7,0,15,10,44903760,3649,775920,62,12318
1592,6,0,13,12,44920860,3648,775920,62,12324
1593,12,0,19,6,44945160,3649,775920,62,12336
1594,17,0,24,1,44987400,3648,775920,62,12353
1595,7,0,19,6,45034020,3649,775920,62,12360
1596,10,0,16,9,45084840,3649,775920,62,12370
1597,4,0,14,11,45109140,3649,775920,62,12374
1598,10,0,15,10,45139140,3649,775920,62,12384
1599,12,0,17,8,45167700,3648,775920,62,12396
1600,9,0,17,8,45195240,3648,775920,62,12405
1601,6,0,16,9,45230700,3649,775920,62,12411
1602,6,0,17,8,45246120,3648,775920,62,12417
1603,3,0,13,12,45278460,3649,775920,62,12420
1604,7,0,12,13,45309660,3649,775920,62,12427
1605,8,0,18,7,45312300,3649,775920,62,12435
1606,6,0,13,12,45349320,3648,775920,62,12441
1607,2,0,10,15,45370140,3649,775920,62,12443
1608,8,0,13,12,45382380,3648,775920,62,12451
1609,6,0,12,13,45394320,3647,775920,62,12457
1610,5,0,12,13,45408900,3647,775920,62,12462
1611,2,0,11,14,45425640,3647,775920,62,12464
1612,6,0,16,9,45429600,3647,775920,62,12470
1613,6,0,14,11,45446820,3646,775920,62,12476
1614,13,0,21,4,45468840,3646,775920,62,12489
1615,8,0,21,4,45503160,3647,775920,62,12497
1616,7,0,16,9,45550320,3647,775920,62,12504
1617,7,0,14,11,45592380,3648,775920,62,12511
1618,8,0,13,12,45631260,3648,775920,61,12519
1619,4,0,12,13,45650400,3648,775920,61,12523
1620,7,0,14,11,45665520,3648,775920,61,12530
1621,11,0,18,7,45675480,3647,775920,61,12541
1622,12,0,16,9,45722460,3647,775920,61,12553
1623,9,0,19,6,45745740,3647,775920,61,12562
1624,14,0,18,7,45803580,3647,775920,61,12576
1625,6,0,16,9,45829440,3647,775920,61,12582
1626,7,0,13,12,45866160,3647,775920,61,12589
1627,11,0,17,8,45883020,3646,775920,61,12600
1628,6,0,16,9,45904980,3646,775920,61,12606
1629,7,0,13,12,45949260,3646,775920,61,12613
1630,11,0,17,8,45969060,3646,775920,61,12624
1631,2,0,14,11,45992880,3646,775920,61,12626
1632,5,0,11,14,46023060,3646,775920,61,12631
1633,5,0,12,13,46038120,3646,775920,61,12636
1634,3,0,12,13,46049220,3646,775920,61,12639
1635,6,0,15,10,46057080,3646,775920,61,12645
1636,3,0,12,13,46080960,3646,775920,61,12648
1637,7,0,13,12,46100100,3646,775920,61,12655
1638,5,0,14,11,46107960,3646,775920,61,12660
1639,6,0,12,13,46137060,3646,775920,61,12666
1640,10,0,16,9,46145100,3644,775920,61,12676
1641,11,0,19,6,46177140,3645,775920,61,12687
1642,8,0,18,7,46205940,3644,775920,61,12695
1643,16,2,25,0,46234440,3645,775920,61,12711
1644,11,0,25,0,46288860,3645,782460,61,12722
1645,10,0,19,6,46335780,3644,782520,61,12732
1646,11,0,25,0,46366440,3645,784560,61,12743
1647,12,0,13,12,46473900,3647,784620,61,12755
1648,9,0,16,9,46487220,3646,784620,61,12764
1649,4,0,13,12,46513620,3646,784620,61,12768
1650,6,0,18,7,46514520,3646,784620,61,12774
1651,10,0,17,8,46569840,3647,784620,61,12784
1652,5,0,17,8,46587600,3647,784620,61,12789
1653,2,0,11,14,46618800,3647,784620,61,12791
1654,10,0,17,8,46642200,3648,784620,61,12801
1655,5,0,13,12,46667460,3647,784620,61,12806
1656,3,0,11,14,46685760,3647,784620,61,12809
1657,6,0,14,11,46703880,3648,784620,61,12815
1658,7,0,12,13,46719660,3647,784620,61,12822
1659,2,0,13,12,46722240,3647,784620,61,12824
1660,6,0,13,12,46741440,3646,784620,61,12830
1661,5,0,15,10,46752900,3646,784620,61,12835
1662,6,0,15,10,46778520,3647,784620,61,12841
1663,6,0,13,12,46809420,3647,784620,61,12847
1664,10,0,17,8,46827720,3647,784620,61,12857
1665,8,0,20,5,46847160,3647,784620,60,12865
1666,11,0,18,7,46890900,3646,784620,60,12876
1667,7,0,15,10,46929360,3646,784620,60,12883
1668,13,0,18,7,46960260,3646,784620,60,12896
1669,8,0,20,5,46981860,3646,784620,60,12904
1670,11,0,19,6,47029980,3646,784620,60,12915
1671,6,0,15,10,47058780,3646,784620,60,12921
1672,8,0,16,9,47088180,3646,784620,60,12929
1673,11,0,19,6,47119200,3646,784620,60,12940
1674,10,0,19,6,47154000,3646,784620,60,12950
1675,10,0,18,7,47195460,3646,784620,60,12960
1676,11,0,20,5,47235180,3647,784620,60,12971
1677,3,0,15,10,47269860,3647,784620,60,12974
1678,8,0,16,9,47295240,3647,784620,60,12982
1679,5,0,13,12,47335080,3648,784620,60,12987
1680,2,0,11,14,47347020,3648,784620,60,12989
1681,5,0,13,12,47361840,3648,784620,60,12994
1682,7,0,14,11,47382420,3648,784620,60,13001
1683,6,0,12,13,47403360,3647,784620,60,13007
1684,5,0,12,13,47426100,3648,784620,60,13012
1685,11,0,16,9,47447340,3647,784620,60,13023
1686,6,0,17,8,47457480,3647,784620,60,13029
1687,4,0,12,13,47493660,3647,784620,60,13033
1688,4,0,11,14,47509380,3647,784620,60,13037
1689,7,0,14,11,47521320,3647,784620,60,13044
1690,11,0,16,9,47543940,3646,784620,60,13055
1691,10,0,17,8,47565240,3645,784620,60,13065
1692,7,0,14,11,47595540,3644,784620,60,13072
1693,9,0,15,10,47611620,3643,784620,59,13081
1694,4,0,13,12,47643780,3644,784620,59,13085
1695,5,0,13,12,47665560,3644,784620,59,13090
1696,11,0,19,6,47681520,3644,784620,59,13101
1697,6,0,18,7,47707740,3644,784620,59,13107
1698,5,0,16,9,47741220,3645,784620,59,13112
1699,10,0,18,7,47779020,3646,784620,59,13122
1700,13,0,19,6,47822580,3646,785100,59,13135
1701,8,0,16,9,47868060,3646,785100,59,13143
1702,5,0,14,11,47894940,3646,785100,59,13148
1703,3,0,11,14,47922840,3647,785100,59,13151
1704,6,0,13,12,47934780,3646,785100,59,13157
1705,7,0,12,13,47958120,3646,785100,59,13164
1706,2,0,10,15,47974680,3646,785100,59,13166
1707,6,0,11,14,47986140,3646,785100,59,13172
1708,5,0,14,11,47991180,3645,785100,59,13177
1709,6,0,16,9,48007320,3646,785100,59,13183
1710,6,0,14,11,48037140,3646,785100,59,13189
1711,7,0,14,11,48064680,3646,785100,59,13196
1712,9,0,15,10,48085380,3645,785100,59,13205
1713,8,0,15,10,48109200,3645,785100,59,13213
1714,13,0,18,7,48152700,3645,785100,59,13226
1715,13,0,16,9,48200940,3645,785100,59,13239
1716,9,0,18,7,48230460,3645,785100,59,13248
1717,16,0,21,4,48263880,3644,785100,59,13264
1718,9,0,21,4,48288540,3643,785100,59,13273
1719,11,0,20,5,48345240,3644,785100,59,13284
1720,11,0,17,8,48385260,3644,785100,59,13295
1721,6,0,18,7,48398580,3643,785100,59,13301
1722,10,0,18,7,48451740,3644,785100,58,13311
1723,9,0,18,7,48483720,3644,785100,58,13320
1724,7,0,18,7,48508080,3644,785100,58,13327
1725,9,2,20,5,48536220,3645,785700,58,13336
1726,3,1,18,7,48572820,3646,794400,59,13339
1727,8,0,19,6,48615180,3647,798600,59,13347
1728,8,0,18,7,48660840,3648,798600,59,13355
1729,3,0,10,15,48708000,3649,798600,59,13358
1730,9,0,13,12,48721620,3648,798600,59,13367
1731,4,0,11,14,48744720,3648,798600,59,13371
1732,6,0,13,12,48755220,3648,798600,59,13377
1733,5,0,14,11,48766500,3648,798600,59,13382
1734,11,0,17,8,48788340,3647,798600,59,13393
1735,3,0,15,10,48807060,3647,798600,59,13396
1736,11,0,17,8,48839760,3647,798600,59,13407
1737,11,0,19,6,48867480,3647,798600,59,13418
1738,11,0,23,2,48892020,3647,798600,59,13429
1739,14,0,24,1,48942300,3647,798960,59,13443
1740,3,0,14,11,49000680,3648,798960,59,13446
1741,8,0,16,9,49024020,3648,798960,59,13454
1742,11,0,19,6,49055520,3648,798960,59,13465
1743,9,0,16,9,49102260,3648,798960,59,13474
1744,5,0,12,13,49122300,3647,798960,59,13479
1745,8,0,14,11,49151220,3648,798960,59,13487
1746,9,0,15,10,49169340,3647,798960,59,13496
1747,6,0,13,12,49190400,3646,798960,59,13502
1748,8,0,14,11,49207380,3646,798960,59,13510
1749,5,0,13,12,49231680,3646,798960,59,13515
1750,4,0,12,13,49253400,3646,798960,59,13519
1751,5,0,13,12,49271760,3646,798960,59,13524
1752,7,0,18,7,49276380,3646,798960,59,13531
1753,6,0,16,9,49301340,3646,798960,59,13537
1754,10,0,17,8,49335600,3646,798960,58,13547
1755,3,0,16,9,49357800,3646,798960,58,13550
1756,4,0,12,13,49400520,3647,798960,58,13554
1757,4,0,13,12,49420440,3648,798960,58,13558
1758,2,0,12,13,49431240,3648,798960,58,13560
1759,7,0,13,12,49455480,3648,798960,58,13567
1760,12,0,18,7,49472820,3648,798960,58,13579
1761,3,0,15,10,49498740,3648,798960,58,13582
1762,13,0,21,4,49526460,3648,798960,58,13595
1763,8,0,17,8,49567860,3648,798960,58,13603
1764,7,0,15,10,49608960,3649,798960,58,13610
1765,10,0,19,6,49623660,3648,798960,58,13620
1766,9,0,16,9,49673100,3648,798960,58,13629
1767,11,0,20,5,49686720,3648,798960,58,13640
1768,11,0,16,9,49739460,3647,798960,58,13651
1769,12,0,15,10,49773900,3646,798960,58,13663
1770,9,0,11,14,49814940,3646,798960,58,13672
1771,10,0,14,11,49826520,3645,798960,58,13682
1772,7,0,15,10,49837020,3644,798960,58,13689
1773,4,0,16,9,49855680,3645,798960,58,13693
1774,6,0,14,11,49882080,3645,798960,58,13699
1775,7,0,15,10,49902540,3644,798960,58,13706
1776,10,0,19,6,49925820,3645,798960,58,13716
1777,10,0,24,1,49945500,3645,798960,58,13726
1778,3,0,15,10,49992900,3645,798960,58,13729
1779,3,0,12,13,50033040,3646,798960,58,13732
1780,7,0,13,12,50063940,3647,798960,58,13739
1781,8,0,14,11,50079960,3646,798960,58,13747
1782,11,0,18,7,50105640,3646,798960,58,13758
1783,6,0,16,9,50136960,3646,798960,58,13764
1784,10,0,14,11,50176620,3646,798960,58,13774
1785,8,0,17,8,50188680,3646,798960,57,13782
1786,12,0,23,2,50208780,3645,799200,57,13794
1787,12,0,22,3,50274600,3647,799200,57,13806
1788,11,0,22,3,50318160,3647,799200,57,13817
1789,15,0,22,3,50376000,3647,799500,57,13832
1790,14,0,22,3,50414700,3646,801600,57,13846
1791,10,0,18,7,50480400,3647,801600,57,13856
1792,7,0,12,13,50530860,3648,801600,57,13863
1793,6,0,14,11,50548380,3648,801600,57,13869
1794,14,0,19,6,50570880,3647,801600,57,13883
1795,3,0,14,11,50592060,3647,801600,57,13886
1796,11,0,21,4,50613360,3647,801600,57,13897
1797,6,0,18,7,50650260,3647,801600,57,13903
1798,9,0,16,9,50710500,3649,801600,57,13912
1799,8,0,16,9,50726160,3648,801600,57,13920
1800,5,0,15,10,50745600,3648,801600,57,13925
1801,8,0,15,10,50769600,3647,801600,57,13933
1802,6,0,15,10,50803440,3648,801600,57,13939
1803,6,0,14,11,50821680,3648,801600,57,13945
1804,5,0,11,14,50849100,3647,801600,57,13950
1805,8,0,13,12,50860560,3647,801600,57,13958
1806,1,0,12,13,50867580,3647,801600,57,13959
1807,5,0,11,14,50892600,3647,801600,57,13964
1808,6,0,14,11,50902800,3647,801600,57,13970
1809,13,0,19,6,50922240,3646,801600,57,13983
1810,10,0,20,5,50949240,3646,801600,57,13993
1811,10,0,22,3,50980380,3646,801600,57,14003
1812,14,2,24,1,51022920,3646,803760,57,14017
1813,8,7,16,9,51074040,3647,808440,57,14025
1814,8,7,19,6,51115860,3649,828480,59,14033
1815,5,0,22,3,51146160,3649,871740,62,14038
1816,12,0,21,4,51192720,3649,871740,62,14050
1817,18,0,25,0,51245040,3649,872580,62,14068
1818,8,0,20,5,51282120,3648,872580,61,14076
1819,5,0,17,8,51330060,3649,872580,61,14081
1820,7,0,17,8,51370260,3650,872580,61,14088
1821,6,0,15,10,51402960,3651,872580,61,14094
1822,3,0,13,12,51423780,3651,872580,61,14097
1823,6,0,15,10,51443760,3651,872580,61,14103
1824,7,0,16,9,51479160,3652,872580,61,14110
1825,2,0,13,12,51505560,3653,872580,61,14112
1826,9,0,15,10,51538380,3653,872580,61,14121
1827,8,0,12,13,51566580,3652,872580,61,14129
1828,3,0,11,14,51581760,3652,872580,61,14132
1829,7,0,12,13,51599520,3652,872580,61,14139
1830,8,0,11,14,51624360,3651,872580,61,14147
1831,8,0,16,9,51627360,3651,872580,61,14155
1832,10,0,15,10,51658380,3650,872580,61,14165
1833,13,0,17,8,51685260,3649,872580,61,14178
1834,10,0,15,10,51719580,3649,872580,61,14188
1835,6,0,18,7,51729540,3649,872580,61,14194
1836,12,0,22,3,51762420,3649,872580,61,14206
1837,15,0,22,3,51799440,3648,872580,61,14221
1838,13,0,21,4,51859800,3648,872580,61,14234
1839,11,0,18,7,51906240,3648,872580,61,14245
1840,8,0,18,7,51939240,3648,872580,61,14253
1841,7,0,16,9,51988800,3649,872580,61,14260
1842,6,0,16,9,52014180,3650,872580,61,14266
1843,6,0,14,11,52042980,3650,872580,61,14272
1844,10,0,17,8,52068060,3650,872580,61,14282
1845,6,0,18,7,52087440,3650,872580,61,14288
1846,6,0,14,11,52133520,3650,872580,61,14294
1847,6,0,14,11,52158120,3650,872580,61,14300
1848,4,0,13,12,52172880,3650,872580,61,14304
1849,4,0,14,11,52192440,3651,872580,60,14308
1850,6,0,12,13,52220520,3651,872580,60,14314
1851,5,0,14,11,52232460,3651,872580,60,14319
1852,7,0,14,11,52255260,3651,872580,60,14326
1853,7,0,13,12,52280400,3650,872580,60,14333
1854,14,0,23,2,52287000,3650,872580,60,14347
1855,12,0,19,6,52325700,3648,873660,60,14359
1856,9,0,16,9,52383600,3649,873660,60,14368
1857,8,0,17,8,52399860,3649,873660,60,14376
1858,10,0,21,4,52431060,3649,873660,60,14386
1859,17,0,21,4,52497720,3650,873660,60,14403
1860,14,0,21,4,52534260,3649,873660,60,14417
1861,16,0,22,3,52585500,3648,873840,60,14433
1862,16,0,22,3,52629540,3647,873840,60,14449
1863,6,0,17,8,52668060,3647,873840,60,14455
1864,7,0,19,6,52690800,3648,873840,60,14462
1865,6,0,17,8,52729560,3648,873840,60,14468
1866,9,0,14,11,52771680,3648,873840,60,14477
1867,11,0,17,8,52789620,3647,873840,60,14488
1868,4,0,13,12,52813020,3647,873840,60,14492
1869,9,0,12,13,52849380,3647,873840,60,14501
1870,3,0,9,16,52869180,3647,873840,60,14504
1871,4,0,11,14,52872840,3647,873840,60,14508
1872,7,0,13,12,52884960,3646,873840,60,14515
1873,3,0,11,14,52901340,3646,873840,60,14518
1874,3,0,12,13,52912680,3646,873840,60,14521
1875,2,0,12,13,52918440,3646,873840,60,14523
1876,7,0,15,10,52936380,3647,873840,60,14530
1877,8,0,15,10,52956900,3646,873840,60,14538
1878,6,0,15,10,52982940,3646,873840,60,14544
1879,10,0,19,6,53011020,3647,873840,60,14554
1880,13,0,24,1,53040960,3647,873840,59,14567
1881,9,0,18,7,53102640,3647,873840,59,14576
1882,10,0,19,6,53134020,3647,873840,59,14586
1883,6,0,15,10,53179260,3648,873840,59,14592
1884,8,0,15,10,53217180,3648,873840,59,14600
1885,6,0,13,12,53239740,3648,873840,59,14606
1886,9,0,15,10,53263440,3648,873840,59,14615
1887,12,0,15,10,53305680,3648,873840,59,14627
1888,11,0,20,5,53327700,3648,873840,59,14638
1889,15,0,22,3,53364840,3647,873840,59,14653
1890,8,0,19,6,53420820,3648,873840,59,14661
1891,5,0,12,13,53464140,3648,873840,59,14666
1892,4,0,12,13,53479860,3648,873840,59,14670
1893,6,0,15,10,53491800,3648,873840,59,14676
1894,6,0,15,10,53507460,3648,873840,59,14682
1895,4,0,13,12,53535720,3648,873840,59,14686
1896,4,0,10,15,53551800,3647,873840,59,14690
1897,2,0,10,15,53559840,3647,873840,59,14692
1898,7,0,13,12,53574060,3647,873840,59,14699
1899,10,0,16,9,53592300,3647,873840,59,14709
1900,7,0,15,10,53618400,3647,873840,59,14716
1901,7,0,15,10,53638020,3646,873840,59,14723
1902,5,0,15,10,53670360,3647,873840,59,14728
1903,9,0,13,12,53705880,3647,873840,59,14737
1904,11,0,16,9,53728380,3647,873840,59,14748
1905,8,0,16,9,53746680,3646,873840,59,14756
1906,6,0,15,10,53775720,3646,873840,59,14762
1907,10,0,18,7,53804280,3646,873840,59,14772
1908,6,0,18,7,53827020,3646,873840,59,14778
1909,14,0,19,6,53881440,3647,873840,59,14792
1910,9,0,19,6,53902320,3646,873840,59,14801
1911,9,0,18,7,53943720,3646,873840,59,14810
1912,6,0,17,8,53975520,3647,873840,58,14816
1913,13,0,20,5,54021480,3647,873840,58,14829
1914,10,0,17,8,54071040,3648,873840,58,14839
1915,9,0,15,10,54093000,3646,873840,58,14848
1916,7,0,15,10,54124980,3647,873840,58,14855
1917,6,0,17,8,54140460,3647,873840,58,14861
1918,6,0,15,10,54169020,3647,873840,58,14867
1919,3,0,11,14,54206940,3648,873840,58,14870
1920,3,0,11,14,54212820,3647,873840,58,14873
1921,4,0,11,14,54225900,3647,873840,58,14877
1922,6,0,12,13,54238260,3647,873840,58,14883
1923,7,0,14,11,54251700,3646,873840,58,14890
1924,9,0,19,6,54267600,3647,873840,58,14899
1925,4,0,13,12,54306960,3647,873840,58,14903
1926,3,0,14,11,54321300,3647,873840,58,14906
1927,9,0,16,9,54342600,3647,873840,58,14915
1928,13,0,19,6,54381300,3647,873840,58,14928
1929,5,0,16,9,54421380,3648,873840,58,14933
1930,11,0,17,8,54460800,3648,873840,58,14944
1931,13,0,19,6,54499800,3648,873840,58,14957
1932,6,0,20,5,54513660,3648,873840,58,14963
1933,8,0,15,10,54587160,3649,873840,58,14971
1934,9,0,16,9,54611880,3649,873840,58,14980
1935,7,0,17,8,54642780,3650,873840,58,14987
1936,9,0,16,9,54678360,3650,873840,58,14996
1937,11,0,18,7,54705420,3649,873840,58,15007
1938,12,0,16,9,54749220,3649,873840,58,15019
1939,4,0,9,16,54781260,3648,873840,58,15023
1940,5,0,12,13,54789660,3648,873840,58,15028
1941,4,0,11,14,54806040,3648,873840,58,15032
1942,1,0,9,16,54813600,3648,873840,58,15033
1943,7,0,12,13,54822060,3647,873840,58,15040
1944,3,0,10,15,54834060,3647,873840,58,15043
1945,5,0,11,14,54849840,3647,873840,58,15048
1946,6,0,13,12,54858600,3647,873840,58,15054
1947,7,0,16,9,54868680,3646,873840,58,15061
1948,5,0,13,12,54906480,3647,873840,58,15066
1949,8,0,17,8,54921120,3647,873840,57,15074
1950,9,0,18,7,54962100,3648,873840,57,15083
1951,13,0,22,3,54992220,3648,873840,57,15096
1952,4,0,14,11,55039260,3648,873840,57,15100
1953,10,0,16,9,55070040,3648,873840,57,15110
1954,10,0,15,10,55101600,3647,873840,57,15120
1955,15,0,20,5,55121400,3646,873840,57,15135
1956,10,0,17,8,55170480,3646,873840,57,15145
1957,7,0,13,12,55204260,3646,873840,57,15152
1958,14,0,21,4,55222740,3646,873840,57,15166
1959,8,0,19,6,55256160,3646,873840,57,15174
1960,10,0,19,6,55297140,3646,873840,57,15184
1961,8,0,17,8,55328940,3646,873840,57,15192
1962,10,0,17,8,55365720,3646,873840,57,15202
1963,6,0,16,9,55391580,3646,873840,57,15208
1964,3,0,14,11,55419360,3646,873840,57,15211
1965,4,0,14,11,55438980,3647,873840,57,15215
1966,5,0,14,11,55454700,3646,873840,57,15220
1967,2,0,14,11,55473360,3647,873840,57,15222
1968,7,0,11,14,55512060,3647,873840,57,15229
1969,6,0,12,13,55520580,3647,873840,57,15235
1970,2,0,9,16,55537440,3647,873840,57,15237
1971,5,0,12,13,55543560,3646,873840,57,15242
1972,5,0,14,11,55554840,3647,873840,57,15247
1973,1,0,9,16,55574640,3646,873840,57,15248
1974,10,0,17,8,55578480,3646,873840,57,15258
1975,6,0,17,8,55599840,3646,873840,57,15264
1976,13,0,19,6,55639320,3646,873840,57,15277
1977,6,0,17,8,55670400,3646,873840,57,15283
1978,8,0,18,7,55696620,3646,873840,57,15291
1979,12,0,18,7,55753800,3647,873840,57,15303
1980,10,0,20,5,55786680,3647,873840,57,15313
1981,6,0,14,11,55828980,3647,873840,57,15319
1982,7,0,14,11,55864740,3648,873840,57,15326
1983,13,0,21,4,55877280,3647,873840,56,15339
1984,12,0,20,5,55921140,3647,873840,56,15351
1985,13,0,21,4,55963200,3647,873840,56,15364
1986,7,0,15,10,56014980,3647,873840,56,15371
1987,13,0,22,3,56030880,3647,873840,56,15384
1988,9,3,23,2,56057940,3647,874920,56,15393
1989,8,0,20,5,56129460,3649,878580,57,15401
1990,4,0,14,11,56185680,3650,878580,57,15405
1991,3,0,10,15,56214960,3650,878580,57,15408
1992,4,0,13,12,56216040,3650,878580,57,15412
1993,6,0,13,12,56242020,3650,878580,56,15418
1994,2,0,11,14,56259780,3651,878580,56,15420
1995,5,0,15,10,56260260,3650,878580,56,15425
1996,2,0,12,13,56283480,3651,878580,56,15427
1997,5,0,12,13,56305380,3651,878580,56,15432
1998,7,0,17,8,56316600,3651,878580,56,15439
1999,10,0,15,10,56344740,3650,878580,56,15449
2000,10,0,22,3,56359200,3650,878580,56,15459
2001,11,0,17,8,56418420,3650,878580,56,15470
2002,7,0,16,9,56447160,3650,878580,56,15477
2003,5,0,16,9,56466840,3651,878580,56,15482
2004,8,0,19,6,56475780,3650,878580,56,15490
2005,9,0,18,7,56519580,3650,878580,56,15499
2006,12,0,21,4,56552760,3650,878580,56,15511
2007,11,0,18,7,56601000,3650,878700,56,15522
2008,11,0,18,7,56642880,3650,878700,56,15533
2009,11,7,16,9,56672760,3651,880680,56,15544
2010,8,9,19,6,56694360,3652,895800,57,15552
2011,6,0,14,11,56760120,3651,939540,60,15558
2012,8,0,12,13,56785800,3650,939540,60,15566
2013,3,0,11,14,56797020,3650,939540,60,15569
2014,9,0,15,10,56806920,3650,939540,60,15578
2015,4,0,14,11,56819820,3649,939540,60,15582
2016,4,0,15,10,56835780,3650,939540,60,15586
2017,3,0,17,8,56836800,3649,939540,60,15589
2018,6,0,15,10,56847840,3648,939540,60,15595
2019,5,0,16,9,56856660,3648,939540,60,15600
2020,7,0,22,3,56857800,3648,939540,60,15607
2021,10,5,20,5,56883000,3648,941640,60,15617
2022,6,9,19,6,56901900,3648,948120,60,15623
2023,3,6,22,3,56922180,3649,971880,62,15626
2024,11,4,25,0,56961600,3649,994440,63,15637
2025,10,0,23,2,57001440,3648,1031220,65,15647
2026,10,0,23,2,57032940,3648,1032420,65,15657
2027,8,0,22,3,57060000,3647,1032420,65,15665
2028,12,2,25,0,57092760,3648,1032600,65,15677
2029,9,0,25,0,57124860,3647,1036200,66,15686
2030,11,0,25,0,57170880,3647,1037220,66,15697
2031,10,1,25,0,57200940,3647,1038840,66,15707
2032,16,10,25,0,57230340,3648,1043040,66,15723
2033,8,14,22,3,57270960,3648,1052400,66,15731
2034,5,8,25,0,57308040,3649,1086540,69,15736
2035,2,0,21,4,57354960,3649,1162380,73,15738
2036,7,0,20,5,57371460,3648,1162380,73,15745
2037,5,0,19,6,57407100,3649,1162380,73,15750
2038,6,0,20,5,57419160,3648,1162380,73,15756
2039,4,0,19,6,57440340,3649,1162380,73,15760
2040,2,0,17,8,57458040,3649,1162380,73,15762
2041,14,1,25,0,57469740,3648,1162860,73,15776
2042,9,1,25,0,57501540,3648,1171020,74,15785
2043,3,0,20,5,57531420,3648,1175100,74,15788
2044,7,0,20,5,57568920,3649,1175100,74,15795
2045,7,0,23,2,57581340,3649,1175100,74,15802
2046,8,0,22,3,57612240,3649,1175100,74,15810
2047,4,0,21,4,57635580,3649,1175100,74,15814
2048,14,0,23,2,57680760,3649,1175460,74,15828
2049,12,0,23,2,57709440,3648,1175460,74,15840
2050,6,0,18,7,57747060,3648,1175460,74,15846
2051,13,0,22,3,57766440,3647,1175460,74,15859
2052,12,0,21,4,57797280,3646,1175460,74,15871
2053,13,1,25,0,57816600,3645,1175460,74,15884
2054,10,10,20,5,57846840,3646,1176360,74,15894
2055,15,21,20,5,57875880,3647,1178760,74,15909
2056,14,32,21,4,57893940,3648,1180440,74,15923
2057,17,40,22,3,57919920,3648,1189680,74,15940
2058,9,40,25,0,57950340,3649,1206420,75,15949
2059,10,40,25,0,57989760,3650,1250400,78,15959
2060,11,37,25,0,58036140,3651,1371780,85,15970
2061,2,26,25,0,58096620,3652,1578060,98,15972
2062,6,7,25,0,58137300,3648,1974960,123,15978
2063,5,0,18,7,58156200,3645,2085960,130,15983
2064,5,0,20,5,58174620,3646,2085960,130,15988
2065,6,0,19,6,58193940,3645,2085960,130,15994
2066,7,0,19,6,58210980,3645,2085960,130,16001
2067,2,0,16,9,58238220,3645,2085960,130,16003
2068,3,0,16,9,58243740,3645,2085960,130,16006
2069,10,0,20,5,58251240,3644,2085960,130,16016
2070,10,0,23,2,58267320,3643,2085960,130,16026
2071,10,0,25,0,58287900,3643,2086500,130,16036
2072,4,0,22,3,58330080,3644,2087100,130,16040
2073,10,0,23,2,58363440,3644,2087820,130,16050
2074,13,0,22,3,58404480,3643,2087940,130,16063
2075,10,0,21,4,58436940,3643,2087940,130,16073
2076,12,8,21,4,58462080,3644,2090280,130,16085
2077,15,20,20,5,58486920,3644,2097360,130,16100
2078,10,29,19,6,58500180,3645,2098440,130,16110
2079,6,30,21,4,58524060,3645,2121060,131,16116
2080,11,34,25,0,58544220,3646,2161800,134,16127
2081,13,40,25,0,58583040,3647,2172360,134,16140
2082,12,40,25,0,58620780,3648,2216160,137,16152
2083,6,36,25,0,58666620,3648,2295240,142,16158
2084,5,30,25,0,58717860,3649,2466360,152,16163
2085,7,28,25,0,58753680,3649,2608080,161,16170
2086,8,19,25,0,58803480,3648,2771040,171,16178
2087,3,0,23,2,58836840,3645,3212880,198,16181
2088,7,0,21,4,58863720,3645,3212880,198,16188
2089,0,0,15,10,58890420,3645,3212880,198,16188
2090,6,0,18,7,58893060,3645,3212880,198,16194
2091,4,0,20,5,58903320,3645,3212880,198,16198
2092,5,0,18,7,58928040,3645,3212880,198,16203
2093,4,0,17,8,58949820,3645,3212880,198,16207
2094,3,0,19,6,58952100,3645,3212880,198,16210
2095,6,0,19,6,58972680,3645,3212880,198,16216
2096,5,0,20,5,58987800,3645,3212880,198,16221
2097,11,0,25,0,59005380,3645,3212880,198,16232
2098,9,0,23,2,59034300,3644,3213180,198,16241
2099,12,3,25,0,59060700,3644,3213240,197,16253
2100,15,10,25,0,59100420,3645,3218460,198,16268
2101,11,10,25,0,59143800,3645,3236460,199,16279
2102,10,10,25,0,59176920,3645,3249660,199,16289
2103,6,5,25,0,59216280,3644,3304320,203,16295
2104,14,2,25,0,59257320,3643,3333840,204,16309
2105,10,2,25,0,59291940,3643,3343500,205,16319
2106,7,0,23,2,59332800,3643,3347820,205,16326
2107,4,0,18,7,59367660,3643,3347820,205,16330
2108,7,0,20,5,59383620,3643,3347820,205,16337
2109,1,0,18,7,59398980,3643,3347820,205,16338
2110,5,0,19,6,59419800,3644,3347820,205,16343
2111,9,0,23,2,59433600,3643,3347820,204,16352
2112,4,0,19,6,59458680,3643,3347820,204,16356
2113,8,0,20,5,59477100,3643,3347820,204,16364
2114,9,0,19,6,59502960,3642,3347820,204,16373
2115,3,0,16,9,59523060,3642,3347820,204,16376
2116,5,0,19,6,59529720,3642,3347820,204,16381
2117,3,0,18,7,59543520,3642,3347820,204,16384
2118,4,0,20,5,59546940,3642,3347820,204,16388
2119,8,0,21,4,59567580,3641,3347820,204,16396
2120,9,0,24,1,59600340,3642,3347820,204,16405
2121,10,2,25,0,59624220,3642,3347820,204,16415
2122,6,0,25,0,59654820,3642,3351120,204,16421
2123,8,0,23,2,59712840,3643,3354180,204,16429
2124,11,0,22,3,59748660,3643,3358080,204,16440
2125,7,0,23,2,59772660,3643,3359700,204,16447
2126,8,5,21,4,59793060,3643,3360300,204,16455
2127,10,6,25,0,59830020,3644,3369720,204,16465
2128,6,0,23,2,59872080,3644,3392520,206,16471
2129,13,2,25,0,59907360,3644,3392760,206,16484
2130,9,3,25,0,59939040,3644,3401160,206,16493
2131,7,0,20,5,59986680,3644,3410940,206,16500
2132,6,0,17,8,60023220,3644,3410940,206,16506
2133,5,0,17,8,60039480,3644,3410940,206,16511
2134,5,0,19,6,60050460,3644,3410940,206,16516
2135,6,0,18,7,60064740,3643,3410940,206,16522
2136,4,0,18,7,60079440,3643,3410940,206,16526
2137,9,0,20,5,60099300,3643,3410940,206,16535
2138,6,0,22,3,60112920,3643,3410940,206,16541
2139,7,0,22,3,60133740,3642,3410940,206,16548
2140,5,0,20,5,60159420,3642,3410940,206,16553
2141,5,0,20,5,60185640,3643,3410940,206,16558
2142,10,0,20,5,60219120,3643,3410940,206,16568
2143,9,0,24,1,60235200,3643,3410940,205,16577
2144,10,0,25,0,60271080,3643,3411060,205,16587
2145,11,4,25,0,60294420,3643,3413700,205,16598
2146,7,3,25,0,60333960,3643,3427440,206,16605
2147,3,0,18,7,60392220,3644,3432660,206,16608
2148,11,1,25,0,60400920,3644,3432660,206,16619
2149,9,0,24,1,60428700,3643,3434760,206,16628
2150,7,0,22,3,60468960,3644,3434760,206,16635
2151,7,0,21,4,60502920,3644,3434760,206,16642
2152,7,0,21,4,60521160,3643,3434760,206,16649
2153,15,6,23,2,60540780,3643,3435660,206,16664
2154,17,21,19,6,60579300,3644,3443340,206,16681
2155,9,21,25,0,60607860,3645,3482940,208,16690
2156,10,29,24,1,60625560,3645,3488940,209,16700
2157,10,30,25,0,60671760,3647,3535980,211,16710
2158,5,28,25,0,60717960,3648,3580200,214,16715
2159,3,19,25,0,60767460,3648,3714300,222,16718
2160,5,4,25,0,60809340,3646,3942900,236,16723
2161,9,0,24,1,60837060,3645,4004580,239,16732
2162,1,0,18,7,60869220,3645,4004580,239,16733
2163,4,0,16,9,60894600,3645,4004580,239,16737
2164,3,0,15,10,60901860,3645,4004580,239,16740
2165,5,0,19,6,60904620,3645,4004580,239,16745
2166,14,2,25,0,60912660,3644,4005540,239,16759
2167,8,0,23,2,60947040,3644,4008120,239,16767
2168,2,0,18,7,60982020,3644,4008120,239,16769
2169,5,0,19,6,60998220,3644,4008120,239,16774
2170,10,0,23,2,61007640,3643,4008120,239,16784
2171,12,0,22,3,61053240,3643,4008120,238,16796
2172,13,1,25,0,61080060,3643,4010700,238,16809
2173,8,0,22,3,61124940,3643,4011540,238,16817
2174,15,3,25,0,61155480,3643,4015320,238,16832
2175,6,0,20,5,61200180,3643,4021680,239,16838
2176,12,2,25,0,61218540,3643,4023060,239,16850
2177,7,0,21,4,61261620,3642,4023960,238,16857
2178,5,0,21,4,61280220,3642,4023960,238,16862
2179,5,0,16,9,61312200,3642,4023960,238,16867
2180,9,0,23,2,61315800,3642,4023960,238,16876
2181,10,0,22,3,61351680,3642,4023960,238,16886
2182,3,0,18,7,61375680,3642,4023960,238,16889
2183,7,0,19,6,61389840,3641,4023960,238,16896
2184,2,0,21,4,61389840,3641,4023960,238,16898
2185,7,0,20,5,61434120,3642,4023960,238,16905
2186,12,0,24,1,61451160,3641,4023960,238,16917
2187,9,1,24,1,61486320,3642,4028640,238,16926
2188,8,3,25,0,61510620,3642,4031400,238,16934
2189,9,0,25,0,61561680,3642,4040880,238,16943
2190,3,0,19,6,61596780,3643,4040940,238,16946
2191,5,0,20,5,61621500,3643,4040940,238,16951
2192,16,2,25,0,61657140,3643,4044840,238,16967
2193,6,0,20,5,61694760,3643,4046640,238,16973
2194,6,0,18,7,61718580,3642,4046640,238,16979
2195,9,0,20,5,61735080,3642,4046640,238,16988
2196,15,0,25,0,61763340,3641,4046760,238,17003
2197,10,0,25,0,61790400,3641,4046760,238,17013
2198,17,9,25,0,61815900,3641,4050900,238,17030
2199,10,13,25,0,61846320,3641,4060140,238,17040
2200,11,11,25,0,61907640,3642,4095120,240,17051
2201,7,2,25,0,61942800,3641,4166940,244,17058
2202,3,0,20,5,61969680,3640,4172880,244,17061
2203,5,0,20,5,62002320,3641,4172880,244,17066
2204,10,1,22,3,62015520,3640,4172880,244,17076
2205,4,2,20,5,62040420,3641,4173660,244,17080
2206,7,6,21,4,62060100,3641,4182420,245,17087
2207,1,0,21,4,62101260,3642,4204620,246,17088
2208,9,0,24,1,62109960,3641,4204620,246,17097
2209,8,0,23,2,62148000,3642,4204620,246,17105
2210,5,0,19,6,62177820,3642,4204620,246,17110
2211,3,0,15,10,62207520,3642,4204620,245,17113
2212,1,0,15,10,62215440,3642,4204620,245,17114
2213,7,0,21,4,62218260,3642,4204620,245,17121
2214,9,0,24,1,62228700,3641,4204620,245,17130
2215,7,0,21,4,62273040,3642,4205340,245,17137
2216,8,0,23,2,62298300,3642,4205340,245,17145
2217,8,0,20,5,62330280,3642,4205340,245,17153
2218,12,0,25,0,62357100,3642,4205880,245,17165
2219,7,0,22,3,62381280,3641,4205880,245,17172
2220,10,0,19,6,62426160,3641,4205880,245,17182
2221,8,0,20,5,62449980,3641,4205880,244,17190
2222,13,0,24,1,62467560,3640,4207200,244,17203
2223,10,0,22,3,62507820,3640,4207800,244,17213
2224,9,0,23,2,62541960,3640,4208580,244,17222
2225,7,0,20,5,62573940,3640,4208580,244,17229
2226,18,6,25,0,62602860,3640,4211340,244,17247
2227,9,13,21,4,62633580,3640,4212480,244,17256
2228,9,14,25,0,62655480,3641,4237080,245,17265
2229,12,17,25,0,62703420,3642,4246080,246,17277
2230,6,13,25,0,62752500,3642,4293840,248,17283
2231,4,2,25,0,62798580,3642,4419360,255,17287
2232,5,0,19,6,62821740,3640,4451460,257,17292
2233,10,0,21,4,62841540,3640,4451460,257,17302
2234,5,0,20,5,62861400,3640,4451460,257,17307
2235,6,0,22,3,62886960,3640,4451460,257,17313
2236,6,0,21,4,62910060,3640,4451460,257,17319
2237,4,0,18,7,62934060,3640,4451460,257,17323
2238,6,0,21,4,62950380,3641,4451460,257,17329
2239,4,0,20,5,62965680,3640,4451460,257,17333
2240,8,0,20,5,62990760,3640,4451460,256,17341
2241,5,0,20,5,63008940,3640,4451460,256,17346
2242,10,0,23,2,63028740,3640,4451460,256,17356
2243,14,11,20,5,63051720,3640,4452120,256,17370
2244,16,25,19,6,63071100,3640,4457100,256,17386
2245,7,30,19,6,63088500,3641,4466400,257,17393
2246,18,40,20,5,63109080,3642,4481760,257,17411
2247,6,39,20,5,63133440,3643,4489800,258,17417
2248,7,37,25,0,63154140,3643,4575300,263,17424
2249,13,35,25,0,63214500,3644,4623180,265,17437
2250,11,39,25,0,63233640,3644,4664340,267,17448
2251,6,32,25,0,63281700,3644,4773960,274,17454
2252,5,26,25,0,63322080,3644,4963680,284,17459
2253,10,24,25,0,63368460,3644,5062380,290,17469
2254,2,9,25,0,63401700,3643,5438640,311,17471
2255,7,0,18,7,63451620,3641,5726760,328,17478
2256,5,0,18,7,63468360,3641,5726760,328,17483
2257,5,0,21,4,63474780,3641,5726760,328,17488
2258,7,0,19,6,63512520,3641,5726760,327,17495
2259,2,0,18,7,63525720,3641,5726760,327,17497
2260,9,0,23,2,63544800,3641,5726760,327,17506
2261,8,0,23,2,63565560,3641,5726760,327,17514
2262,7,0,20,5,63607980,3641,5727000,327,17521
2263,5,0,19,6,63629760,3641,5727000,327,17526
2264,6,0,20,5,63641820,3641,5727000,327,17532
2265,8,0,22,3,63660240,3641,5727000,327,17540
2266,9,4,20,5,63689340,3641,5727120,327,17549
2267,10,6,24,1,63712200,3641,5742480,327,17559
2268,10,10,25,0,63738180,3642,5751900,328,17569
2269,10,13,25,0,63776940,3642,5756460,328,17579
2270,8,10,25,0,63824940,3643,5773800,328,17587
2271,11,5,25,0,63864300,3642,5855700,333,17598
2272,6,0,17,8,63910140,3640,5899080,335,17604
2273,11,0,25,0,63922380,3641,5899560,335,17615
2274,12,7,22,3,63951420,3641,5901900,335,17627
2275,3,5,21,4,63990000,3642,5915040,336,17630
2276,4,0,23,2,64012980,3641,5946000,337,17634
2277,2,0,17,8,64042860,3641,5946000,337,17636
2278,5,0,18,7,64059060,3641,5946000,337,17641
2279,3,0,19,6,64064580,3641,5946000,337,17644
2280,4,0,17,8,64083720,3641,5946000,337,17648
2281,5,0,18,7,64094520,3641,5946000,337,17653
2282,4,0,19,6,64109820,3641,5946000,337,17657
2283,8,0,21,4,64126740,3641,5946000,337,17665
2284,2,0,18,7,64140780,3641,5946000,337,17667
2285,6,0,18,7,64163280,3641,5946000,337,17673
2286,7,0,22,3,64184760,3641,5946000,336,17680
2287,6,0,19,6,64207860,3641,5946000,336,17686
2288,7,0,19,6,64231560,3641,5946000,336,17693
2289,9,0,24,1,64240620,3640,5946000,336,17702
2290,10,0,21,4,64274640,3640,5946000,336,17712
2291,18,5,25,0,64306980,3640,5946300,336,17730
2292,8,5,25,0,64338420,3640,5953320,336,17738
2293,12,13,23,2,64367820,3640,5955600,336,17750
2294,11,15,25,0,64411320,3641,5981820,337,17761
2295,7,12,25,0,64440840,3641,6003840,338,17768
2296,8,3,25,0,64486380,3640,6098940,343,17776
2297,7,0,23,2,64522620,3639,6131280,345,17783
2298,13,2,25,0,64558080,3640,6132720,345,17796
2299,6,0,23,2,64593120,3640,6134580,345,17802
2300,9,5,23,2,64624260,3641,6135960,345,17811
2301,6,9,20,5,64652640,3641,6144900,345,17817
2302,2,8,21,4,64670220,3642,6154980,346,17819
2303,2,0,22,3,64702680,3642,6213780,349,17821
2304,2,0,15,10,64741980,3642,6213780,349,17823
2305,7,0,18,7,64747980,3642,6213780,349,17830
2306,4,0,16,9,64763880,3641,6213780,349,17834
2307,3,0,16,9,64772100,3641,6213780,349,17837
2308,2,0,16,9,64778400,3641,6213780,348,17839
2309,10,0,23,2,64781220,3641,6213780,348,17849
2310,8,0,22,3,64810860,3640,6213780,348,17857
2311,9,0,24,1,64844460,3641,6213840,348,17866
2312,6,0,23,2,64862940,3640,6213840,348,17872
2313,5,0,22,3,64898220,3641,6213840,348,17877
2314,8,0,23,2,64931700,3642,6213840,348,17885
2315,5,0,21,4,64956960,3642,6213840,347,17890
2316,10,0,25,0,64990980,3642,6213960,347,17900
2317,9,7,20,5,65028120,3643,6215760,347,17909
2318,7,9,22,3,65049660,3644,6235200,348,17916
2319,12,10,24,1,65092800,3644,6249720,349,17928
2320,9,9,25,0,65118420,3644,6295800,351,17937
2321,11,6,25,0,65161620,3643,6334740,353,17948
2322,10,0,23,2,65209080,3642,6372480,355,17958
2323,6,0,18,7,65235060,3641,6372480,355,17964
2324,5,0,18,7,65251080,3641,6372480,355,17969
2325,6,0,21,4,65262000,3641,6372480,355,17975
2326,7,0,21,4,65288520,3641,6372480,355,17982
2327,5,0,18,7,65313120,3641,6372480,354,17987
2328,6,0,17,8,65341020,3641,6372480,354,17993
2329,8,0,20,5,65352660,3641,6372480,354,18001
2330,4,0,20,5,65373420,3641,6372480,354,18005
2331,6,0,20,5,65396940,3641,6372480,354,18011
2332,8,0,23,2,65418240,3642,6372480,354,18019
2333,4,0,20,5,65440380,3641,6372480,354,18023
2334,8,0,21,4,65469000,3642,6372480,354,18031
2335,5,0,22,3,65479560,3641,6372480,353,18036
2336,7,0,21,4,65523420,3642,6372480,353,18043
2337,7,0,23,2,65545440,3642,6372480,353,18050
2338,10,0,22,3,65578920,3642,6372480,353,18060
2339,10,0,22,3,65604300,3641,6372540,353,18070
2340,12,0,25,0,65625600,3641,6372660,353,18082
2341,13,0,24,1,65671500,3640,6375060,352,18095
2342,10,0,23,2,65705100,3640,6375660,352,18105
2343,18,12,23,2,65733360,3640,6378900,352,18123
2344,12,18,25,0,65762700,3641,6394800,353,18135
2345,9,20,25,0,65809620,3642,6407100,353,18144
2346,11,22,25,0,65857020,3643,6444240,355,18155
2347,9,25,23,2,65888340,3643,6459660,356,18164
2348,7,20,25,0,65931540,3644,6542340,360,18171
2349,5,17,25,0,65971980,3644,6612060,364,18176
2350,8,7,25,0,66022560,3644,6791160,374,18184
2351,2,0,20,5,66040740,3642,6892560,379,18186
2352,5,0,17,8,66074580,3642,6892560,379,18191
2353,4,0,17,8,66087900,3642,6892560,379,18195
2354,3,0,15,10,66101220,3642,6892560,379,18198
2355,7,0,19,6,66106140,3641,6892560,379,18205
2356,7,0,23,2,66111600,3641,6892560,379,18212
2357,11,0,25,0,66133740,3640,6892560,378,18223
2358,4,0,21,4,66174600,3641,6892860,378,18227
2359,12,0,25,0,66197280,3641,6893340,378,18239
2360,8,0,21,4,66234840,3640,6894360,378,18247
2361,13,0,24,1,66261120,3640,6894360,378,18260
2362,14,2,25,0,66298380,3640,6896640,378,18274
2363,9,1,25,0,66325620,3639,6905820,378,18283
2364,22,19,23,2,66363720,3640,6907200,378,18305
2365,17,32,20,5,66406920,3641,6915780,378,18322
2366,7,35,20,5,66429780,3641,6937620,379,18329
2367,8,40,22,3,66434820,3642,6946740,379,18337
2368,14,39,20,5,66475560,3643,6954660,379,18351
2369,9,39,25,0,66503520,3644,6992220,381,18360
2370,4,39,25,0,66523440,3644,7046340,384,18364
2371,11,40,25,0,66568020,3645,7105620,387,18375
2372,7,37,25,0,66616740,3646,7228920,394,18382
2373,9,38,25,0,66649440,3646,7292160,397,18391
2374,9,38,25,0,66686460,3646,7332420,399,18400
2375,5,34,25,0,66737220,3647,7437120,405,18405
2376,6,29,25,0,66779100,3647,7745220,421,18411
2377,7,6,25,0,66835620,3644,8392680,456,18418
2378,8,0,24,1,66850320,3642,8545920,465,18426
2379,6,0,22,3,66888120,3642,8546400,464,18432
2380,9,0,24,1,66918480,3643,8546940,464,18441
2381,6,0,20,5,66967200,3643,8546940,464,18447
2382,5,0,18,7,66982980,3643,8546940,464,18452
2383,8,0,21,4,66999780,3643,8546940,464,18460
2384,3,0,20,5,67022160,3643,8547300,464,18463
2385,10,0,22,3,67051560,3643,8547840,463,18473
2386,9,0,24,1,67078080,3643,8547840,463,18482
2387,11,0,23,2,67110420,3643,8547840,463,18493
2388,20,11,22,3,67137840,3642,8548020,463,18513
2389,14,22,20,5,67168500,3643,8552700,462,18527
2390,9,29,19,6,67188000,3643,8558520,462,18536
2391,10,36,20,5,67199820,3644,8571360,463,18546
2392,14,40,20,5,67235160,3645,8588700,464,18560
2393,7,38,21,4,67248240,3645,8632680,466,18567
2394,8,39,25,0,67266000,3646,8659560,467,18575
2395,5,35,25,0,67321500,3647,8783520,474,18580
2396,12,38,25,0,67356180,3647,8815980,475,18592
2397,5,37,25,0,67388400,3648,8824800,476,18597
2398,8,32,25,0,67447920,3648,9008280,485,18605
2399,3,23,25,0,67484100,3648,9315900,502,18608

