Hour,Arrivals,Waiting,Treating,Available Rooms,Total Treatment Time,Average Treatment Time,Total Wait Time,Average Wait Time,Total Arrivals
1,7,0,7,18,0,0,0,0,7
2,2,0,5,20,16440,4110,0,0,9
3,4,0,5,20,39540,4942,0,0,13
4,1,0,2,23,69360,5780,0,0,14
5,3,0,3,22,75960,5425,0,0,17
6,7,0,6,19,89580,4976,0,0,24
7,6,0,6,19,111180,4632,0,0,30
8,5,0,8,17,128220,4748,0,0,35
9,9,0,13,12,150360,4850,0,0,44
10,11,0,15,10,185100,4627,0,0,55
11,13,0,16,9,259740,4995,0,0,68
12,14,0,17,8,308100,4740,0,0,82
13,6,0,11,14,365040,4740,0,0,88
14,12,0,14,11,414120,4815,0,0,100
15,12,0,17,8,458160,4822,0,0,112
16,8,0,12,13,522300,4836,0,0,120
17,8,0,10,15,579060,4907,0,0,128
18,12,0,11,14,617520,4786,0,0,140
19,13,0,16,9,657480,4799,0,0,153
20,5,0,12,13,701640,4805,0,0,158
21,9,0,10,15,765120,4873,0,0,167
22,3,0,7,18,793680,4869,0,0,170
23,7,0,9,16,816420,4859,0,0,177
24,5,0,8,17,851280,4892,0,0,182
25,7,0,10,15,869400,4856,0,0,189
26,3,0,5,20,923580,4938,0,0,192
27,3,0,4,21,941220,4927,0,0,195
28,5,0,4,21,960960,4902,0,0,200
29,3,0,2,23,981000,4880,0,0,203
30,2,0,1,24,991020,4857,0,0,205
31,9,0,9,16,997500,4865,0,0,214
32,9,0,11,14,1024200,4831,0,0,223
33,6,0,7,18,1077720,4854,0,0,229
34,11,0,11,14,1107600,4836,0,0,240
35,9,0,15,10,1128360,4822,0,0,249
36,10,0,15,10,1183740,4851,0,0,259
37,13,0,16,9,1240440,4845,0,0,272
38,13,0,20,5,1280940,4833,0,0,285
39,15,0,20,5,1358280,4851,0,0,300
40,9,0,14,11,1424460,4828,0,0,309
41,9,0,14,11,1476180,4855,0,0,318
42,4,0,7,18,1536600,4878,0,0,322
43,10,0,12,13,1565820,4893,0,0,332
44,9,0,11,14,1616160,4897,0,0,341
45,12,0,13,12,1656960,4873,0,0,353
46,4,0,9,16,1692960,4864,0,0,357
47,8,0,7,18,1742520,4867,0,0,365
48,0,0,3,22,1759740,4861,0,0,365
49,4,0,4,21,1779180,4874,0,0,369
50,2,0,3,22,1794480,4876,0,0,371
51,3,0,2,23,1811040,4868,0,0,374
52,8,0,9,16,1811520,4856,0,0,382
53,7,0,9,16,1842780,4849,0,0,389
54,10,0,10,15,1875540,4821,0,0,399
55,9,0,11,14,1908660,4807,0,0,408
56,12,0,15,10,1947240,4808,0,0,420
57,5,0,9,16,2003040,4815,0,0,425
58,13,0,13,12,2044680,4811,0,0,438
59,6,0,12,13,2073540,4799,0,0,444
60,13,0,12,13,2125920,4777,0,0,457
61,6,0,13,12,2155140,4789,0,0,463
62,17,0,17,8,2214780,4783,0,0,480
63,11,0,16,9,2264880,4768,0,0,491
64,6,0,10,15,2318760,4761,0,0,497
65,11,0,13,12,2364180,4776,0,0,508
66,12,0,15,10,2411100,4774,0,0,520
67,12,0,16,9,2465160,4777,0,0,532
68,2,0,8,17,2520420,4791,0,0,534
69,8,0,8,17,2571300,4815,0,0,542
70,9,0,13,12,2588460,4811,0,0,551
71,4,0,7,18,2638380,4814,0,0,555
72,3,0,5,20,2665440,4819,0,0,558
73,5,0,7,18,2685840,4830,0,0,563
74,9,0,9,16,2716260,4824,0,0,572
75,6,0,8,17,2749920,4824,0,0,578
76,7,0,9,16,2781000,4828,0,0,585
77,8,0,12,13,2810160,4836,0,0,593
78,6,0,13,12,2835120,4838,0,0,599
79,7,0,10,15,2894160,4855,0,0,606
80,6,0,9,16,2923920,4848,0,0,612
81,6,0,8,17,2952780,4840,0,0,618
82,10,0,13,12,2973900,4835,0,0,628
83,7,0,13,12,3006480,4833,0,0,635
84,5,0,9,16,3061560,4851,0,0,640
85,4,0,6,19,3099240,4857,0,0,644
86,11,0,14,11,3113520,4857,0,0,655
87,8,0,11,14,3155940,4840,0,0,663
88,5,0,8,17,3198840,4846,0,0,668
89,7,0,9,16,3225360,4842,0,0,675
90,9,0,14,11,3256860,4860,0,0,684
91,7,0,11,14,3307200,4863,0,0,691
92,6,0,10,15,3343800,4867,0,0,697
93,8,0,10,15,3388200,4875,0,0,705
94,5,0,6,19,3420180,4858,0,0,710
95,6,0,8,17,3433800,4850,0,0,716
96,5,0,6,19,3466500,4848,0,0,721
97,3,0,3,22,3491280,4842,0,0,724
98,8,0,8,17,3504180,4840,0,0,732
99,7,0,11,14,3521400,4837,0,0,739
100,8,0,11,14,3558900,4835,0,0,747
101,7,0,7,18,3614220,4838,0,0,754
102,8,0,12,13,3627540,4836,0,0,762
103,3,0,5,20,3679080,4840,0,0,765
104,12,0,11,14,3704820,4836,0,0,777
105,7,0,12,13,3735600,4838,0,0,784
106,13,0,13,12,3789120,4833,0,0,797
107,9,0,16,9,3814560,4828,0,0,806
108,11,0,17,8,3865260,4831,0,0,817
109,8,0,13,12,3928320,4837,0,0,825
110,9,0,14,11,3970680,4842,0,0,834
111,14,0,17,8,4026300,4845,0,0,848
112,15,0,17,8,4088400,4832,0,0,863
113,11,0,13,12,4168380,4841,0,0,874
114,9,0,15,10,4198800,4837,0,0,883
115,9,0,13,12,4257540,4843,0,0,892
116,6,0,9,16,4306080,4843,0,0,898
117,5,0,5,20,4347900,4841,0,0,903
118,4,0,6,19,4355760,4834,0,0,907
119,9,0,12,13,4369920,4833,0,0,916
120,5,0,8,17,4414260,4834,0,0,921
121,4,0,3,22,4460760,4838,0,0,925
122,7,0,9,16,4466760,4839,0,0,932
123,10,0,11,14,4502340,4836,0,0,942
124,4,0,5,20,4544520,4829,0,0,946
125,3,0,4,21,4564320,4829,0,0,949
126,6,0,5,20,4579620,4820,0,0,955
127,6,0,6,19,4599840,4816,0,0,961
128,9,0,9,16,4623420,4811,0,0,970
129,7,0,13,12,4637880,4811,0,0,977
130,14,0,18,7,4683300,4813,0,0,991
131,13,0,18,7,4742460,4809,0,0,1004
132,17,0,16,9,4835640,4811,0,0,1021
133,9,0,15,10,4879260,4807,0,0,1030
134,9,0,15,10,4928340,4812,0,0,1039
135,9,0,10,15,5004240,4821,0,0,1048
136,10,0,13,12,5038080,4821,0,0,1058
137,4,0,9,16,5077980,4822,0,0,1062
138,10,0,10,15,5121780,4822,0,0,1072
139,8,0,10,15,5156340,4819,0,0,1080
140,11,0,14,11,5180940,4810,0,0,1091
141,4,0,7,18,5231280,4808,0,0,1095
142,4,0,7,18,5251020,4808,0,0,1099
143,3,0,5,20,5277540,4810,0,0,1102
144,9,0,10,15,5295360,4809,0,0,1111
145,4,0,7,18,5324880,4805,0,0,1115
146,1,0,3,22,5357160,4813,0,0,1116
147,8,0,7,18,5378700,4815,0,0,1124
148,4,0,8,17,5394780,4816,0,0,1128
149,10,0,9,16,5442240,4820,0,0,1138
150,4,0,9,16,5455440,4815,0,0,1142
151,3,0,5,20,5493420,4818,0,0,1145
152,8,0,9,16,5506020,4812,0,0,1153
153,7,0,9,16,5539380,4812,0,0,1160
154,12,0,15,10,5567520,4812,0,0,1172
155,15,0,19,6,5621760,4813,0,0,1187
156,12,0,20,5,5677680,4815,0,0,1199
157,13,0,16,9,5764560,4819,0,0,1212
158,9,0,12,13,5825040,4818,0,0,1221
159,8,0,11,14,5869800,4819,0,0,1229
160,7,0,12,13,5901540,4821,0,0,1236
161,16,0,15,10,5956320,4815,0,0,1252
162,6,0,12,13,6005100,4819,0,0,1258
163,8,0,9,16,6066600,4826,0,0,1266
164,5,0,8,17,6085620,4818,0,0,1271
165,8,0,10,15,6120420,4823,0,0,1279
166,8,0,9,16,6159780,4819,0,0,1287
167,5,0,8,17,6181260,4814,0,0,1292
168,5,0,6,19,6221700,4819,0,0,1297
169,5,0,6,19,6241440,4815,0,0,1302
170,10,0,12,13,6260160,4815,0,0,1312
171,4,0,8,17,6299100,4815,0,0,1316
172,6,0,8,17,6337800,4823,0,0,1322
173,10,0,15,10,6359880,4829,0,0,1332
174,13,0,19,6,6402540,4828,0,0,1345
175,12,0,17,8,6478020,4834,0,0,1357
176,7,0,14,11,6540060,4844,0,0,1364
177,4,0,6,19,6608100,4851,0,0,1368
178,8,0,9,16,6630480,4850,0,0,1376
179,10,0,10,15,6665160,4843,0,0,1386
180,7,0,10,15,6683580,4832,0,0,1393
181,9,0,13,12,6711120,4831,0,0,1402
182,9,0,17,8,6743640,4837,0,0,1411
183,12,0,13,12,6819120,4836,0,0,1423
184,7,0,12,13,6856980,4835,0,0,1430
185,15,0,16,9,6910380,4835,0,0,1445
186,8,0,18,7,6935100,4832,0,0,1453
187,9,0,13,12,7008060,4836,0,0,1462
188,7,0,9,16,7063320,4837,0,0,1469
189,14,0,17,8,7088940,4835,0,0,1483
190,8,0,12,13,7156140,4838,0,0,1491
191,8,0,10,15,7212360,4843,0,0,1499
192,7,0,10,15,7240740,4840,0,0,1506
193,7,0,10,15,7279500,4843,0,0,1513
194,12,0,12,13,7319400,4837,0,0,1525
195,9,0,13,12,7357200,4837,0,0,1534
196,8,0,7,18,7410480,4827,0,0,1542
197,4,0,9,16,7418460,4826,0,0,1546
198,2,0,3,22,7463520,4830,0,0,1548
199,5,0,7,18,7469340,4831,0,0,1553
200,5,0,6,19,7497000,4830,0,0,1558
201,13,0,15,10,7515540,4830,0,0,1571
202,2,0,8,17,7559520,4830,0,0,1573
203,15,0,16,9,7601220,4835,0,0,1588
204,8,0,10,15,7661220,4830,0,0,1596
205,10,0,12,13,7697100,4828,0,0,1606
206,11,0,13,12,7740600,4825,0,0,1617
207,13,0,18,7,7780440,4826,0,0,1630
208,11,0,14,11,7849560,4824,0,0,1641
209,11,0,13,12,7903140,4821,0,0,1652
210,8,0,9,16,7951440,4816,0,0,1660
211,9,0,13,12,7975620,4816,0,0,1669
212,12,0,12,13,8037960,4816,0,0,1681
213,9,0,13,12,8072160,4813,0,0,1690
214,8,0,14,11,8104380,4812,0,0,1698
215,5,0,5,20,8183640,4819,0,0,1703
216,4,0,5,20,8197980,4816,0,0,1707
217,5,0,5,20,8219460,4815,0,0,1712
218,4,0,7,18,8233080,4817,0,0,1716
219,3,0,2,23,8269260,4816,0,0,1719
220,4,0,4,21,8284500,4819,0,0,1723
221,5,0,8,17,8288100,4818,0,0,1728
222,5,0,9,16,8304420,4816,0,0,1733
223,11,0,10,15,8355780,4818,0,0,1744
224,6,0,7,18,8393220,4815,0,0,1750
225,9,0,9,16,8414100,4808,0,0,1759
226,7,0,8,17,8461680,4813,0,0,1766
227,10,0,12,13,8489700,4812,0,0,1776
228,11,0,16,9,8517180,4809,0,0,1787
229,13,0,17,8,8566800,4804,0,0,1800
230,10,0,14,11,8617740,4798,0,0,1810
231,12,0,12,13,8696880,4804,0,0,1822
232,12,0,15,10,8736420,4802,0,0,1834
233,10,0,13,12,8798640,4805,0,0,1844
234,11,0,13,12,8838540,4798,0,0,1855
235,10,0,14,11,8883600,4799,0,0,1865
236,3,0,9,16,8929620,4803,0,0,1868
237,14,0,17,8,8955900,4802,0,0,1882
238,5,0,10,15,9019260,4805,0,0,1887
239,6,0,9,16,9054000,4805,0,0,1893
240,4,0,7,18,9087840,4808,0,0,1897
241,6,0,6,19,9125040,4810,0,0,1903
242,3,0,5,20,9143460,4809,0,0,1906
243,5,0,6,19,9157920,4807,0,0,1911
244,6,0,7,18,9175260,4803,0,0,1917
245,6,0,8,17,9198840,4803,0,0,1923
246,6,0,10,15,9223140,4806,0,0,1929
247,6,0,7,18,9265860,4805,0,0,1935
248,5,0,7,18,9290100,4806,0,0,1940
249,11,0,12,13,9314640,4803,0,0,1951
250,10,0,16,9,9344640,4804,0,0,1961
251,7,0,13,12,9391800,4803,0,0,1968
252,6,0,7,18,9459180,4808,0,0,1974
253,11,0,13,12,9486300,4810,0,0,1985
254,13,0,18,7,9526140,4811,0,0,1998
255,8,0,14,11,9581640,4810,0,0,2006
256,14,0,16,9,9634680,4807,0,0,2020
257,11,0,13,12,9693660,4803,0,0,2031
258,7,0,12,13,9735660,4805,0,0,2038
259,8,0,8,17,9793500,4805,0,0,2046
260,8,0,6,19,9823800,4796,0,0,2054
261,3,0,4,21,9847620,4796,0,0,2057
262,7,0,8,17,9865800,4798,0,0,2064
263,8,0,9,16,9896040,4796,0,0,2072
264,7,0,11,14,9917100,4795,0,0,2079
265,8,0,8,17,9960720,4791,0,0,2087
266,7,0,9,16,9991440,4792,0,0,2094
267,3,0,6,19,10021980,4792,0,0,2097
268,6,0,9,16,10037820,4793,0,0,2103
269,2,0,1,24,10090560,4795,0,0,2105
270,5,0,6,19,10090560,4795,0,0,2110
271,10,0,11,14,10113300,4795,0,0,2120
272,11,0,16,9,10134240,4791,0,0,2131
273,6,0,9,16,10199700,4793,0,0,2137
274,9,0,10,15,10235160,4791,0,0,2146
275,13,0,14,11,10274100,4789,0,0,2159
276,8,0,12,13,10315200,4786,0,0,2167
277,7,0,9,16,10360680,4785,0,0,2174
278,11,0,14,11,10391700,4786,0,0,2185
279,11,0,15,10,10431660,4782,0,0,2196
280,12,0,17,8,10482720,4784,0,0,2208
281,7,0,11,14,10552680,4787,0,0,2215
282,13,0,15,10,10590300,4785,0,0,2228
283,5,0,9,16,10635480,4782,0,0,2233
284,6,0,6,19,10679880,4782,0,0,2239
285,5,0,6,19,10697460,4779,0,0,2244
286,3,0,6,19,10709880,4779,0,0,2247
287,8,0,9,16,10743840,4783,0,0,2255
288,5,0,9,16,10767900,4783,0,0,2260
289,8,0,11,14,10794840,4782,0,0,2268
290,3,0,9,16,10813800,4780,0,0,2271
291,2,0,5,20,10855320,4786,0,0,2273
292,5,0,6,19,10886940,4791,0,0,2278
293,4,0,4,21,10913280,4790,0,0,2282
294,2,0,3,22,10923240,4788,0,0,2284
295,8,0,9,16,10937760,4790,0,0,2292
296,10,0,14,11,10952520,4786,0,0,2302
297,17,0,21,4,11007240,4789,0,0,2319
298,13,0,18,7,11070720,4784,0,0,2332
299,6,0,13,12,11138040,4790,0,0,2338
300,9,0,12,13,11192520,4793,0,0,2347
301,8,0,10,15,11232060,4789,0,0,2355
302,13,0,18,7,11260740,4791,0,0,2368
303,13,0,22,3,11294640,4787,0,0,2381
304,11,0,18,7,11375100,4791,0,0,2392
305,10,0,12,13,11461080,4795,0,0,2402
306,8,0,13,12,11494500,4795,0,0,2410
307,5,0,8,17,11539800,4794,0,0,2415
308,8,0,6,19,11585640,4793,0,0,2423
309,14,0,16,9,11600100,4791,0,0,2437
310,2,0,9,16,11639640,4789,0,0,2439
311,8,0,6,19,11694060,4790,0,0,2447
312,5,0,7,18,11708580,4788,0,0,2452
313,2,0,4,21,11731020,4788,0,0,2454
314,1,0,1,24,11758020,4791,0,0,2455
315,6,0,5,20,11762340,4789,0,0,2461
316,9,0,11,14,11774940,4788,0,0,2470
317,8,0,13,12,11801520,4787,0,0,2478
318,6,0,11,14,11844840,4789,0,0,2484
319,14,0,16,9,11884800,4788,0,0,2498
320,8,0,13,12,11932860,4786,0,0,2506
321,9,0,10,15,11990640,4786,0,0,2515
322,14,0,18,7,12012720,4784,0,0,2529
323,8,0,14,11,12063420,4781,0,0,2537
324,8,0,13,12,12106500,4781,0,0,2545
325,9,0,15,10,12151620,4785,0,0,2554
326,12,0,17,8,12210120,4790,0,0,2566
327,13,0,16,9,12272040,4788,0,0,2579
328,9,0,14,11,12333000,4791,0,0,2588
329,10,0,13,12,12388560,4792,0,0,2598
330,12,0,16,9,12427200,4790,0,0,2610
331,7,0,10,15,12485700,4789,0,0,2617
332,6,0,7,18,12523560,4787,0,0,2623
333,7,0,8,17,12552780,4787,0,0,2630
334,10,0,13,12,12580620,4788,0,0,2640
335,7,0,10,15,12626160,4788,0,0,2647
336,9,0,15,10,12648240,4789,0,0,2656
337,4,0,9,16,12698220,4789,0,0,2660
338,4,0,6,19,12736500,4791,0,0,2664
339,7,0,8,17,12757860,4790,0,0,2671
340,2,0,4,21,12788820,4791,0,0,2673
341,5,0,7,18,12798960,4791,0,0,2678
342,10,0,12,13,12821040,4791,0,0,2688
343,13,0,17,8,12856080,4789,0,0,2701
344,5,0,9,16,12911280,4787,0,0,2706
345,7,0,7,18,12958260,4788,0,0,2713
346,12,0,13,12,12987300,4788,0,0,2725
347,11,0,13,12,13031760,4785,0,0,2736
348,12,0,11,14,13090860,4782,0,0,2748
349,11,0,11,14,13126680,4776,0,0,2759
350,6,0,10,15,13166520,4779,0,0,2765
351,7,0,9,16,13200540,4777,0,0,2772
352,10,0,13,12,13231860,4778,0,0,2782
353,1,0,5,20,13278300,4779,0,0,2783
354,4,0,5,20,13306080,4782,0,0,2787
355,13,0,13,12,13322280,4780,0,0,2800
356,6,0,11,14,13353300,4777,0,0,2806
357,4,0,6,19,13400760,4779,0,0,2810
358,3,0,5,20,13423080,4780,0,0,2813
359,5,0,8,17,13432500,4780,0,0,2818
360,5,0,6,19,13460940,4778,0,0,2823
361,5,0,4,21,13496220,4779,0,0,2828
362,2,0,3,22,13513740,4780,0,0,2830
363,6,0,6,19,13524720,4779,0,0,2836
364,7,0,7,18,13549500,4777,0,0,2843
365,7,0,10,15,13564320,4776,0,0,2850
366,0,0,3,22,13597620,4776,0,0,2850
367,6,0,6,19,13619220,4778,0,0,2856
368,11,0,13,12,13631220,4776,0,0,2867
369,8,0,14,11,13665000,4776,0,0,2875
370,7,0,12,13,13708200,4776,0,0,2882
371,11,0,16,9,13747500,4778,0,0,2893
372,8,0,11,14,13802820,4776,0,0,2901
373,15,0,18,7,13845360,4777,0,0,2916
374,15,0,22,3,13890660,4775,0,0,2931
375,9,0,14,11,13969980,4774,0,0,2940
376,22,0,20,5,14031720,4769,0,0,2962
377,5,0,13,12,14084280,4767,0,0,2967
378,9,0,11,14,14144040,4770,0,0,2976
379,2,0,7,18,14169060,4769,0,0,2978
380,5,0,4,21,14209260,4769,0,0,2983
381,6,0,6,19,14226900,4769,0,0,2989
382,7,0,7,18,14248980,4767,0,0,2996
383,5,0,6,19,14275200,4766,0,0,3001
384,8,0,8,17,14294520,4763,0,0,3009
385,4,0,8,17,14317800,4764,0,0,3013
386,4,0,7,18,14348400,4766,0,0,3017
387,3,0,6,19,14366100,4766,0,0,3020
388,4,0,6,19,14391960,4768,0,0,3024
389,5,0,5,20,14418000,4767,0,0,3029
390,11,0,12,13,14435100,4767,0,0,3040
391,13,0,15,10,14471880,4763,0,0,3053
392,12,0,16,9,14516520,4761,0,0,3065
393,8,0,12,13,14571780,4760,0,0,3073
394,11,0,12,13,14623260,4760,0,0,3084
395,8,0,11,14,14664300,4759,0,0,3092
396,6,0,10,15,14699340,4760,0,0,3098
397,11,0,12,13,14740860,4759,0,0,3109
398,19,0,21,4,14788800,4759,0,0,3128
399,9,0,17,8,14841120,4756,0,0,3137
400,13,0,16,9,14912640,4758,0,0,3150
401,8,0,11,14,14982480,4760,0,0,3158
402,10,0,12,13,15027240,4761,0,0,3168
403,6,0,8,17,15066180,4758,0,0,3174
404,2,0,4,21,15099240,4760,0,0,3176
405,5,0,7,18,15109140,4760,0,0,3181
406,5,0,7,18,15139260,4762,0,0,3186
407,7,0,9,16,15160860,4761,0,0,3193
408,10,0,13,12,15184260,4759,0,0,3203
409,3,0,8,17,15224880,4760,0,0,3206
410,8,0,8,17,15260640,4760,0,0,3214
411,4,0,7,18,15284040,4759,0,0,3218
412,3,0,5,20,15308460,4760,0,0,3221
413,2,0,5,20,15324240,4762,0,0,3223
414,10,0,11,14,15344400,4762,0,0,3233
415,3,0,8,17,15371520,4761,0,0,3236
416,6,0,7,18,15411360,4763,0,0,3242
417,12,0,14,11,15435480,4764,0,0,3254
418,14,0,15,10,15484020,4759,0,0,3268
419,9,0,12,13,15529620,4756,0,0,3277
420,8,0,12,13,15569100,4756,0,0,3285
421,12,0,12,13,15626520,4756,0,0,3297
422,7,0,12,13,15662160,4757,0,0,3304
423,12,0,15,10,15702540,4756,0,0,3316
424,6,0,9,16,15760500,4757,0,0,3322
425,4,0,7,18,15800580,4760,0,0,3326
426,8,0,11,14,15823560,4761,0,0,3334
427,6,0,10,15,15858420,4762,0,0,3340
428,6,0,7,18,15899100,4761,0,0,3346
429,8,0,9,16,15925500,4760,0,0,3354
430,7,0,7,18,15960540,4758,0,0,3361
431,6,0,9,16,15979320,4758,0,0,3367
432,3,0,5,20,16011600,4758,0,0,3370
433,4,0,5,20,16028880,4757,0,0,3374
434,5,0,6,19,16047180,4757,0,0,3379
435,5,0,4,21,16068780,4754,0,0,3384
436,2,0,4,21,16075560,4753,0,0,3386
437,7,0,7,18,16096980,4753,0,0,3393
438,9,0,12,13,16109100,4751,0,0,3402
439,5,0,11,14,16141680,4753,0,0,3407
440,5,0,8,17,16188720,4755,0,0,3412
441,8,0,9,16,16218540,4754,0,0,3420
442,11,0,14,11,16243200,4753,0,0,3431
443,14,0,20,5,16278660,4752,0,0,3445
444,13,0,15,10,16355340,4750,0,0,3458
445,6,0,8,17,16416660,4750,0,0,3464
446,13,0,13,12,16454340,4750,0,0,3477
447,11,0,15,10,16485540,4746,0,0,3488
448,14,0,20,5,16530060,4747,0,0,3502
449,17,0,22,3,16591440,4744,0,0,3519
450,10,0,13,12,16682880,4744,0,0,3529
451,8,0,13,12,16727160,4746,0,0,3537
452,9,0,12,13,16784640,4749,0,0,3546
453,6,0,10,15,16829040,4751,0,0,3552
454,7,0,10,15,16862520,4751,0,0,3559
455,5,0,8,17,16896120,4751,0,0,3564
456,8,0,9,16,16937160,4753,0,0,3572
457,7,0,7,18,16972260,4751,0,0,3579
458,4,0,7,18,16985220,4749,0,0,3583
459,2,0,4,21,17022420,4753,0,0,3585
460,10,0,10,15,17043240,4754,0,0,3595
461,10,0,14,11,17066100,4752,0,0,3605
462,13,0,17,8,17116380,4753,0,0,3618
463,10,0,17,8,17161860,4752,0,0,3628
464,7,0,13,12,17214060,4752,0,0,3635
465,8,0,10,15,17276640,4755,0,0,3643
466,12,0,15,10,17306940,4754,0,0,3655
467,9,0,16,9,17351460,4756,0,0,3664
468,13,0,18,7,17408640,4757,0,0,3677
469,8,0,16,9,17449800,4756,0,0,3685
470,8,0,11,14,17524020,4759,0,0,3693
471,12,0,13,12,17579220,4761,0,0,3705
472,6,0,9,16,17628120,4761,0,0,3711
473,11,0,16,9,17647920,4761,0,0,3722
474,3,0,12,13,17691720,4764,0,0,3725
475,7,0,6,19,17766720,4768,0,0,3732
476,4,0,5,20,17781960,4766,0,0,3736
477,4,0,3,22,17806200,4764,0,0,3740
478,5,0,7,18,17812080,4765,0,0,3745
479,6,0,10,15,17821500,4763,0,0,3751
480,6,0,9,16,17866560,4766,0,0,3757
481,6,0,9,16,17890260,4765,0,0,3763
482,5,0,6,19,17925720,4764,0,0,3768
483,4,0,4,21,17958540,4766,0,0,3772
484,19,0,22,3,17961840,4765,0,0,3791
485,10,0,16,9,18030120,4763,0,0,3801
486,8,0,14,11,18086220,4765,0,0,3809
487,8,0,12,13,18136320,4766,0,0,3817
488,11,0,15,10,18181380,4768,0,0,3828
489,11,0,16,9,18233280,4769,0,0,3839
490,12,0,13,12,18303360,4768,0,0,3851
491,12,0,17,8,18343860,4769,0,0,3863
492,6,0,11,14,18408960,4771,0,0,3869
493,8,0,10,15,18449700,4771,0,0,3877
494,4,0,7,18,18484260,4771,0,0,3881
495,7,0,9,16,18509940,4771,0,0,3888
496,10,0,12,13,18542580,4771,0,0,3898
497,8,0,12,13,18577200,4770,0,0,3906
498,7,0,8,17,18629460,4770,0,0,3913
499,6,0,8,17,18650820,4768,0,0,3919
500,9,0,9,16,18693300,4769,0,0,3928
501,5,0,6,19,18719040,4766,0,0,3933
502,6,0,7,18,18736500,4765,0,0,3939
503,3,0,5,20,18770040,4767,0,0,3942
504,8,0,8,17,18795960,4768,0,0,3950
505,7,0,9,16,18816900,4766,0,0,3957
506,3,0,7,18,18847980,4768,0,0,3960
507,4,0,5,20,18875340,4767,0,0,3964
508,4,0,6,19,18891720,4768,0,0,3968
509,6,0,6,19,18919320,4767,0,0,3974
510,5,0,6,19,18935460,4766,0,0,3979
511,5,0,7,18,18954900,4766,0,0,3984
512,8,0,9,16,18982260,4765,0,0,3992
513,5,0,8,17,19004100,4764,0,0,3997
514,7,0,8,17,19033560,4763,0,0,4004
515,11,0,9,16,19065360,4759,0,0,4015
516,11,0,13,12,19095960,4758,0,0,4026
517,13,0,17,8,19138080,4758,0,0,4039
518,5,0,10,15,19203060,4760,0,0,4044
519,8,0,7,18,19254360,4760,0,0,4052
520,18,0,22,3,19260120,4757,0,0,4070
521,10,0,18,7,19331340,4759,0,0,4080
522,9,0,12,13,19404540,4759,0,0,4089
523,8,0,10,15,19463340,4762,0,0,4097
524,11,0,16,9,19486080,4761,0,0,4108
525,9,0,14,11,19530540,4760,0,0,4117
526,3,0,8,17,19582560,4762,0,0,4120
527,4,0,5,20,19625820,4764,0,0,4124
528,2,0,3,22,19647600,4765,0,0,4126
529,6,0,6,19,19665180,4766,0,0,4132
530,8,0,8,17,19682640,4763,0,0,4140
531,8,0,7,18,19716060,4761,0,0,4148
532,9,0,11,14,19731780,4759,0,0,4157
533,5,0,7,18,19777320,4759,0,0,4162
534,6,0,10,15,19788540,4759,0,0,4168
535,7,0,7,18,19837920,4759,0,0,4175
536,7,0,10,15,19858440,4759,0,0,4182
537,8,0,13,12,19881660,4759,0,0,4190
538,7,0,11,14,19931400,4761,0,0,4197
539,13,0,15,10,19971660,4760,0,0,4210
540,9,0,11,14,20030940,4760,0,0,4219
541,8,0,8,17,20085480,4760,0,0,4227
542,16,0,16,9,20115960,4758,0,0,4243
543,7,0,12,13,20178660,4761,0,0,4250
544,7,0,9,16,20225040,4761,0,0,4257
545,7,0,10,15,20255220,4761,0,0,4264
546,6,0,11,14,20279520,4761,0,0,4270
547,8,0,11,14,20327640,4763,0,0,4278
548,7,0,9,16,20374680,4764,0,0,4285
549,9,0,12,13,20402220,4764,0,0,4294
550,5,0,7,18,20449680,4764,0,0,4299
551,2,0,4,21,20476740,4765,0,0,4301
552,8,0,8,17,20495280,4765,0,0,4309
553,7,0,10,15,20518980,4765,0,0,4316
554,10,0,13,12,20549700,4764,0,0,4326
555,2,0,7,18,20607540,4769,0,0,4328
556,5,0,5,20,20649360,4771,0,0,4333
557,9,0,12,13,20656500,4770,0,0,4342
558,7,0,10,15,20700240,4770,0,0,4349
559,6,0,9,16,20736060,4771,0,0,4355
560,8,0,12,13,20761260,4771,0,0,4363
561,8,0,10,15,20805660,4770,0,0,4371
562,7,0,9,16,20847600,4771,0,0,4378
563,12,0,15,10,20876460,4771,0,0,4390
564,8,0,12,13,20932980,4772,0,0,4398
565,16,0,20,5,20967420,4771,0,0,4414
566,11,0,16,9,21040740,4772,0,0,4425
567,10,0,17,8,21074400,4770,0,0,4435
568,15,0,17,8,21168540,4775,0,0,4450
569,10,0,18,7,21212640,4775,0,0,4460
570,5,0,8,17,21295380,4777,0,0,4465
571,8,0,10,15,21325440,4778,0,0,4473
572,4,0,7,18,21356520,4777,0,0,4477
573,5,0,6,19,21385800,4777,0,0,4482
574,2,0,5,20,21398760,4777,0,0,4484
575,3,0,5,20,21416400,4778,0,0,4487
576,6,0,7,18,21429180,4776,0,0,4493
577,7,0,8,17,21462240,4777,0,0,4500
578,2,0,7,18,21482220,4779,0,0,4502
579,10,0,8,17,21519780,4777,0,0,4512
580,3,0,8,17,21535140,4778,0,0,4515
581,3,0,8,17,21553260,4778,0,0,4518
582,11,0,11,14,21599880,4780,0,0,4529
583,3,0,6,19,21633240,4779,0,0,4532
584,11,0,10,15,21668280,4780,0,0,4543
585,11,0,16,9,21688860,4779,0,0,4554
586,9,0,14,11,21746160,4780,0,0,4563
587,11,0,12,13,21806100,4779,0,0,4574
588,9,0,15,10,21832620,4779,0,0,4583
589,6,0,6,19,21900000,4778,0,0,4589
590,12,0,13,12,21922740,4778,0,0,4601
591,18,0,22,3,21955740,4776,0,0,4619
592,12,0,22,3,22013100,4776,0,0,4631
593,19,1,25,0,22098240,4779,60,0,4650
594,6,0,17,8,22190580,4783,120,0,4656
595,7,0,12,13,22259280,4785,120,0,4663
596,5,0,11,14,22299600,4788,120,0,4668
597,5,0,8,17,22354320,4791,120,0,4673
598,14,0,19,6,22372800,4792,120,0,4687
599,8,0,10,15,22449720,4791,120,0,4695
600,7,0,8,17,22489080,4791,120,0,4702
601,5,0,8,17,22515060,4791,120,0,4707
602,2,0,6,19,22545480,4793,120,0,4709
603,4,0,3,22,22582980,4794,120,0,4713
604,6,0,6,19,22596180,4794,120,0,4719
605,3,0,8,17,22598580,4793,120,0,4722
606,8,0,7,18,22644960,4794,120,0,4730
607,6,0,7,18,22665900,4792,120,0,4736
608,5,0,9,16,22686060,4794,120,0,4741
609,8,0,10,15,22721640,4794,120,0,4749
610,6,0,7,18,22767300,4795,120,0,4755
611,9,0,11,14,22783860,4793,120,0,4764
612,11,0,14,11,22824360,4794,120,0,4775
613,10,0,15,10,22872060,4794,120,0,4785
614,13,0,17,8,22914960,4792,120,0,4798
615,12,0,17,8,22982820,4795,120,0,4810
616,6,0,7,18,23061180,4795,120,0,4816
617,13,0,14,11,23085780,4794,120,0,4829
618,6,0,14,11,23119500,4795,120,0,4835
619,7,0,12,13,23171820,4797,120,0,4842
620,3,0,6,19,23219400,4798,120,0,4845
621,6,0,6,19,23243460,4797,120,0,4851
622,4,0,3,22,23265780,4795,120,0,4855
623,9,0,10,15,23274360,4794,120,0,4864
624,6,0,9,16,23307060,4794,120,0,4870
625,5,0,5,20,23350140,4794,120,0,4875
626,1,0,3,22,23362020,4794,120,0,4876
627,3,0,5,20,23368680,4794,120,0,4879
628,7,0,9,16,23383500,4794,120,0,4886
629,4,0,7,18,23413140,4794,120,0,4890
630,7,0,7,18,23444280,4794,120,0,4897
631,5,0,5,20,23470560,4792,120,0,4902
632,11,0,9,16,23494920,4790,120,0,4913
633,7,0,12,13,23516160,4791,120,0,4920
634,11,0,14,11,23560440,4791,120,0,4931
635,5,0,10,15,23608680,4792,120,0,4936
636,8,0,9,16,23658360,4793,120,0,4944
637,8,0,14,11,23671560,4793,120,0,4952
638,13,0,19,6,23719800,4795,120,0,4965
639,12,0,18,7,23782200,4795,120,0,4977
640,8,0,14,11,23832360,4794,120,0,4985
641,13,0,14,11,23899680,4795,120,0,4998
642,10,0,13,12,23944860,4793,120,0,5008
643,15,0,16,9,24005040,4794,120,0,5023
644,7,0,13,12,24053040,4794,120,0,5030
645,5,0,8,17,24100680,4794,120,0,5035
646,3,0,6,19,24133260,4795,120,0,5038
647,7,0,7,18,24156600,4794,120,0,5045
648,5,0,8,17,24181620,4796,120,0,5050
649,7,0,9,16,24212700,4796,120,0,5057
650,3,0,4,21,24247560,4795,120,0,5060
651,6,0,6,19,24270420,4796,120,0,5066
652,3,0,6,19,24282720,4796,120,0,5069
653,7,0,9,16,24307080,4797,120,0,5076
654,13,0,12,13,24348780,4795,120,0,5089
655,13,0,15,10,24393840,4795,120,0,5102
656,9,0,15,10,24435060,4794,120,0,5111
657,8,0,14,11,24488400,4796,120,0,5119
658,7,0,14,11,24527220,4797,120,0,5126
659,12,0,14,11,24600060,4800,120,0,5138
660,11,0,16,9,24641460,4800,120,0,5149
661,13,0,17,8,24689040,4798,120,0,5162
662,9,0,15,10,24741780,4798,120,0,5171
663,6,0,9,16,24805500,4799,120,0,5177
664,10,0,13,12,24833760,4799,120,0,5187
665,9,0,14,11,24879780,4801,120,0,5196
666,4,0,6,19,24941640,4802,120,0,5200
667,9,0,11,14,24960000,4801,120,0,5209
668,5,0,10,15,24985140,4801,120,0,5214
669,2,0,3,22,25036920,4802,120,0,5216
670,5,0,4,21,25053300,4802,120,0,5221
671,4,0,6,19,25058040,4801,120,0,5225
672,8,0,9,16,25084740,4801,120,0,5233
673,6,0,15,10,25084740,4801,120,0,5239
674,6,0,14,11,25111800,4800,120,0,5245
675,7,0,18,7,25123080,4799,120,0,5252
676,8,0,16,9,25172400,4800,120,0,5260
677,10,0,19,6,25203660,4799,120,0,5270
678,9,0,20,5,25230120,4797,120,0,5279
679,8,0,21,4,25267020,4798,120,0,5287
680,5,0,14,11,25320420,4797,120,0,5292
681,9,0,18,7,25349700,4798,120,0,5301
682,8,0,21,4,25369380,4797,120,0,5309
683,14,0,23,2,25427160,4797,120,0,5323
684,12,1,25,0,25466820,4796,840,0,5335
685,14,0,25,0,25532700,4795,1560,0,5349
686,5,0,21,4,25587960,4798,1560,0,5354
687,4,0,15,10,25640340,4798,1560,0,5358
688,8,0,15,10,25680480,4799,1560,0,5366
689,9,0,21,4,25690080,4798,1560,0,5375
690,9,0,21,4,25732860,4798,1560,0,5384
691,9,0,21,4,25767960,4796,1560,0,5393
692,12,0,21,4,25826880,4796,2040,0,5405
693,5,0,15,10,25884660,4797,2040,0,5410
694,5,0,15,10,25914840,4799,2040,0,5415
695,6,0,16,9,25941180,4799,2040,0,5421
696,5,0,16,9,25968420,4800,2040,0,5426
697,7,0,16,9,25993920,4798,2040,0,5433
698,5,0,15,10,26023200,4798,2040,0,5438
699,5,0,14,11,26053020,4798,2040,0,5443
700,8,0,20,5,26063400,4799,2040,0,5451
701,6,0,16,9,26106000,4798,2040,0,5457
702,7,0,14,11,26139060,4796,2040,0,5464
703,6,0,16,9,26155320,4795,2040,0,5470
704,7,0,20,5,26169240,4795,2040,0,5477
705,14,0,22,3,26228580,4795,2040,0,5491
706,7,0,18,7,26270040,4793,2040,0,5498
707,10,0,18,7,26317380,4793,2040,0,5508
708,3,0,14,11,26344260,4792,2040,0,5511
709,7,0,14,11,26370720,4791,2040,0,5518
710,10,0,20,5,26393460,4791,2040,0,5528
711,12,0,24,1,26425200,4790,2040,0,5540
712,13,5,25,0,26464200,4791,2760,0,5553
713,13,6,25,0,26526720,4792,10440,1,5566
714,9,6,25,0,26586540,4795,16200,2,5575
715,11,6,25,0,26644020,4796,37140,6,5586
716,4,0,22,3,26713440,4797,71580,12,5590
717,11,0,18,7,26786340,4797,72060,12,5601
718,5,0,19,6,26811120,4798,72060,12,5606
719,3,0,13,12,26860080,4799,72060,12,5609
720,7,0,15,10,26881020,4799,72060,12,5616
721,2,0,14,11,26895540,4799,72060,12,5618
722,2,0,11,14,26928960,4801,72060,12,5620
723,8,0,18,7,26935680,4801,72060,12,5628
724,1,0,11,14,26962140,4799,72060,12,5629
725,5,0,14,11,26976180,4800,72060,12,5634
726,7,0,16,9,26997900,4799,72060,12,5641
727,13,0,25,0,27018540,4799,72060,12,5654
728,12,4,25,0,27062700,4800,74580,13,5666
729,12,3,25,0,27127140,4801,84960,14,5678
730,10,0,24,1,27200160,4802,88740,15,5688
731,8,0,23,2,27242520,4802,88740,15,5696
732,8,0,19,6,27306840,4803,88740,15,5704
733,11,0,19,6,27354300,4802,88740,15,5715
734,11,0,22,3,27394980,4802,88740,15,5726
735,7,0,21,4,27434580,4802,89100,15,5733
736,10,0,22,3,27483780,4804,89100,15,5743
737,10,0,19,6,27548340,4804,89100,15,5753
738,12,1,25,0,27573720,4804,89100,15,5765
739,4,0,17,8,27646560,4806,89340,15,5769
740,4,0,11,14,27690360,4805,89340,15,5773
741,2,0,10,15,27708960,4806,89340,15,5775
742,1,0,11,14,27708960,4806,89340,15,5776
743,4,0,13,12,27718200,4806,89340,15,5780
744,4,0,11,14,27743820,4805,89340,15,5784
745,2,0,12,13,27746100,4805,89340,15,5786
746,8,0,17,8,27763680,4805,89340,15,5794
747,3,0,15,10,27782220,4804,89340,15,5797
748,8,0,18,7,27810660,4805,89340,15,5805
749,6,0,18,7,27838320,4805,89340,15,5811
750,11,0,19,6,27884040,4805,89340,15,5822
751,2,0,15,10,27911040,4804,89340,15,5824
752,11,0,16,9,27953760,4803,89340,15,5835
753,10,0,21,4,27974940,4803,89340,15,5845
754,6,0,18,7,28017660,4803,89340,15,5851
755,3,0,14,11,28049580,4803,89340,15,5854
756,10,0,18,7,28081980,4803,89340,15,5864
757,6,0,18,7,28108320,4803,89340,15,5870
758,18,3,25,0,28146360,4803,90420,15,5888
759,9,0,25,0,28197660,4802,97080,16,5897
760,9,0,22,3,28265340,4803,98940,16,5906
761,8,0,18,7,28322700,4803,98940,16,5914
762,5,0,17,8,28357380,4804,98940,16,5919
763,9,0,17,8,28400460,4804,98940,16,5928
764,6,0,18,7,28420080,4803,98940,16,5934
765,10,0,22,3,28452180,4804,98940,16,5944
766,6,0,19,6,28501440,4805,98940,16,5950
767,7,0,17,8,28549740,4806,98940,16,5957
768,6,0,14,11,28584360,4804,98940,16,5963
769,6,0,15,10,28614600,4805,98940,16,5969
770,4,0,17,8,28623960,4805,98940,16,5973
771,4,0,13,12,28661220,4805,98940,16,5977
772,9,0,17,8,28678740,4804,98940,16,5986
773,8,0,17,8,28714020,4804,98940,16,5994
774,10,0,19,6,28748760,4803,98940,16,6004
775,8,0,18,7,28788000,4802,98940,16,6012
776,6,0,18,7,28818720,4803,98940,16,6018
777,3,0,14,11,28856700,4803,98940,16,6021
778,10,0,20,5,28872780,4803,98940,16,6031
779,13,0,25,0,28908780,4802,98940,16,6044
780,12,2,25,0,28954140,4802,104400,17,6056
781,19,13,25,0,29009280,4805,109260,17,6075
782,8,12,25,0,29057280,4806,129300,21,6083
783,8,8,25,0,29141100,4810,173580,28,6091
784,4,2,25,0,29202000,4812,210960,34,6095
785,13,0,22,3,29276220,4810,238620,39,6108
786,10,0,25,0,29311320,4810,238620,39,6118
787,9,0,21,4,29374620,4810,239400,39,6127
788,8,0,17,8,29437680,4811,239400,39,6135
789,8,0,19,6,29459460,4810,239400,38,6143
790,4,0,16,9,29495700,4810,239400,38,6147
791,8,0,18,7,29525340,4811,239400,38,6155
792,3,0,14,11,29556060,4810,239400,38,6158
793,4,0,14,11,29581920,4811,239400,38,6162
794,6,0,17,8,29595120,4811,239400,38,6168
795,6,0,16,9,29631300,4811,239400,38,6174
796,6,0,17,8,29650200,4811,239400,38,6180
797,10,0,22,3,29681280,4812,239400,38,6190
798,7,0,18,7,29736120,4812,239400,38,6197
799,5,0,16,9,29773380,4813,239400,38,6202
800,7,0,15,10,29803440,4811,239400,38,6209
801,7,0,17,8,29826840,4811,239400,38,6216
802,12,0,23,2,29862780,4812,239400,38,6228
803,15,0,23,2,29920860,4810,241500,38,6243
804,15,0,25,0,29974080,4808,244800,39,6258
805,9,1,25,0,30022320,4810,247140,39,6267
806,10,0,21,4,30095340,4810,248220,39,6277
807,10,1,25,0,30124140,4811,249060,39,6287
808,9,0,20,5,30205620,4812,249120,39,6296
809,9,0,20,5,30240540,4811,249120,39,6305
810,9,0,19,6,30288300,4811,249120,39,6314
811,6,0,16,9,30330540,4811,249120,39,6320
812,8,0,16,9,30363660,4810,249120,39,6328
813,5,0,15,10,30392460,4810,249120,39,6333
814,6,0,15,10,30426900,4811,249120,39,6339
815,3,0,14,11,30446700,4811,249120,39,6342
816,4,0,14,11,30468600,4811,249120,39,6346
817,8,0,18,7,30490020,4812,249120,39,6354
818,9,0,17,8,30525600,4810,249120,39,6363
819,4,0,15,10,30557100,4810,249120,39,6367
820,10,0,17,8,30587040,4809,249120,39,6377
821,4,0,16,9,30607500,4808,249120,39,6381
822,9,0,18,7,30642840,4808,249120,38,6390
823,8,0,19,6,30680580,4809,249120,38,6398
824,8,0,16,9,30727140,4808,249120,38,6406
825,9,0,18,7,30753240,4807,249120,38,6415
826,12,0,25,0,30782100,4808,249120,38,6427
827,11,1,25,0,30829740,4808,249180,38,6438
828,5,0,18,7,30904080,4809,249540,38,6443
829,12,0,22,3,30941280,4809,249540,38,6455
830,9,0,24,1,30973440,4809,249540,38,6464
831,14,4,25,0,31018500,4809,249540,38,6478
832,9,3,25,0,31071240,4810,256440,39,6487
833,7,0,24,1,31147260,4814,265740,40,6494
834,8,0,20,5,31211340,4815,267180,41,6502
835,8,0,19,6,31261980,4816,267180,41,6510
836,3,0,13,12,31301340,4815,267180,41,6513
837,5,0,12,13,31333020,4816,267180,40,6518
838,7,0,15,10,31349880,4815,267180,40,6525
839,5,0,14,11,31366560,4813,267180,40,6530
840,8,0,15,10,31389300,4812,267180,40,6538
841,3,0,13,12,31412640,4811,267180,40,6541
842,7,0,17,8,31428180,4812,267180,40,6548
843,7,0,15,10,31463580,4810,267180,40,6555
844,3,0,15,10,31477920,4810,267180,40,6558
845,2,0,11,14,31513140,4811,267180,40,6560
846,4,0,11,14,31529220,4811,267180,40,6564
847,7,0,16,9,31533720,4810,267180,40,6571
848,5,0,15,10,31557480,4809,267180,40,6576
849,7,0,16,9,31582080,4809,267180,40,6583
850,9,0,16,9,31626600,4809,267180,40,6592
851,10,0,19,6,31657920,4809,267180,40,6602
852,4,0,15,10,31693020,4808,267180,40,6606
853,13,0,23,2,31728000,4810,267180,40,6619
854,5,0,15,10,31793940,4810,267180,40,6624
855,13,0,21,4,31825620,4810,267180,40,6637
856,9,0,23,2,31853520,4809,267180,40,6646
857,10,0,24,1,31906200,4810,267180,40,6656
858,12,0,21,4,31976100,4810,267180,40,6668
859,7,0,21,4,32012400,4811,267180,40,6675
860,10,0,21,4,32057340,4810,267180,39,6685
861,6,0,20,5,32099760,4811,267180,39,6691
862,11,0,22,3,32144580,4812,267180,39,6702
863,4,0,14,11,32203680,4812,267180,39,6706
864,2,0,10,15,32238840,4813,267180,39,6708
865,4,0,13,12,32244120,4813,267180,39,6712
866,5,0,16,9,32256180,4813,267180,39,6717
867,6,0,16,9,32286060,4813,267180,39,6723
868,6,0,18,7,32307960,4814,267180,39,6729
869,7,0,19,6,32339400,4814,267180,39,6736
870,4,0,14,11,32388660,4815,267180,39,6740
871,3,0,13,12,32410500,4815,267180,39,6743
872,9,0,14,11,32433240,4813,267180,39,6752
873,12,0,22,3,32445960,4812,267180,39,6764
874,10,0,22,3,32490720,4812,267180,39,6774
875,9,0,19,6,32550420,4812,267180,39,6783
876,12,0,24,1,32587080,4812,267180,39,6795
877,9,0,21,4,32640000,4812,267180,39,6804
878,10,0,19,6,32695140,4811,267180,39,6814
879,12,0,23,2,32731200,4811,267180,39,6826
880,5,0,20,5,32774760,4812,267180,39,6831
881,11,0,18,7,32827740,4810,267180,39,6842
882,5,0,14,11,32873640,4811,267180,39,6847
883,9,0,19,6,32891820,4810,267180,38,6856
884,4,0,14,11,32936520,4811,267180,38,6860
885,4,0,15,10,32951280,4811,267180,38,6864
886,4,0,15,10,32981400,4812,267180,38,6868
887,6,0,14,11,33013140,4812,267180,38,6874
888,2,0,11,14,33036300,4812,267180,38,6876
889,7,0,17,8,33042000,4812,267180,38,6883
890,5,0,17,8,33064800,4812,267180,38,6888
891,13,0,22,3,33109440,4813,267180,38,6901
892,10,0,21,4,33156000,4812,267180,38,6911
893,3,0,14,11,33207300,4812,267180,38,6914
894,8,0,17,8,33239040,4813,267180,38,6922
895,4,0,14,11,33261600,4812,267180,38,6926
896,8,0,16,9,33295800,4812,267180,38,6934
897,13,0,22,3,33326580,4812,267720,38,6947
898,8,0,22,3,33370680,4813,267720,38,6955
899,6,0,21,4,33408660,4813,267720,38,6961
900,11,0,23,2,33451140,4813,267720,38,6972
901,9,0,24,1,33491340,4814,267720,38,6981
902,16,7,25,0,33547620,4816,270540,38,6997
903,6,3,25,0,33606660,4818,295800,42,7003
904,6,0,20,5,33677220,4818,298260,42,7009
905,10,0,19,6,33730620,4818,298260,42,7019
906,9,0,20,5,33769500,4818,298260,42,7028
907,6,0,17,8,33813360,4818,298260,42,7034
908,3,0,15,10,33844980,4819,298260,42,7037
909,13,0,20,5,33883980,4819,298260,42,7050
910,6,0,16,9,33919800,4818,298260,42,7056
911,10,0,23,2,33933660,4818,298260,42,7066
912,3,0,16,9,33978780,4817,298260,42,7069
913,4,0,13,12,34025700,4819,298260,42,7073
914,2,0,10,15,34053060,4819,298260,42,7075
915,3,0,12,13,34058040,4819,298260,42,7078
916,7,0,15,10,34074540,4819,298260,42,7085
917,10,0,19,6,34097160,4818,298260,42,7095
918,11,2,25,0,34114140,4819,299160,42,7106
919,8,0,23,2,34181880,4820,299820,42,7114
920,8,0,22,3,34224120,4820,299820,42,7122
921,6,0,15,10,34295880,4821,299820,42,7128
922,7,0,12,13,34333980,4820,299820,42,7135
923,10,0,18,7,34351920,4819,299820,41,7145
924,9,0,20,5,34373280,4818,299820,41,7154
925,8,0,19,6,34412880,4817,299820,41,7162
926,11,0,22,3,34452900,4817,299820,41,7173
927,13,1,25,0,34497900,4818,302340,42,7186
928,14,2,25,0,34555560,4817,306300,42,7200
929,10,0,23,2,34621080,4817,308340,42,7210
930,9,0,19,6,34676640,4816,308340,42,7219
931,6,0,15,10,34721400,4815,308340,42,7225
932,10,0,20,5,34739700,4814,308340,42,7235
933,4,0,16,9,34778340,4814,308340,42,7239
934,7,0,17,8,34813080,4815,308340,42,7246
935,7,0,18,7,34845000,4816,308340,42,7253
936,6,0,19,6,34872360,4816,308340,42,7259
937,3,0,14,11,34918620,4817,308340,42,7262
938,4,0,14,11,34939920,4817,308340,42,7266
939,8,0,17,8,34968480,4818,308340,42,7274
940,3,0,19,6,34972800,4818,308340,42,7277
941,7,0,18,7,35021580,4819,308340,42,7284
942,6,0,16,9,35048580,4818,308340,42,7290
943,4,0,15,10,35080200,4819,308340,42,7294
944,12,0,23,2,35104380,4820,308340,42,7306
945,8,0,17,8,35162100,4818,308700,42,7314
946,14,0,25,0,35190900,4818,309060,42,7328
947,7,0,21,4,35244720,4818,309060,42,7335
948,13,0,24,1,35290560,4818,309060,42,7348
949,13,0,21,4,35359560,4817,310440,42,7361
950,13,1,25,0,35399280,4817,310440,42,7374
951,9,0,23,2,35460180,4817,312480,42,7383
952,10,0,20,5,35520780,4817,312480,42,7393
953,9,0,22,3,35557500,4818,312480,42,7402
954,9,0,22,3,35602740,4818,312960,42,7411
955,6,0,20,5,35653860,4820,312960,42,7417
956,7,0,16,9,35703840,4819,312960,42,7424
957,8,0,18,7,35734260,4819,312960,42,7432
958,4,0,15,10,35772660,4820,312960,42,7436
959,6,0,15,10,35808120,4821,312960,42,7442
960,6,0,15,10,35837640,4821,312960,42,7448
961,5,0,14,11,35864880,4821,312960,41,7453
962,4,0,13,12,35882640,4820,312960,41,7457
963,6,0,14,11,35898960,4819,312960,41,7463
964,8,0,19,6,35915580,4819,312960,41,7471
965,7,0,18,7,35958540,4820,312960,41,7478
966,11,0,23,2,35992620,4820,312960,41,7489
967,2,0,15,10,36045480,4821,312960,41,7491
968,5,0,12,13,36086580,4821,312960,41,7496
969,7,0,17,8,36094440,4821,312960,41,7503
970,15,0,22,3,36127440,4819,312960,41,7518
971,12,0,25,0,36166800,4819,319800,42,7530
972,9,0,23,2,36222900,4819,319920,42,7539
973,17,1,25,0,36280140,4818,321540,42,7556
974,9,0,24,1,36334740,4818,322440,42,7565
975,12,0,20,5,36400620,4816,322440,42,7577
976,7,0,19,6,36438540,4816,322440,42,7584
977,7,0,19,6,36473640,4816,322440,42,7591
978,7,0,15,10,36528780,4817,322440,42,7598
979,11,0,23,2,36545820,4817,322440,42,7609
980,7,0,19,6,36595860,4817,322440,42,7616
981,3,0,13,12,36639900,4817,322440,42,7619
982,6,0,16,9,36648060,4816,322440,42,7625
983,5,0,14,11,36678480,4815,322440,42,7630
984,4,0,13,12,36703500,4816,322440,42,7634
985,5,0,13,12,36721260,4815,322440,42,7639
986,5,0,15,10,36734460,4815,322440,42,7644
987,7,0,16,9,36760140,4814,322440,42,7651
988,5,0,15,10,36794220,4815,322440,42,7656
989,12,0,22,3,36816480,4815,322440,42,7668
990,10,0,19,6,36880620,4815,322440,41,7678
991,3,0,14,11,36910620,4814,322440,41,7681
992,9,0,17,8,36940440,4814,322440,41,7690
993,9,0,19,6,36968520,4813,322440,41,7699
994,6,0,17,8,37009260,4813,322440,41,7705
995,14,0,25,0,37037280,4813,323040,41,7719
996,11,1,25,0,37091460,4814,330720,42,7730
997,7,0,20,5,37150140,4814,330780,42,7737
998,11,0,22,3,37195020,4814,330780,42,7748
999,8,0,20,5,37246980,4814,330780,42,7756
1000,11,0,24,1,37282260,4814,330780,42,7767
1001,4,0,15,10,37340520,4814,330780,42,7771
1002,8,0,18,7,37371360,4815,330780,42,7779
1003,8,0,18,7,37409280,4815,330780,42,7787
1004,7,0,17,8,37438500,4814,330780,42,7794
1005,11,0,23,2,37463280,4814,330780,42,7805
1006,1,0,13,12,37518000,4814,330780,42,7806
1007,6,0,15,10,37543500,4815,330780,42,7812
1008,2,0,14,11,37557240,4815,330780,42,7814
1009,6,0,15,10,37577280,4814,330780,42,7820
1010,8,0,14,11,37610760,4813,330780,42,7828
1011,4,0,13,12,37634700,4813,330780,42,7832
1012,6,0,13,12,37668060,4813,330780,42,7838
1013,2,0,10,15,37689180,4813,330780,42,7840
1014,10,0,18,7,37698480,4813,330780,42,7850
1015,5,0,17,8,37720980,4812,330780,42,7855
1016,9,0,19,6,37758000,4813,330780,42,7864
1017,9,0,20,5,37801560,4813,330780,42,7873
1018,13,0,25,0,37839180,4813,330840,41,7886
1019,7,0,23,2,37888080,4814,331740,42,7893
1020,10,0,21,4,37953900,4815,331740,41,7903
1021,10,0,20,5,37999560,4814,331740,41,7913
1022,11,0,20,5,38052120,4814,331740,41,7924
1023,11,0,25,0,38079720,4814,331740,41,7935
1024,10,0,19,6,38156160,4814,331740,41,7945
1025,12,0,20,5,38192820,4811,331740,41,7957
1026,15,3,25,0,38227500,4812,333360,41,7972
1027,11,1,25,0,38298600,4813,348780,43,7983
1028,5,0,20,5,38343360,4812,350760,43,7988
1029,9,0,18,7,38391540,4811,350760,43,7997
1030,9,0,18,7,38450400,4813,350760,43,8006
1031,6,0,15,10,38484660,4812,350760,43,8012
1032,8,0,16,9,38514540,4811,350760,43,8020
1033,3,0,11,14,38554200,4812,350760,43,8023
1034,6,0,15,10,38564040,4812,350760,43,8029
1035,4,0,16,9,38576460,4811,350760,43,8033
1036,9,0,17,8,38619180,4812,350760,43,8042
1037,5,0,19,6,38635500,4812,350760,43,8047
1038,5,0,14,11,38685600,4812,350760,43,8052
1039,6,0,15,10,38702280,4811,350760,43,8058
1040,12,0,23,2,38717940,4811,350760,43,8070
1041,10,0,18,7,38779560,4810,350760,43,8080
1042,8,0,18,7,38811540,4809,350760,43,8088
1043,12,0,21,4,38850240,4808,350760,43,8100
1044,4,0,18,7,38888160,4809,350760,43,8104
1045,13,0,25,0,38918820,4809,350940,43,8117
1046,13,4,25,0,38970840,4810,358740,44,8130
1047,7,0,23,2,39040980,4811,364980,44,8137
1048,10,0,23,2,39098760,4812,364980,44,8147
1049,9,0,24,1,39133980,4812,364980,44,8156
1050,14,0,25,0,39209400,4813,365400,44,8170
1051,12,0,23,2,39261960,4812,365400,44,8182
1052,9,0,22,3,39304920,4811,365400,44,8191
1053,3,0,16,9,39350700,4811,365400,44,8194
1054,5,0,14,11,39399420,4813,365400,44,8199
1055,6,0,16,9,39421080,4813,365400,44,8205
1056,6,0,16,9,39446400,4813,365400,44,8211
1057,5,0,15,10,39472020,4813,365400,44,8216
1058,6,0,14,11,39502860,4812,365400,44,8222
1059,5,0,16,9,39516240,4812,365400,44,8227
1060,6,0,15,10,39555060,4813,365400,44,8233
1061,8,0,20,5,39572160,4813,365400,44,8241
1062,6,0,15,10,39630000,4814,365400,44,8247
1063,12,0,19,6,39654480,4812,365400,44,8259
1064,9,0,19,6,39688500,4811,365400,44,8268
1065,7,0,20,5,39716820,4811,365400,44,8275
1066,12,1,25,0,39745320,4811,365400,44,8287
1067,15,4,25,0,39817740,4812,373800,45,8302
1068,10,5,25,0,39875280,4814,383640,46,8312
1069,16,13,25,0,39925620,4816,390840,46,8328
1070,6,6,25,0,39995160,4816,419880,50,8334
1071,12,6,25,0,40058820,4817,424620,50,8346
1072,8,0,22,3,40128180,4816,502500,60,8354
1073,11,0,24,1,40175640,4816,502500,60,8365
1074,8,0,21,4,40221660,4815,502500,60,8373
1075,7,0,16,9,40289160,4816,502500,59,8380
1076,11,0,20,5,40319100,4816,502500,59,8391
1077,8,0,24,1,40339260,4816,502500,59,8399
1078,4,0,13,12,40423440,4818,502500,59,8403
1079,2,0,11,14,40443720,4818,502500,59,8405
1080,2,0,11,14,40453260,4818,502500,59,8407
1081,3,0,12,13,40461420,4817,502500,59,8410
1082,2,0,12,13,40467360,4817,502500,59,8412
1083,8,0,19,6,40474380,4817,502500,59,8420
1084,6,0,17,8,40516860,4818,502500,59,8426
1085,6,0,18,7,40542360,4818,502500,59,8432
1086,2,0,14,11,40570800,4818,502500,59,8434
1087,6,0,12,13,40606680,4818,502500,59,8440
1088,13,0,18,7,40627560,4816,502500,59,8453
1089,9,0,22,3,40654380,4816,502500,59,8462
1090,6,0,21,4,40686240,4816,502500,59,8468
1091,8,0,16,9,40750020,4816,502500,59,8476
1092,3,0,13,12,40783740,4817,502500,59,8479
1093,10,0,20,5,40801440,4817,502500,59,8489
1094,12,0,25,0,40833000,4817,503040,59,8501
1095,12,0,20,5,40897140,4815,503040,59,8513
1096,7,0,17,8,40942620,4815,503040,59,8520
1097,9,0,17,8,40980000,4814,503040,58,8529
1098,9,0,18,7,41017800,4814,503040,58,8538
1099,9,0,20,5,41042160,4813,503040,58,8547
1100,9,0,19,6,41084520,4812,503040,58,8556
1101,9,0,20,5,41126160,4812,503040,58,8565
1102,3,0,16,9,41157060,4812,503040,58,8568
1103,6,0,14,11,41207280,4813,503040,58,8574
1104,7,0,20,5,41209860,4813,503040,58,8581
1105,7,0,21,4,41240580,4813,503040,58,8588
1106,5,0,15,10,41297220,4814,503040,58,8593
1107,7,0,17,8,41327220,4815,503040,58,8600
1108,5,0,18,7,41351820,4815,503040,58,8605
1109,5,0,17,8,41385240,4816,503040,58,8610
1110,15,0,24,1,41419560,4815,503040,58,8625
1111,6,0,21,4,41452680,4814,503040,58,8631
1112,13,0,21,4,41520060,4815,503040,58,8644
1113,9,0,23,2,41544960,4814,503040,58,8653
1114,6,0,19,6,41605200,4815,503040,58,8659
1115,12,0,25,0,41642640,4816,503040,58,8671
1116,10,0,21,4,41711400,4816,505620,58,8681
1117,10,0,21,4,41762340,4816,505620,58,8691
1118,14,0,24,1,41803080,4815,506460,58,8705
1119,10,0,23,2,41860200,4815,511860,58,8715
1120,14,1,25,0,41923860,4817,512400,58,8729
1121,10,0,25,0,41970960,4816,513000,58,8739
1122,4,0,23,2,42007020,4817,513000,58,8743
1123,10,0,20,5,42080940,4818,513000,58,8753
1124,5,0,19,6,42107820,4818,513000,58,8758
1125,9,0,17,8,42166740,4819,513000,58,8767
1126,4,0,14,11,42192000,4818,513000,58,8771
1127,5,0,15,10,42216600,4818,513000,58,8776
1128,8,0,17,8,42241680,4818,513000,58,8784
1129,4,0,19,6,42249060,4818,513000,58,8788
1130,3,0,12,13,42316260,4820,513000,58,8791
1131,7,0,14,11,42333480,4819,513000,58,8798
1132,6,0,15,10,42355620,4819,513000,58,8804
1133,6,0,16,9,42377700,4818,513000,58,8810
1134,6,0,14,11,42417780,4819,513000,58,8816
1135,5,0,14,11,42442500,4819,513000,58,8821
1136,5,0,16,9,42458280,4819,513000,58,8826
1137,4,0,13,12,42493620,4819,513000,58,8830
1138,7,0,15,10,42510420,4818,513000,58,8837
1139,9,0,20,5,42534360,4819,513000,57,8846
1140,15,0,25,0,42584880,4819,517500,58,8861
1141,12,1,25,0,42635640,4819,517740,58,8873
1142,13,4,25,0,42688500,4819,521700,58,8886
1143,8,0,25,0,42761100,4821,539460,60,8894
1144,16,2,25,0,42822420,4820,544560,61,8910
1145,11,2,25,0,42879600,4821,551760,61,8921
1146,7,0,19,6,42947580,4820,562020,62,8928
1147,7,0,16,9,42992520,4820,562020,62,8935
1148,11,0,18,7,43034160,4820,562020,62,8946
1149,4,0,17,8,43057020,4819,562020,62,8950
1150,7,0,16,9,43099140,4820,562020,62,8957
1151,4,0,12,13,43130760,4819,562020,62,8961
1152,7,0,16,9,43141740,4819,562020,62,8968
1153,6,0,17,8,43162200,4818,562020,62,8974
1154,7,0,19,6,43190460,4819,562020,62,8981
1155,7,0,19,6,43223220,4819,562020,62,8988
1156,4,0,15,10,43273860,4820,562020,62,8992
1157,16,0,24,1,43298040,4819,562140,62,9008
1158,8,0,22,3,43342920,4819,562140,62,9016
1159,6,0,18,7,43392780,4819,562140,62,9022
1160,6,0,17,8,43443900,4821,562140,62,9028
1161,15,0,21,4,43482660,4819,562140,62,9043
1162,8,0,23,2,43507380,4819,562140,62,9051
1163,15,0,24,1,43572060,4818,562140,62,9066
1164,11,0,24,1,43620060,4818,563580,62,9077
1165,10,0,24,1,43663860,4817,563580,62,9087
1166,10,0,22,3,43729080,4818,564780,62,9097
1167,14,0,25,0,43777440,4818,564780,61,9111
1168,11,0,23,2,43836780,4817,572700,62,9122
1169,8,0,17,8,43901400,4817,573000,62,9130
1170,12,0,25,0,43926780,4818,573000,62,9142
1171,10,0,25,0,43981980,4818,575280,62,9152
1172,8,0,21,4,44038860,4818,575280,62,9160
1173,7,0,17,8,44091000,4818,575280,62,9167
1174,6,0,20,5,44110200,4819,575280,62,9173
1175,7,0,19,6,44154960,4819,575280,62,9180
1176,8,0,17,8,44200260,4819,575280,62,9188
1177,5,0,16,9,44232900,4819,575280,62,9193
1178,7,0,17,8,44260200,4819,575280,62,9200
1179,7,0,20,5,44283600,4820,575280,62,9207
1180,8,0,20,5,44325300,4820,575280,62,9215
1181,7,0,18,7,44374560,4821,575280,62,9222
1182,11,0,22,3,44409660,4821,575280,62,9233
1183,9,0,20,5,44458980,4820,575280,62,9242
1184,10,0,22,3,44502780,4821,575280,62,9252
1185,7,0,20,5,44543520,4821,575280,62,9259
1186,6,0,16,9,44591880,4821,575280,62,9265
1187,7,0,15,10,44624760,4820,575280,62,9272
1188,13,0,24,1,44642580,4820,575280,61,9285
1189,9,0,22,3,44692680,4820,575280,61,9294
1190,15,0,25,0,44742240,4819,575460,61,9309
1191,14,0,25,0,44794020,4817,575580,61,9323
1192,11,2,25,0,44850240,4818,583800,62,9334
1193,16,4,25,0,44908680,4818,587280,62,9350
1194,11,2,25,0,44982540,4819,594720,63,9361
1195,7,0,24,1,45031740,4819,597120,63,9368
1196,8,0,20,5,45094920,4819,597120,63,9376
1197,4,0,17,8,45137100,4820,597120,63,9380
1198,4,0,12,13,45192120,4822,597120,63,9384
1199,10,0,18,7,45203760,4821,597120,63,9394
1200,9,0,24,1,45220620,4821,597120,63,9403
1201,11,0,24,1,45271920,4821,597900,63,9414
1202,5,0,18,7,45342420,4823,597900,63,9419
1203,4,0,14,11,45384180,4823,597900,63,9423
1204,6,0,15,10,45407520,4823,597900,63,9429
1205,9,0,19,6,45424380,4822,597900,63,9438
1206,8,0,18,7,45471660,4823,597900,63,9446
1207,5,0,16,9,45502920,4822,597900,63,9451
1208,5,0,15,10,45529020,4822,597900,63,9456
1209,10,0,19,6,45558600,4822,597900,63,9466
1210,6,0,19,6,45580920,4821,597900,63,9472
1211,10,0,19,6,45633660,4822,597900,63,9482
1212,13,0,23,2,45672720,4821,597900,62,9495
1213,11,0,22,3,45724560,4821,597900,62,9506
1214,14,0,24,1,45775020,4820,599460,62,9520
1215,7,0,23,2,45816780,4820,599460,62,9527
1216,9,0,19,6,45884220,4821,599460,62,9536
1217,10,0,21,4,45925260,4821,599460,62,9546
1218,6,0,18,7,45968340,4821,599460,62,9552
1219,6,0,18,7,45999600,4821,599460,62,9558
1220,8,0,20,5,46037100,4822,599460,62,9566
1221,2,0,15,10,46076520,4823,599460,62,9568
1222,2,0,11,14,46121520,4824,599460,62,9570
1223,7,0,16,9,46133220,4825,599460,62,9577
1224,3,0,18,7,46142580,4825,599460,62,9580
1225,5,0,17,8,46180380,4826,599460,62,9585
1226,9,0,20,5,46209120,4826,599460,62,9594
1227,8,0,16,9,46274880,4827,599460,62,9602
1228,3,0,14,11,46301820,4827,599460,62,9605
1229,8,0,15,10,46333200,4827,599460,62,9613
1230,3,0,11,14,46358700,4826,599460,62,9616
1231,5,0,14,11,46368300,4826,599460,62,9621
1232,9,0,20,5,46377780,4825,599460,62,9630
1233,4,0,16,9,46419180,4826,599460,62,9634
1234,9,0,17,8,46457160,4826,599460,62,9643
1235,10,0,21,4,46480980,4825,599460,62,9653
1236,12,0,21,4,46533780,4825,599460,62,9665
1237,10,0,20,5,46583520,4824,599460,61,9675
1238,10,0,18,7,46623900,4822,599460,61,9685
1239,11,0,22,3,46654560,4822,599460,61,9696
1240,17,2,25,0,46707720,4822,601200,61,9713
1241,7,0,24,1,46759080,4822,611520,62,9720
1242,13,0,23,2,46821780,4822,611520,62,9733
1243,8,0,19,6,46884060,4822,611520,62,9741
1244,10,0,21,4,46924740,4822,611520,62,9751
1245,5,0,18,7,46966320,4822,611520,62,9756
1246,2,0,13,12,47012940,4824,611520,62,9758
1247,9,0,17,8,47038740,4824,611520,62,9767
1248,4,0,13,12,47074320,4824,611520,62,9771
1249,3,0,11,14,47102940,4824,611520,62,9774
1250,7,0,16,9,47110920,4824,611520,62,9781
1251,6,0,15,10,47142780,4824,611520,62,9787
1252,2,0,13,12,47157120,4823,611520,62,9789
1253,7,0,14,11,47190480,4824,611520,62,9796
1254,10,0,18,7,47208360,4823,611520,62,9806
1255,7,0,16,9,47242860,4822,611520,62,9813
1256,9,0,19,6,47275140,4822,611520,62,9822
1257,12,2,25,0,47299620,4823,611940,62,9834
1258,16,5,25,0,47361420,4822,618180,62,9850
1259,12,8,25,0,47414940,4823,625440,63,9862
1260,3,0,23,2,47482320,4824,654360,66,9865
1261,9,0,17,8,47552520,4824,654360,66,9874
1262,9,0,19,6,47580120,4823,654360,66,9883
1263,6,0,17,8,47609880,4822,654360,66,9889
1264,14,0,22,3,47651460,4822,654360,66,9903
1265,4,0,18,7,47684340,4821,654360,66,9907
1266,5,0,12,13,47739840,4822,654360,66,9912
1267,12,0,19,6,47757600,4821,654360,65,9924
1268,14,0,20,5,47800920,4819,654360,65,9938
1269,2,0,13,12,47842020,4819,654360,65,9940
1270,8,0,17,8,47866560,4819,654360,65,9948
1271,6,0,18,7,47882760,4819,654360,65,9954
1272,6,0,14,11,47921880,4818,654360,65,9960
1273,3,0,14,11,47936760,4818,654360,65,9963
1274,6,0,16,9,47967660,4819,654360,65,9969
1275,13,0,22,3,47990640,4818,654360,65,9982
1276,15,1,25,0,48038580,4817,654660,65,9997
1277,3,0,17,8,48088680,4817,655800,65,10000
1278,3,0,12,13,48139140,4818,655800,65,10003
1279,8,0,17,8,48153960,4818,655800,65,10011
1280,7,0,21,4,48166440,4818,655800,65,10018
1281,9,0,20,5,48218940,4818,655800,65,10027
1282,6,0,17,8,48266580,4818,655800,65,10033
1283,10,0,21,4,48301860,4819,655800,65,10043
1284,4,0,12,13,48367440,4819,655800,65,10047
1285,15,0,21,4,48387480,4818,655800,65,10062
1286,10,4,25,0,48396240,4818,656280,65,10072
1287,17,6,25,0,48494580,4821,666840,66,10089
1288,9,7,25,0,48538080,4821,678240,67,10098
1289,11,2,25,0,48615900,4822,714300,70,10109
1290,8,0,17,8,48681540,4819,717360,70,10117
1291,12,0,24,1,48701520,4819,717840,70,10129
1292,5,0,16,9,48761160,4819,717840,70,10134
1293,7,0,16,9,48804420,4820,717840,70,10141
1294,7,0,19,6,48820020,4819,717840,70,10148
1295,7,0,15,10,48869580,4819,717840,70,10155
1296,8,0,19,6,48886860,4819,717840,70,10163
1297,6,0,17,8,48923400,4819,717840,70,10169
1298,6,0,16,9,48961620,4819,717840,70,10175
1299,5,0,14,11,48992160,4819,717840,70,10180
1300,7,0,17,8,49009440,4819,717840,70,10187
1301,6,0,14,11,49052460,4818,717840,70,10193
1302,7,0,15,10,49072740,4818,717840,70,10200
1303,6,0,14,11,49108020,4818,717840,70,10206
1304,6,0,17,8,49120800,4818,717840,70,10212
1305,14,0,23,2,49158300,4818,717840,70,10226
1306,5,0,21,4,49187460,4817,717840,70,10231
1307,9,0,16,9,49249620,4817,717840,70,10240
1308,5,0,14,11,49283520,4817,717840,70,10245
1309,12,0,21,4,49306080,4816,717840,69,10257
1310,12,0,22,3,49349280,4815,718920,70,10269
1311,17,2,25,0,49401360,4815,720180,70,10286
1312,13,2,25,0,49465140,4815,728040,70,10299
1313,8,0,22,3,49514520,4814,734520,71,10307
1314,12,0,22,3,49583940,4815,734520,71,10319
1315,9,0,21,4,49624860,4814,734520,71,10328
1316,7,0,22,3,49652940,4814,734520,71,10335
1317,6,0,18,7,49719780,4816,734520,71,10341
1318,10,0,23,2,49749120,4816,734520,70,10351
1319,3,0,16,9,49804320,4817,734520,70,10354
1320,5,0,12,13,49848480,4817,734520,70,10359
1321,5,0,14,11,49868040,4818,734520,70,10364
1322,5,0,15,10,49881660,4817,734520,70,10369
1323,9,0,16,9,49918740,4817,734520,70,10378
1324,7,0,20,5,49929300,4817,734520,70,10385
1325,4,0,16,9,49969080,4817,734520,70,10389
1326,6,0,12,13,50012340,4816,734520,70,10395
1327,4,0,15,10,50017500,4816,734520,70,10399
1328,5,0,14,11,50040480,4816,734520,70,10404
1329,6,0,16,9,50062260,4816,734520,70,10410
1330,12,0,20,5,50096400,4816,734520,70,10422
1331,9,0,18,7,50132520,4814,734520,70,10431
1332,17,2,25,0,50176680,4814,736500,70,10448
1333,7,0,22,3,50229300,4814,739080,70,10455
1334,7,0,20,5,50276220,4814,739080,70,10462
1335,13,0,21,4,50339700,4815,739080,70,10475
1336,15,2,25,0,50378100,4814,739080,70,10490
1337,13,4,25,0,50434620,4815,745980,71,10503
1338,5,0,22,3,50491140,4815,758820,72,10508
1339,8,0,21,4,50551560,4816,758820,72,10516
1340,10,0,24,1,50586960,4816,758820,72,10526
1341,3,0,15,10,50642460,4816,758820,72,10529
1342,3,0,12,13,50683740,4817,758820,72,10532
1343,7,0,17,8,50691600,4817,758820,72,10539
1344,7,0,19,6,50712240,4817,758820,71,10546
1345,4,0,23,2,50712240,4817,758820,71,10550
1346,5,1,25,0,50718900,4817,758820,71,10555
1347,5,0,23,2,50754720,4816,761400,72,10560
1348,6,1,25,0,50766660,4816,761760,72,10566
1349,6,1,25,0,50800140,4817,765480,72,10572
1350,7,4,25,0,50816760,4816,768660,72,10579
1351,11,10,25,0,50845920,4817,772080,72,10590
1352,7,14,25,0,50862420,4817,777180,73,10597
1353,9,18,25,0,50893920,4818,792300,74,10606
1354,14,28,25,0,50919180,4818,796020,74,10620
1355,11,36,25,0,50937360,4819,807000,75,10631
1356,10,40,25,0,50962080,4819,827880,77,10641
1357,15,40,25,0,50991480,4820,842820,79,10656
1358,8,38,25,0,51019080,4820,883140,82,10664
1359,17,38,25,0,51044940,4821,913380,85,10681
1360,9,38,25,0,51072660,4821,945360,88,10690
1361,13,40,25,0,51088620,4821,969720,90,10703
1362,5,40,25,0,51117300,4821,1080120,101,10708
1363,8,39,25,0,51145680,4822,1093320,102,10716
1364,6,40,25,0,51170220,4822,1228380,115,10722
1365,8,40,25,0,51193620,4822,1306440,122,10730
1366,6,39,25,0,51223800,4822,1439460,134,10736
1367,5,40,25,0,51235860,4823,1443720,135,10741
1368,4,39,25,0,51270420,4824,1466700,137,10745
1369,7,38,25,0,51299520,4824,1474440,137,10752
1370,9,40,25,0,51318060,4824,1477500,138,10761
1371,2,37,25,0,51346980,4825,1581660,147,10763
1372,9,37,25,0,51382140,4825,1768800,165,10772
1373,6,38,25,0,51400380,4824,1774320,165,10778
1374,13,40,25,0,51418200,4824,1784640,166,10791
1375,7,40,25,0,51446760,4825,1801800,167,10798
1376,7,40,25,0,51467040,4825,1813860,169,10805
1377,8,39,25,0,51497040,4825,1849680,172,10813
1378,14,40,25,0,51524940,4826,1883100,175,10827
1379,8,38,25,0,51555360,4826,1890060,175,10835
1380,15,40,25,0,51565500,4826,1892880,176,10850
1381,12,38,25,0,51602880,4826,2036220,189,10862
1382,7,37,25,0,51630300,4827,2099160,195,10869
1383,10,39,25,0,51650160,4826,2102040,195,10879
1384,5,39,25,0,51671460,4826,2154060,200,10884
1385,7,39,25,0,51706980,4826,2161860,200,10891
1386,7,37,25,0,51726660,4826,2287200,212,10898
1387,8,39,25,0,51754980,4826,2291340,212,10906
1388,8,40,25,0,51775320,4826,2303460,213,10914
1389,7,38,25,0,51805740,4826,2328600,215,10921
1390,3,33,25,0,51833220,4825,2670480,247,10924
1391,3,29,25,0,51859980,4824,2895540,268,10927
1392,10,34,25,0,51879180,4824,3027120,280,10937
1393,7,36,25,0,51903600,4824,3037440,280,10944
1394,5,39,25,0,51916200,4824,3048360,281,10949
1395,0,33,25,0,51956280,4825,3078180,284,10949
1396,7,34,25,0,51979560,4824,3156000,291,10956
1397,9,37,25,0,52004640,4824,3161340,291,10965
1398,2,34,25,0,52032960,4825,3178560,293,10967
1399,6,38,25,0,52042260,4824,3184380,293,10973
1400,6,39,25,0,52074660,4825,3194160,294,10979
1401,4,38,25,0,52108560,4826,3209460,295,10983
1402,10,40,25,0,52124160,4826,3216840,296,10993
1403,14,40,25,0,52151220,4827,3225600,296,11007
1404,8,38,25,0,52171380,4827,3234420,297,11015
1405,13,40,25,0,52204920,4827,3237180,297,11028
1406,11,40,25,0,52223580,4828,3238980,297,11039
1407,11,39,25,0,52265340,4829,3271620,300,11050
1408,9,40,25,0,52278720,4828,3277560,300,11059
1409,6,38,25,0,52301100,4828,3288480,301,11065
1410,16,40,25,0,52326720,4829,3293340,302,11081
1411,6,40,25,0,52348680,4829,3375420,309,11087
1412,6,39,25,0,52372800,4829,3380100,309,11093
1413,2,36,25,0,52402560,4830,3627060,332,11095
1414,1,29,25,0,52439880,4830,4252800,389,11096
1415,6,28,25,0,52459800,4828,5070120,464,11102
1416,4,24,25,0,52491540,4828,5509320,504,11106
1417,3,18,25,0,52518300,4826,6603060,604,11109
1418,4,5,25,0,52546380,4821,8716020,797,11113
1419,8,3,25,0,52558260,4818,9539820,872,11121
1420,4,4,25,0,52576680,4818,9543720,872,11125
1421,4,3,25,0,52602180,4818,9559140,873,11129
1422,6,1,25,0,52636320,4818,9571500,874,11135
1423,9,7,25,0,52654860,4818,9573300,873,11144
1424,9,11,25,0,52680480,4818,9584880,873,11153
1425,13,21,25,0,52698240,4819,9592140,873,11166
1426,10,26,25,0,52729260,4819,9604980,874,11176
1427,8,31,25,0,52750080,4820,9615540,874,11184
1428,11,38,25,0,52776840,4821,9634020,875,11195
1429,12,40,25,0,52800720,4821,9652020,876,11207
1430,16,40,25,0,52832100,4821,9683280,878,11223
1431,8,38,25,0,52854600,4822,9719160,881,11231
1432,6,39,25,0,52886460,4822,9753300,884,11237
1433,8,38,25,0,52903920,4822,9772920,885,11245
1434,8,39,25,0,52929180,4823,9803160,888,11253
1435,3,38,25,0,52956420,4823,9845460,891,11256
1436,2,36,25,0,52981860,4824,9864180,893,11258
1437,4,36,25,0,53005380,4824,9963120,901,11262
1438,3,34,25,0,53033040,4825,10067100,911,11265
1439,7,38,25,0,53054820,4825,10122480,915,11272
1440,4,37,25,0,53087640,4826,10178340,920,11276
1441,5,36,25,0,53117400,4826,10246200,925,11281
1442,2,35,25,0,53132280,4826,10369740,936,11283
1443,6,39,25,0,53146740,4827,10443540,943,11289
1444,6,37,25,0,53192100,4828,10458120,943,11295
1445,8,39,25,0,53206320,4828,10461540,943,11303
1446,2,35,25,0,53239320,4828,10746480,969,11305
1447,10,38,25,0,53261760,4829,10751160,969,11315
1448,2,36,25,0,53283900,4829,10820040,975,11317
1449,9,40,25,0,53310660,4829,10836780,976,11326
1450,10,40,25,0,53328000,4829,10841760,976,11336
1451,11,40,25,0,53365260,4830,10863960,977,11347
1452,10,39,25,0,53390040,4830,10873740,978,11357
1453,6,40,25,0,53407140,4830,10877700,978,11363
1454,6,38,25,0,53439000,4830,10994160,988,11369
1455,12,40,25,0,53461020,4830,11001480,988,11381
1456,9,38,25,0,53480940,4831,11008860,988,11390
1457,4,35,25,0,53515860,4831,11356980,1019,11394
1458,12,38,25,0,53542140,4830,11438940,1026,11406
1459,7,39,25,0,53559900,4830,11443920,1026,11413
1460,8,40,25,0,53592000,4830,11523360,1032,11421
1461,5,40,25,0,53610720,4830,11530020,1032,11426
1462,4,37,25,0,53642040,4830,11544300,1033,11430
1463,5,37,25,0,53666820,4830,11567760,1035,11435
1464,5,37,25,0,53689980,4830,11572320,1035,11440
1465,7,39,25,0,53713080,4831,11576820,1035,11447
1466,7,40,25,0,53744340,4831,11581380,1035,11454
1467,8,39,25,0,53764980,4831,11586420,1035,11462
1468,11,40,25,0,53782800,4831,11589720,1035,11473
1469,10,40,25,0,53815380,4832,11645940,1039,11483
1470,14,40,25,0,53832360,4831,11805900,1053,11497
1471,7,40,25,0,53853540,4831,11974380,1068,11504
1472,9,40,25,0,53895960,4831,12202920,1087,11513
1473,5,39,25,0,53912820,4831,12208680,1087,11518
1474,16,40,25,0,53948880,4831,12226320,1089,11534
1475,5,36,25,0,53974920,4831,12332700,1097,11539
1476,11,39,25,0,53996700,4830,12350160,1098,11550
1477,10,40,25,0,54017220,4830,12369720,1099,11560
1478,10,39,25,0,54048180,4830,12384720,1100,11570
1479,13,40,25,0,54065940,4830,12386100,1100,11583
1480,1,34,25,0,54092460,4830,12449100,1105,11584
1481,7,34,25,0,54120960,4830,12549360,1114,11591
1482,13,40,25,0,54133620,4830,12553560,1113,11604
1483,9,38,25,0,54171900,4831,12578760,1115,11613
1484,3,40,25,0,54178080,4831,12582780,1115,11616
1485,7,37,25,0,54223140,4832,12600000,1116,11623
1486,3,34,25,0,54248760,4831,12829680,1136,11626
1487,6,33,25,0,54278460,4831,12849480,1137,11632
1488,7,38,25,0,54287640,4831,12850260,1137,11639
1489,11,39,25,0,54320760,4832,12859440,1137,11650
1490,8,38,25,0,54347220,4833,12872940,1138,11658
1491,4,39,25,0,54365280,4833,13123140,1160,11662
1492,10,40,25,0,54389880,4833,13126680,1159,11672
1493,7,39,25,0,54415620,4833,13356780,1179,11679
1494,9,38,25,0,54453360,4833,13399800,1182,11688
1495,4,40,25,0,54460020,4833,13401360,1182,11692
1496,9,40,25,0,54495600,4834,13449960,1186,11701
1497,12,39,25,0,54517800,4833,13539120,1193,11713
1498,7,38,25,0,54535380,4834,13555920,1194,11720
1499,6,37,25,0,54575580,4834,13598040,1198,11726
1500,6,35,25,0,54608400,4834,13876980,1221,11732
1501,7,40,25,0,54616200,4834,13879020,1221,11739
1502,12,40,25,0,54646680,4834,13887900,1221,11751
1503,8,38,25,0,54680400,4835,14150580,1244,11759
1504,8,40,25,0,54693060,4834,14154840,1244,11767
1505,10,38,25,0,54727740,4834,14182500,1245,11777
1506,14,39,25,0,54751080,4833,14416260,1265,11791
1507,8,39,25,0,54766680,4833,14422620,1265,11799
1508,8,40,25,0,54796980,4834,14433900,1266,11807
1509,5,36,25,0,54831420,4834,14450460,1267,11812
1510,2,31,25,0,54856560,4833,15851820,1389,11814
1511,6,32,25,0,54872820,4832,15855360,1389,11820
1512,9,35,25,0,54902700,4832,15859260,1388,11829
1513,4,36,25,0,54919260,4833,15866040,1388,11833
1514,7,37,25,0,54959220,4834,15877440,1388,11840
1515,10,39,25,0,54973380,4834,15886020,1389,11850
1516,10,40,25,0,54989520,4834,15898740,1390,11860
1517,10,40,25,0,55004340,4834,15906600,1390,11870
1518,8,40,25,0,55041120,4835,15932100,1391,11878
1519,12,40,25,0,55071060,4836,15937080,1391,11890
1520,8,39,25,0,55100460,4836,15983820,1395,11898
1521,10,40,25,0,55128120,4837,15987420,1394,11908
1522,8,38,25,0,55160280,4836,16364640,1426,11916
1523,6,38,25,0,55180800,4835,16406280,1429,11922
1524,11,40,25,0,55195620,4835,16410120,1429,11933
1525,15,40,25,0,55231140,4835,16476120,1434,11948
1526,11,40,25,0,55259640,4835,16498320,1436,11959
1527,16,38,25,0,55279920,4835,16506900,1435,11975
1528,6,39,25,0,55299120,4834,16573620,1441,11981
1529,12,39,25,0,55333140,4834,16605480,1442,11993
1530,7,39,25,0,55354740,4834,16626660,1444,12000
1531,3,36,25,0,55377600,4833,16666680,1447,12003
1532,5,36,25,0,55396380,4833,16672380,1446,12008
1533,9,39,25,0,55428060,4833,17057520,1479,12017
1534,10,40,25,0,55449840,4833,17068800,1479,12027
1535,5,38,25,0,55478940,4833,17083980,1480,12032
1536,7,39,25,0,55502400,4834,17100180,1481,12039
1537,4,38,25,0,55527960,4834,17116620,1482,12043
1538,9,38,25,0,55558800,4834,17467800,1511,12052
1539,2,39,25,0,55564740,4834,17468520,1511,12054
1540,4,37,25,0,55608720,4835,17505660,1514,12058
1541,11,40,25,0,55628520,4834,17517660,1514,12069
1542,5,38,25,0,55659540,4834,17960580,1551,12074
1543,4,37,25,0,55681740,4834,17971320,1551,12078
1544,10,37,25,0,55714920,4833,17979780,1551,12088
1545,4,37,25,0,55733100,4833,17985000,1551,12092
1546,9,40,25,0,55754520,4833,17994360,1551,12101
1547,11,40,25,0,55782300,4833,17996220,1550,12112
1548,6,39,25,0,55801680,4833,18390120,1584,12118
1549,18,40,25,0,55824300,4834,18403080,1584,12136
1550,12,40,25,0,55850160,4834,18825900,1620,12148
1551,8,39,25,0,55885440,4834,19680480,1693,12156
1552,8,40,25,0,55910460,4834,19688940,1693,12164
1553,8,39,25,0,55924380,4834,19698960,1693,12172
1554,6,40,25,0,55951440,4835,19712220,1694,12178
1555,12,38,25,0,55991160,4835,19724940,1694,12190
1556,2,35,25,0,56008980,4835,19790100,1699,12192
1557,1,16,25,0,56041620,4829,24488820,2102,12193
1558,10,14,25,0,56067180,4826,24988140,2143,12203
1559,5,14,25,0,56080500,4825,25334280,2172,12208
1560,9,17,25,0,56113080,4826,25339020,2171,12217
1561,5,19,25,0,56128500,4826,25344960,2171,12222
1562,8,22,25,0,56151660,4826,25349280,2170,12230
1563,2,20,25,0,56178420,4826,25357080,2170,12232
1564,5,20,25,0,56213040,4827,25388700,2172,12237
1565,6,19,25,0,56238780,4826,25394700,2171,12243
1566,8,23,25,0,56257800,4826,25408080,2171,12251
1567,3,20,25,0,56285520,4826,25418280,2171,12254
1568,10,26,25,0,56304720,4826,25422000,2170,12264
1569,7,29,25,0,56329020,4827,25435020,2170,12271
1570,10,32,25,0,56371920,4828,25446180,2168,12281
1571,8,40,25,0,56371920,4828,25446180,2168,12289
1572,11,40,25,0,56414640,4828,25469220,2168,12300
1573,13,40,25,0,56433540,4828,25487760,2169,12313
1574,10,39,25,0,56462640,4829,25495860,2168,12323
1575,8,40,25,0,56489100,4829,25518840,2169,12331
1576,5,39,25,0,56505840,4829,25585020,2175,12336
1577,11,40,25,0,56539380,4830,25588380,2174,12347
1578,7,39,25,0,56557860,4830,25604340,2174,12354
1579,7,39,25,0,56588040,4830,25621200,2175,12361
1580,4,38,25,0,56614380,4830,25631340,2175,12365
1581,8,40,25,0,56638800,4831,25636020,2174,12373
1582,7,40,25,0,56656620,4831,25638780,2174,12380
1583,6,39,25,0,56685900,4832,25719360,2180,12386
1584,3,35,25,0,56716020,4831,25747860,2182,12389
1585,4,33,25,0,56743320,4831,25955340,2199,12393
1586,6,33,25,0,56767140,4831,25961880,2198,12399
1587,7,38,25,0,56777940,4831,25964400,2197,12406
1588,8,40,25,0,56802480,4831,25970760,2197,12414
1589,3,36,25,0,56840940,4832,25992300,2198,12417
1590,7,39,25,0,56860560,4832,26002260,2197,12424
1591,10,38,25,0,56892780,4833,26019900,2198,12434
1592,11,39,25,0,56911920,4833,26027160,2198,12445
1593,11,40,25,0,56941260,4834,26034240,2198,12456
1594,11,39,25,0,56962500,4834,26043060,2198,12467
1595,12,40,25,0,56992500,4834,26092080,2201,12479
1596,13,40,25,0,57021060,4834,26098860,2200,12492
1597,12,40,25,0,57046320,4834,26206680,2208,12504
1598,4,37,25,0,57070560,4834,26216580,2209,12508
1599,11,40,25,0,57088860,4833,26252520,2210,12519
1600,13,40,25,0,57103380,4833,26379540,2221,12532
1601,7,38,25,0,57148440,4834,26496720,2229,12539
1602,6,37,25,0,57174900,4833,26582700,2235,12545
1603,9,40,25,0,57189120,4833,26586000,2235,12554
1604,11,40,25,0,57219420,4833,26597160,2234,12565
1605,9,38,25,0,57247560,4834,26772900,2249,12574
1606,3,35,25,0,57274260,4834,26806680,2251,12577
1607,5,35,25,0,57288900,4833,27105600,2275,12582
1608,9,38,25,0,57320640,4833,27109920,2274,12591
1609,4,37,25,0,57345600,4833,27119460,2274,12595
1610,7,38,25,0,57369180,4833,27127500,2273,12602
1611,9,39,25,0,57390300,4833,27153120,2274,12611
1612,6,39,25,0,57417180,4833,27177480,2275,12617
1613,8,39,25,0,57449820,4833,27182760,2274,12625
1614,14,40,25,0,57460380,4833,27186060,2274,12639
1615,13,40,25,0,57496920,4834,27190920,2274,12652
1616,7,38,25,0,57519420,4834,27243660,2277,12659
1617,8,39,25,0,57543060,4834,27255600,2277,12667
1618,11,39,25,0,57566940,4834,27262080,2277,12678
1619,7,40,25,0,57593940,4834,27267180,2276,12685
1620,12,40,25,0,57624720,4834,27285300,2277,12697
1621,10,37,25,0,57651960,4834,27300900,2277,12707
1622,12,40,25,0,57673560,4834,27302820,2276,12719
1623,20,40,25,0,57701760,4834,27702960,2309,12739
1624,7,38,25,0,57725280,4834,27943140,2328,12746
1625,12,40,25,0,57749640,4833,27949740,2327,12758
1626,10,40,25,0,57762060,4833,27952140,2326,12768
1627,8,40,25,0,57789720,4833,28173060,2344,12776
1628,9,40,25,0,57817440,4834,28180740,2344,12785
1629,5,37,25,0,57850980,4834,28408680,2362,12790
1630,3,35,25,0,57873240,4834,28869060,2399,12793
1631,6,34,25,0,57905700,4834,29095860,2417,12799
1632,4,33,25,0,57923760,4833,29319480,2435,12803
1633,3,30,25,0,57946440,4833,29930100,2485,12806
1634,4,26,25,0,57977820,4832,30684240,2547,12810
1635,6,19,25,0,58004580,4829,32522100,2698,12816
1636,7,18,25,0,58033020,4828,33256500,2757,12823
1637,8,22,25,0,58049580,4828,33259800,2756,12831
1638,7,24,25,0,58076820,4828,33267540,2754,12838
1639,7,27,25,0,58096620,4828,33272760,2754,12845
1640,2,24,25,0,58125780,4829,33286620,2754,12847
1641,14,34,25,0,58144320,4829,33289500,2751,12861
1642,12,40,25,0,58173660,4829,33295920,2750,12873
1643,11,40,25,0,58197120,4830,33307920,2749,12884
1644,5,39,25,0,58224720,4830,33355620,2752,12889
1645,8,39,25,0,58251900,4830,33371340,2752,12897
1646,7,37,25,0,58279680,4830,33391560,2753,12904
1647,13,40,25,0,58299420,4830,33396660,2752,12917
1648,12,39,25,0,58333560,4830,33452700,2755,12929
1649,11,39,25,0,58351260,4829,33486420,2757,12940
1650,12,38,25,0,58384500,4829,33496260,2756,12952
1651,3,37,25,0,58401840,4829,33506100,2756,12955
1652,8,39,25,0,58433460,4829,33510420,2755,12963
1653,8,40,25,0,58453020,4829,33521760,2755,12971
1654,6,40,25,0,58475100,4829,33530880,2754,12977
1655,6,40,25,0,58503480,4829,33541080,2754,12983
1656,3,38,25,0,58523040,4829,33550020,2754,12986
1657,8,40,25,0,58553100,4830,33555300,2754,12994
1658,4,38,25,0,58576980,4831,33563520,2753,12998
1659,5,37,25,0,58605360,4831,33691320,2763,13003
1660,6,40,25,0,58619220,4830,33694680,2762,13009
1661,7,40,25,0,58641660,4831,33704040,2762,13016
1662,7,39,25,0,58678260,4832,33712080,2761,13023
1663,9,39,25,0,58704240,4832,33726840,2762,13032
1664,9,40,25,0,58717680,4832,33730080,2761,13041
1665,8,40,25,0,58737780,4832,33808800,2767,13049
1666,8,36,25,0,58789320,4833,33886620,2772,13057
1667,6,35,25,0,58809360,4832,33910740,2772,13063
1668,12,38,25,0,58835280,4832,33917820,2771,13075
1669,11,39,25,0,58848720,4832,33924960,2771,13086
1670,7,40,25,0,58884000,4832,34058460,2781,13093
1671,13,39,25,0,58905960,4832,34064940,2780,13106
1672,14,39,25,0,58930500,4832,34082760,2780,13120
1673,9,38,25,0,58957740,4832,34103280,2780,13129
1674,9,40,25,0,58973520,4831,34106880,2780,13138
1675,11,40,25,0,59009040,4832,34125300,2779,13149
1676,4,40,25,0,59026020,4832,34151280,2781,13153
1677,4,33,25,0,59066160,4831,34847640,2837,13157
1678,10,36,25,0,59092620,4830,34854840,2835,13167
1679,4,38,25,0,59101260,4830,34857720,2834,13171
1680,1,34,25,0,59134860,4831,35000580,2845,13172
1681,8,36,25,0,59161800,4831,35013480,2845,13180
1682,3,35,25,0,59177400,4830,35026140,2845,13183
1683,5,26,25,0,59216700,4828,37398960,3036,13188
1684,3,16,25,0,59238180,4825,40202040,3263,13191
1685,8,16,25,0,59254320,4823,41174520,3341,13199
1686,9,21,25,0,59281140,4823,41182080,3338,13208
1687,15,32,25,0,59307480,4824,41194020,3336,13223
1688,14,40,25,0,59334720,4825,41202660,3333,13237
1689,13,40,25,0,59352120,4825,41207880,3332,13250
1690,6,39,25,0,59388180,4825,41237040,3333,13256
1691,9,39,25,0,59404980,4826,41264160,3335,13265
1692,7,40,25,0,59425080,4826,41276940,3335,13272
1693,8,38,25,0,59460180,4826,41311440,3336,13280
1694,13,40,25,0,59470860,4826,41314680,3336,13293
1695,11,40,25,0,59505660,4827,41389920,3340,13304
1696,7,38,25,0,59529000,4827,41404020,3340,13311
1697,10,39,25,0,59560620,4828,41491140,3346,13321
1698,7,39,25,0,59594040,4828,41565300,3350,13328
1699,8,40,25,0,59609040,4828,41612640,3353,13336
1700,5,35,25,0,59646780,4827,41674740,3356,13341
1701,6,37,25,0,59661060,4826,41681280,3355,13347
1702,3,35,25,0,59683380,4826,41814540,3365,13350
1703,8,38,25,0,59708040,4826,41819520,3364,13358
1704,2,36,25,0,59737140,4827,41827560,3363,13360
1705,7,38,25,0,59758260,4827,41831640,3362,13367
1706,4,37,25,0,59785080,4827,41842800,3362,13371
1707,5,35,25,0,59818260,4827,41951820,3369,13376
1708,5,35,25,0,59836800,4827,42029640,3374,13381
1709,2,30,25,0,59866680,4827,42202500,3387,13383
1710,2,26,25,0,59892420,4826,42593880,3418,13385
1711,9,28,25,0,59921160,4826,42597240,3416,13394
1712,5,29,25,0,59935020,4826,42603540,3415,13399
1713,9,25,25,0,59970960,4823,43500540,3485,13408
1714,15,38,25,0,59981700,4824,43502520,3482,13423
1715,7,39,25,0,60015840,4824,43512540,3480,13430
1716,10,40,25,0,60025800,4824,43523100,3480,13440
1717,11,40,25,0,60057480,4825,43547280,3480,13451
1718,11,40,25,0,60090720,4825,43561080,3480,13462
1719,19,40,25,0,60101820,4825,43565220,3479,13481
1720,13,40,25,0,60130500,4825,43598520,3481,13494
1721,8,40,25,0,60166920,4826,43656600,3484,13502
1722,9,40,25,0,60191220,4826,43688280,3485,13511
1723,10,40,25,0,60207840,4826,43695600,3485,13521
1724,14,39,25,0,60236940,4827,43737300,3486,13535
1725,2,38,25,0,60253500,4827,43781400,3489,13537
1726,9,39,25,0,60297360,4828,43864980,3494,13546
1727,5,39,25,0,60316020,4827,43870560,3493,13551
1728,10,39,25,0,60344820,4827,43887780,3493,13561
1729,1,35,25,0,60366000,4827,44021640,3503,13562
1730,4,33,25,0,60398760,4828,44097840,3508,13566
1731,3,29,25,0,60424200,4827,44181360,3514,13569
1732,4,26,25,0,60447300,4826,44327220,3525,13573
1733,4,26,25,0,60468780,4826,44400480,3530,13577
1734,12,31,25,0,60498480,4826,44534220,3537,13589
1735,5,33,25,0,60513000,4826,44542080,3536,13594
1736,10,39,25,0,60532500,4826,44546640,3534,13604
1737,9,39,25,0,60569280,4827,44564400,3534,13613
1738,13,40,25,0,60589080,4828,44571780,3533,13626
1739,17,40,25,0,60619380,4828,44630400,3536,13643
1740,8,35,25,0,60652320,4828,44682360,3540,13651
1741,7,36,25,0,60672900,4827,44703120,3540,13658
1742,12,40,25,0,60679200,4827,44703600,3539,13670
1743,4,36,25,0,60724740,4828,44729640,3539,13674
1744,10,40,25,0,60733380,4828,44733360,3538,13684
1745,12,38,25,0,60777180,4829,44751600,3538,13696
1746,7,40,25,0,60787440,4829,44755260,3537,13703
1747,6,38,25,0,60823620,4829,44790180,3538,13709
1748,5,37,25,0,60849840,4829,44835240,3540,13714
1749,6,38,25,0,60870300,4829,44899020,3544,13720
1750,4,37,25,0,60889080,4828,44922480,3545,13724
1751,0,29,25,0,60917280,4827,45173400,3564,13724
1752,3,15,25,0,60961680,4824,50115120,3953,13727
1753,3,0,23,2,60981540,4818,52669860,4154,13730
1754,9,2,25,0,61000440,4818,52671420,4151,13739
1755,9,6,25,0,61018440,4817,52676700,4149,13748
1756,3,5,25,0,61038180,4817,52683900,4148,13751
1757,8,5,25,0,61074240,4817,52692120,4146,13759
1758,1,1,25,0,61090320,4817,52721820,4148,13760
1759,9,2,25,0,61115580,4816,52734240,4147,13769
1760,8,2,25,0,61150800,4815,52742280,4144,13777
1761,2,3,25,0,61154760,4815,52743120,4144,13779
1762,12,10,25,0,61189740,4816,52748640,4140,13791
1763,16,23,25,0,61211640,4817,52750620,4136,13807
1764,18,37,25,0,61238220,4817,52762440,4130,13825
1765,13,40,25,0,61261380,4818,52776180,4129,13838
1766,15,40,25,0,61291440,4818,52784280,4128,13853
1767,9,39,25,0,61312380,4819,52806540,4129,13862
1768,11,40,25,0,61335840,4819,52840140,4131,13873
1769,9,40,25,0,61365480,4819,52900380,4133,13882
1770,7,38,25,0,61396320,4819,52979460,4139,13889
1771,11,39,25,0,61409340,4819,52987860,4138,13900
1772,6,40,25,0,61438260,4820,53061180,4142,13906
1773,6,38,25,0,61463640,4820,53083380,4142,13912
1774,5,38,25,0,61490220,4820,53172360,4147,13917
1775,7,39,25,0,61517640,4821,53180040,4147,13924
1776,4,40,25,0,61536000,4821,53230500,4150,13928
1777,4,39,25,0,61562940,4821,53287200,4153,13932
1778,9,37,25,0,61592700,4822,53349420,4156,13941
1779,12,40,25,0,61617120,4822,53407260,4159,13953
1780,3,38,25,0,61638480,4823,53422680,4159,13956
1781,4,36,25,0,61666920,4823,53673960,4178,13960
1782,4,35,25,0,61696020,4823,53687760,4178,13964
1783,3,36,25,0,61707600,4823,53758860,4182,13967
1784,5,36,25,0,61745640,4824,53770620,4181,13972
1785,12,40,25,0,61766340,4824,53849340,4185,13984
1786,12,40,25,0,61780080,4825,53858940,4185,13996
1787,9,39,25,0,61814880,4825,53873940,4185,14005
1788,6,38,25,0,61849440,4825,53965080,4190,14011
1789,8,40,25,0,61866960,4826,53967780,4189,14019
1790,15,39,25,0,61898220,4825,54015900,4191,14034
1791,12,40,25,0,61913700,4825,54020580,4189,14046
1792,10,40,25,0,61946400,4826,54029040,4188,14056
1793,12,40,25,0,61958400,4826,54030180,4187,14068
1794,12,40,25,0,61991820,4826,54092400,4190,14080
1795,2,37,25,0,62019360,4826,54098160,4189,14082
1796,7,39,25,0,62045040,4826,54100500,4187,14089
1797,5,37,25,0,62076360,4827,54260040,4199,14094
1798,3,35,25,0,62103120,4827,54450240,4212,14097
1799,3,33,25,0,62125680,4827,54646500,4227,14100
1800,6,32,25,0,62146080,4826,54879540,4243,14106
1801,4,31,25,0,62171100,4826,54986160,4250,14110
1802,6,30,25,0,62201640,4825,55132020,4259,14116
1803,3,28,25,0,62224740,4825,55185840,4262,14119
1804,3,25,25,0,62252100,4825,55573260,4291,14122
1805,8,26,25,0,62277780,4825,55798800,4306,14130
1806,8,31,25,0,62296140,4825,55802460,4304,14138
1807,8,35,25,0,62317140,4825,55810320,4302,14146
1808,9,38,25,0,62351100,4826,55818420,4299,14155
1809,15,40,25,0,62371320,4826,55834380,4299,14170
1810,9,38,25,0,62400300,4826,55865820,4300,14179
1811,10,40,25,0,62417520,4826,55885020,4300,14189
1812,6,39,25,0,62455140,4826,55895220,4298,14195
1813,8,39,25,0,62466000,4826,55902480,4298,14203
1814,9,39,25,0,62500260,4827,55930740,4298,14212
1815,10,40,25,0,62515920,4826,55935660,4297,14222
1816,10,40,25,0,62543580,4827,55939440,4296,14232
1817,10,40,25,0,62580180,4827,55982520,4297,14242
1818,14,38,25,0,62601300,4827,55989780,4296,14256
1819,8,38,25,0,62626860,4827,56208120,4312,14264
1820,8,37,25,0,62659260,4827,56257860,4313,14272
1821,8,37,25,0,62680860,4827,56311800,4316,14280
1822,7,39,25,0,62700420,4827,56593860,4336,14287
1823,4,37,25,0,62729220,4827,56601300,4334,14291
1824,3,36,25,0,62753040,4827,56631180,4336,14294
1825,8,38,25,0,62777580,4827,56641680,4334,14302
1826,8,39,25,0,62805060,4827,56648460,4332,14310
1827,8,40,25,0,62819640,4827,56651400,4331,14318
1828,4,38,25,0,62854080,4827,56712060,4335,14322
1829,3,34,25,0,62881380,4827,56759340,4337,14325
1830,9,37,25,0,62908620,4826,56764440,4334,14334
1831,4,38,25,0,62921040,4826,56972580,4349,14338
1832,11,40,25,0,62951340,4826,57053520,4354,14349
1833,6,38,25,0,62986860,4826,57073620,4352,14355
1834,8,40,25,0,62999460,4826,57094920,4353,14363
1835,9,38,25,0,63029760,4826,57360420,4371,14372
1836,6,39,25,0,63051360,4826,57383340,4371,14378
1837,5,40,25,0,63070980,4826,57387120,4370,14383
1838,11,39,25,0,63110460,4827,57394320,4368,14394
1839,11,40,25,0,63124740,4826,57425280,4369,14405
1840,8,39,25,0,63158100,4826,57449880,4369,14413
1841,10,36,25,0,63187380,4826,57470280,4369,14423
1842,5,36,25,0,63211680,4826,57516900,4371,14428
1843,5,37,25,0,63230400,4826,57535620,4371,14433
1844,9,40,25,0,63253980,4826,57539220,4369,14442
1845,3,38,25,0,63282720,4827,57874860,4394,14445
1846,7,39,25,0,63305760,4827,57884820,4392,14452
1847,4,36,25,0,63333300,4827,57921120,4394,14456
1848,6,38,25,0,63351660,4827,57923820,4392,14462
1849,5,39,25,0,63381600,4827,57936720,4391,14467
1850,4,38,25,0,63409680,4828,57943800,4391,14471
1851,11,40,25,0,63431100,4827,57962820,4390,14482
1852,7,39,25,0,63444120,4827,57969060,4389,14489
1853,6,40,25,0,63478680,4828,58003080,4391,14495
1854,10,40,25,0,63507420,4828,58019880,4390,14505
1855,8,38,25,0,63532500,4828,58026060,4388,14513
1856,12,39,25,0,63548880,4828,58030440,4387,14525
1857,4,37,25,0,63582720,4828,58075500,4390,14529
1858,9,37,25,0,63615060,4829,58082940,4388,14538
1859,6,40,25,0,63626340,4829,58091520,4387,14544
1860,14,38,25,0,63666120,4829,58136100,4389,14558
1861,9,39,25,0,63686640,4829,58140960,4387,14567
1862,6,39,25,0,63710520,4829,58155540,4387,14573
1863,14,40,25,0,63731460,4829,58162380,4385,14587
1864,14,39,25,0,63764100,4829,58171980,4385,14601
1865,9,40,25,0,63781860,4829,58180260,4384,14610
1866,11,38,25,0,63811140,4829,58194600,4383,14621
1867,12,39,25,0,63838140,4829,58555320,4408,14633
1868,12,40,25,0,63859020,4829,58558800,4407,14645
1869,8,40,25,0,63883260,4829,58570080,4406,14653
1870,6,36,25,0,63921420,4829,58927800,4431,14659
1871,6,39,25,0,63929520,4828,59329560,4460,14665
1872,3,36,25,0,63972300,4829,59579880,4477,14668
1873,6,38,25,0,63986220,4829,59583000,4476,14674
1874,6,38,25,0,64015740,4829,59588340,4474,14680
1875,4,37,25,0,64034880,4830,59609280,4475,14684
1876,8,40,25,0,64061340,4830,59617980,4474,14692
1877,11,40,25,0,64083600,4830,59629800,4473,14703
1878,7,38,25,0,64110300,4830,59642880,4472,14710
1879,13,40,25,0,64135680,4830,59646540,4470,14723
1880,11,39,25,0,64153920,4830,60045300,4500,14734
1881,13,39,25,0,64182120,4831,60055560,4499,14747
1882,7,39,25,0,64207920,4831,60076260,4499,14754
1883,14,39,25,0,64243080,4832,60082680,4497,14768
1884,9,40,25,0,64253400,4832,60087300,4497,14777
1885,6,39,25,0,64283580,4832,60102360,4496,14783
1886,12,40,25,0,64315860,4833,60108660,4495,14795
1887,4,39,25,0,64333320,4833,60125220,4495,14799
1888,5,36,25,0,64369860,4833,60593280,4529,14804
1889,9,39,25,0,64385160,4832,60598080,4526,14813
1890,13,40,25,0,64410660,4833,60605280,4526,14826
1891,8,39,25,0,64437540,4834,60909000,4547,14834
1892,10,40,25,0,64463100,4834,60923640,4547,14844
1893,11,38,25,0,64496340,4834,60948420,4546,14855
1894,5,38,25,0,64516200,4833,60965100,4546,14860
1895,4,37,25,0,64540320,4833,61298700,4570,14864
1896,7,38,25,0,64570020,4833,61307160,4568,14871
1897,8,40,25,0,64582560,4834,61312860,4567,14879
1898,10,39,25,0,64621260,4834,61330020,4566,14889
1899,3,38,25,0,64638420,4834,61338240,4565,14892
1900,3,36,25,0,64671300,4834,61858980,4603,14895
1901,9,39,25,0,64696800,4834,61868760,4602,14904
1902,4,38,25,0,64715820,4834,61883640,4602,14908
1903,9,39,25,0,64744260,4834,61890720,4599,14917
1904,12,40,25,0,64769760,4834,61902300,4598,14929
1905,4,39,25,0,64787340,4834,61911360,4598,14933
1906,9,40,25,0,64813200,4835,61917840,4597,14942
1907,8,39,25,0,64836540,4835,61927500,4597,14950
1908,9,39,25,0,64870740,4835,62452020,4633,14959
1909,8,39,25,0,64891800,4836,62459760,4632,14967
1910,8,40,25,0,64918080,4836,62491140,4633,14975
1911,9,39,25,0,64938060,4836,62499660,4632,14984
1912,17,39,25,0,64972620,4836,62526660,4632,15001
1913,8,37,25,0,64993140,4836,62547540,4633,15009
1914,7,38,25,0,65015400,4836,62557380,4632,15016
1915,3,33,25,0,65049780,4836,63499620,4700,15019
1916,10,36,25,0,65064960,4835,64309500,4758,15029
1917,3,32,25,0,65105340,4835,64860840,4797,15032
1918,7,36,25,0,65114160,4835,64864260,4795,15039
1919,4,33,25,0,65156400,4835,64884600,4794,15043
1920,1,30,25,0,65170560,4835,65887080,4868,15044
1921,2,14,25,0,65202180,4831,70184100,5185,15046
1922,3,0,23,2,65229480,4826,74400240,5495,15049
1923,6,0,24,1,65240400,4825,74400240,5493,15055
1924,7,2,25,0,65261880,4825,74400360,5491,15062
1925,13,11,25,0,65280780,4825,74404140,5485,15075
1926,10,16,25,0,65310600,4826,74414220,5482,15085
1927,5,17,25,0,65331960,4826,74428080,5481,15090
1928,12,26,25,0,65348400,4826,74432220,5479,15102
1929,7,27,25,0,65389260,4827,74446740,5474,15109
1930,13,37,25,0,65401500,4827,74455020,5470,15122
1931,13,39,25,0,65442660,4827,74481060,5468,15135
1932,6,39,25,0,65457480,4827,74488980,5468,15141
1933,13,37,25,0,65485860,4827,74522220,5469,15154
1934,10,40,25,0,65511300,4828,74543400,5468,15164
1935,10,40,25,0,65524620,4828,74550480,5467,15174
1936,10,39,25,0,65566380,4828,74593380,5468,15184
1937,12,39,25,0,65581680,4828,74650740,5471,15196
1938,8,40,25,0,65602200,4829,74662440,5470,15204
1939,8,38,25,0,65641860,4830,74813520,5479,15212
1940,9,40,25,0,65655540,4830,74898540,5485,15221
1941,10,40,25,0,65678940,4830,74959560,5487,15231
1942,2,37,25,0,65711760,4831,75019380,5490,15233
1943,3,35,25,0,65738700,4831,75149940,5498,15236
1944,5,37,25,0,65755080,4831,75207180,5500,15241
1945,5,37,25,0,65789100,4832,75269580,5503,15246
1946,7,40,25,0,65810220,4832,75351900,5506,15253
1947,13,40,25,0,65845020,4832,75361380,5505,15266
1948,2,39,25,0,65857620,4832,75490260,5513,15268
1949,1,34,25,0,65894820,4833,75610920,5521,15269
1950,9,38,25,0,65913660,4832,75705480,5526,15278
1951,5,37,25,0,65943960,4832,75714840,5523,15283
1952,7,40,25,0,65954220,4832,75720000,5522,15290
1953,10,39,25,0,65996700,4833,75734940,5521,15300
1954,12,40,25,0,66011040,4833,75742920,5520,15312
1955,6,40,25,0,66024660,4833,75745800,5519,15318
1956,3,35,25,0,66062820,4834,75903600,5530,15321
1957,5,36,25,0,66087720,4834,75930060,5530,15326
1958,14,38,25,0,66124080,4835,75938940,5527,15340
1959,7,40,25,0,66133620,4835,75949740,5526,15347
1960,14,40,25,0,66161460,4835,75968520,5526,15361
1961,12,40,25,0,66188280,4835,75982320,5525,15373
1962,10,38,25,0,66206640,4835,75996600,5525,15383
1963,10,40,25,0,66237960,4835,76003260,5523,15393
1964,8,40,25,0,66270900,4836,76111560,5528,15401
1965,6,40,25,0,66286260,4835,76113660,5527,15407
1966,5,39,25,0,66316680,4836,76127460,5525,15412
1967,3,39,25,0,66335040,4836,76128900,5524,15415
1968,4,35,25,0,66375780,4836,76603740,5558,15419
1969,2,30,25,0,66404880,4836,76938840,5580,15421
1970,2,28,25,0,66418320,4835,77128140,5593,15423
1971,3,24,25,0,66448980,4835,77656500,5630,15426
1972,11,31,25,0,66462720,4835,77701500,5632,15437
1973,5,28,25,0,66502140,4835,77717520,5628,15442
1974,7,33,25,0,66511080,4835,77721300,5626,15449
1975,9,37,25,0,66540900,4835,77732400,5624,15458
1976,4,37,25,0,66567960,4836,77742960,5622,15462
1977,10,39,25,0,66591360,4836,77768160,5622,15472
1978,15,39,25,0,66621720,4836,77784240,5621,15487
1979,8,38,25,0,66645480,4836,77795760,5620,15495
1980,14,40,25,0,66663360,4836,77799240,5618,15509
1981,8,38,25,0,66693900,4837,77810580,5618,15517
1982,10,39,25,0,66714060,4837,77824980,5617,15527
1983,13,40,25,0,66748080,4837,77833440,5614,15540
1984,9,39,25,0,66766080,4837,77839620,5613,15549
1985,9,40,25,0,66796680,4837,77871420,5613,15558
1986,11,40,25,0,66810600,4837,77874060,5612,15569
1987,10,38,25,0,66845040,4837,78187320,5632,15579
1988,13,39,25,0,66874860,4837,78192240,5630,15592
1989,6,38,25,0,66896160,4837,78225660,5630,15598
1990,5,34,25,0,66931440,4836,78274620,5632,15603
1991,3,34,25,0,66945480,4836,78333000,5635,15606
1992,6,35,25,0,66973560,4837,78336300,5633,15612
1993,5,37,25,0,66988680,4837,78340740,5631,15617
1994,4,34,25,0,67027260,4837,78534480,5643,15621
1995,5,34,25,0,67048260,4837,78759480,5658,15626
1996,2,31,25,0,67072980,4837,78957660,5671,15628
1997,5,30,25,0,67099260,4837,79460340,5705,15633
1998,2,25,25,0,67127400,4836,80122020,5752,15635
1999,3,21,25,0,67154100,4836,80647380,5788,15638
2000,11,25,25,0,67176180,4835,80895960,5803,15649
2001,11,31,25,0,67200660,4835,80903160,5798,15660
2002,13,40,25,0,67213680,4835,80905200,5793,15673
2003,9,40,25,0,67225740,4835,80912220,5793,15682
2004,14,40,25,0,67261260,4836,80925540,5792,15696
2005,9,40,25,0,67293720,4837,80964780,5793,15705
2006,8,38,25,0,67327860,4837,81026340,5796,15713
2007,9,37,25,0,67351560,4838,81076560,5798,15722
2008,8,39,25,0,67374240,4838,81152400,5801,15730
2009,9,37,25,0,67409400,4838,81213180,5803,15739
2010,5,38,25,0,67422840,4837,81240780,5804,15744
2011,7,38,25,0,67454520,4837,81246600,5800,15751
2012,10,40,25,0,67464840,4837,81249900,5799,15761
2013,7,39,25,0,67491840,4838,81259260,5798,15768
2014,5,37,25,0,67526640,4838,81276000,5798,15773
2015,4,36,25,0,67552800,4839,81328320,5800,15777
2016,6,37,25,0,67574160,4838,81383460,5802,15783
2017,8,40,25,0,67574160,4838,81383460,5802,15791
2018,10,40,25,0,67574160,4838,81383460,5802,15801
2019,7,40,25,0,67574160,4838,81383460,5802,15808
2020,8,40,25,0,67574160,4838,81383460,5802,15816
2021,3,40,25,0,67574160,4838,81383460,5802,15819
2022,3,40,25,0,67574160,4838,81383460,5802,15822
2023,15,40,25,0,67574160,4838,81383460,5802,15837
2024,5,40,25,0,67574160,4838,81383460,5802,15842
2025,9,40,25,0,67574160,4838,81383460,5802,15851
2026,11,40,25,0,67574160,4838,81383460,5802,15862
2027,14,40,25,0,67574160,4838,81383460,5802,15876
2028,6,40,25,0,67574160,4838,81383460,5802,15882
2029,11,40,25,0,67574160,4838,81383460,5802,15893
2030,11,40,25,0,67574160,4838,81383460,5802,15904
2031,11,40,25,0,67574160,4838,81383460,5802,15915
2032,8,40,25,0,67574160,4838,81383460,5802,15923
2033,7,40,25,0,67574160,4838,81383460,5802,15930
2034,6,40,25,0,67574160,4838,81383460,5802,15936
2035,10,40,25,0,67574160,4838,81383460,5802,15946
2036,6,40,25,0,67574160,4838,81383460,5802,15952
2037,7,40,25,0,67574160,4838,81383460,5802,15959
2038,6,40,25,0,67574160,4838,81383460,5802,15965
2039,9,40,25,0,67574160,4838,81383460,5802,15974
2040,7,40,25,0,67574160,4838,81383460,5802,15981
2042,4,40,25,0,67574160,4838,81383460,5802,15985
2041,0,40,25,0,67574160,4838,81383460,5802,15985
2043,2,40,25,0,67574160,4838,81383460,5802,15987
2044,2,40,25,0,67574160,4838,81383460,5802,15989
2045,8,40,25,0,67574160,4838,81383460,5802,15997
2046,9,40,25,0,67574160,4838,81383460,5802,16006
2047,7,40,25,0,67574160,4838,81383460,5802,16013
2048,6,40,25,0,67574160,4838,81383460,5802,16019
2049,5,40,25,0,67574160,4838,81383460,5802,16024
2050,6,40,25,0,67574160,4838,81383460,5802,16030
2051,10,40,25,0,67574160,4838,81383460,5802,16040
2052,3,40,25,0,67574160,4838,81383460,5802,16043
2053,6,40,25,0,67574160,4838,81383460,5802,16049
2054,13,40,25,0,67574160,4838,81383460,5802,16062
2055,13,40,25,0,67574160,4838,81383460,5802,16075
2056,10,40,25,0,67574160,4838,81383460,5802,16085
2057,13,40,25,0,67574160,4838,81383460,5802,16098
2058,6,40,25,0,67574160,4838,81383460,5802,16104
2059,6,40,25,0,67574160,4838,81383460,5802,16110
2060,8,40,25,0,67574160,4838,81383460,5802,16118
2061,4,40,25,0,67574160,4838,81383460,5802,16122
2062,5,40,25,0,67574160,4838,81383460,5802,16127
2063,6,40,25,0,67574160,4838,81383460,5802,16133
2064,5,40,25,0,67574160,4838,81383460,5802,16138
2065,5,40,25,0,67574160,4838,81383460,5802,16143
2066,7,40,25,0,67574160,4838,81383460,5802,16150
2067,9,40,25,0,67574160,4838,81383460,5802,16159
2068,2,40,25,0,67574160,4838,81383460,5802,16161
2069,9,40,25,0,67574160,4838,81383460,5802,16170
2070,11,40,25,0,67574160,4838,81383460,5802,16181
2071,6,40,25,0,67574160,4838,81383460,5802,16187
2072,7,40,25,0,67574160,4838,81383460,5802,16194
2073,6,40,25,0,67574160,4838,81383460,5802,16200
2074,9,40,25,0,67574160,4838,81383460,5802,16209
2075,17,40,25,0,67574160,4838,81383460,5802,16226
2076,5,40,25,0,67574160,4838,81383460,5802,16231
2077,7,40,25,0,67574160,4838,81383460,5802,16238
2078,18,40,25,0,67574160,4838,81383460,5802,16256
2079,11,40,25,0,67574160,4838,81383460,5802,16267
2080,9,40,25,0,67574160,4838,81383460,5802,16276
2081,4,40,25,0,67574160,4838,81383460,5802,16280
2082,8,40,25,0,67574160,4838,81383460,5802,16288
2083,7,40,25,0,67574160,4838,81383460,5802,16295
2084,7,40,25,0,67574160,4838,81383460,5802,16302
2085,3,40,25,0,67574160,4838,81383460,5802,16305
2086,7,40,25,0,67574160,4838,81383460,5802,16312
2087,3,40,25,0,67574160,4838,81383460,5802,16315
2088,7,40,25,0,67574160,4838,81383460,5802,16322
2089,7,40,25,0,67574160,4838,81383460,5802,16329
2090,4,40,25,0,67574160,4838,81383460,5802,16333
2091,7,40,25,0,67574160,4838,81383460,5802,16340
2092,5,40,25,0,67574160,4838,81383460,5802,16345
2093,5,40,25,0,67574160,4838,81383460,5802,16350
2094,9,40,25,0,67574160,4838,81383460,5802,16359
2095,5,40,25,0,67574160,4838,81383460,5802,16364
2096,4,40,25,0,67574160,4838,81383460,5802,16368
2097,11,40,25,0,67574160,4838,81383460,5802,16379
2098,13,40,25,0,67574160,4838,81383460,5802,16392
2099,7,40,25,0,67574160,4838,81383460,5802,16399
2100,13,40,25,0,67574160,4838,81383460,5802,16412
2101,7,40,25,0,67574160,4838,81383460,5802,16419
2102,10,40,25,0,67574160,4838,81383460,5802,16429
2103,9,40,25,0,67574160,4838,81383460,5802,16438
2104,5,40,25,0,67574160,4838,81383460,5802,16443
2105,6,40,25,0,67574160,4838,81383460,5802,16449
2106,12,40,25,0,67574160,4838,81383460,5802,16461
2107,15,40,25,0,67574160,4838,81383460,5802,16476
2108,2,40,25,0,67574160,4838,81383460,5802,16478
2109,7,40,25,0,67574160,4838,81383460,5802,16485
2110,7,40,25,0,67574160,4838,81383460,5802,16492
2111,5,40,25,0,67574160,4838,81383460,5802,16497
2112,4,40,25,0,67574160,4838,81383460,5802,16501
2113,6,40,25,0,67574160,4838,81383460,5802,16507
2114,1,40,25,0,67574160,4838,81383460,5802,16508
2115,5,40,25,0,67574160,4838,81383460,5802,16513
2116,10,40,25,0,67574160,4838,81383460,5802,16523
2117,4,40,25,0,67574160,4838,81383460,5802,16527
2118,5,40,25,0,67574160,4838,81383460,5802,16532
2119,11,40,25,0,67574160,4838,81383460,5802,16543
2120,6,40,25,0,67574160,4838,81383460,5802,16549
2121,15,40,25,0,67574160,4838,81383460,5802,16564
2122,6,40,25,0,67574160,4838,81383460,5802,16570
2123,7,40,25,0,67574160,4838,81383460,5802,16577
2124,13,40,25,0,67574160,4838,81383460,5802,16590
2125,7,40,25,0,67574160,4838,81383460,5802,16597
2126,9,40,25,0,67574160,4838,81383460,5802,16606
2127,11,40,25,0,67574160,4838,81383460,5802,16617
2128,13,40,25,0,67574160,4838,81383460,5802,16630
2129,14,40,25,0,67574160,4838,81383460,5802,16644
2130,6,40,25,0,67574160,4838,81383460,5802,16650
2131,3,40,25,0,67574160,4838,81383460,5802,16653
2132,6,40,25,0,67574160,4838,81383460,5802,16659
2133,5,40,25,0,67574160,4838,81383460,5802,16664
2134,5,40,25,0,67574160,4838,81383460,5802,16669
2135,4,40,25,0,67574160,4838,81383460,5802,16673
2136,7,40,25,0,67574160,4838,81383460,5802,16680
2137,5,40,25,0,67574160,4838,81383460,5802,16685
2138,2,40,25,0,67574160,4838,81383460,5802,16687
2139,6,40,25,0,67574160,4838,81383460,5802,16693
2140,7,40,25,0,67574160,4838,81383460,5802,16700
2141,8,40,25,0,67574160,4838,81383460,5802,16708
2142,4,40,25,0,67574160,4838,81383460,5802,16712
2143,12,40,25,0,67574160,4838,81383460,5802,16724
2144,6,40,25,0,67574160,4838,81383460,5802,16730
2145,11,40,25,0,67574160,4838,81383460,5802,16741
2146,11,40,25,0,67574160,4838,81383460,5802,16752
2147,7,40,25,0,67574160,4838,81383460,5802,16759
2148,8,40,25,0,67574160,4838,81383460,5802,16767
2149,6,40,25,0,67574160,4838,81383460,5802,16773
2150,11,40,25,0,67574160,4838,81383460,5802,16784
2151,20,40,25,0,67574160,4838,81383460,5802,16804
2152,16,40,25,0,67574160,4838,81383460,5802,16820
2153,9,40,25,0,67574160,4838,81383460,5802,16829
2154,10,40,25,0,67574160,4838,81383460,5802,16839
2155,15,40,25,0,67574160,4838,81383460,5802,16854
2156,6,40,25,0,67574160,4838,81383460,5802,16860
2157,6,40,25,0,67574160,4838,81383460,5802,16866
2158,5,40,25,0,67574160,4838,81383460,5802,16871
2159,8,40,25,0,67574160,4838,81383460,5802,16879
2160,9,40,25,0,67574160,4838,81383460,5802,16888
2161,6,40,25,0,67574160,4838,81383460,5802,16894
2162,3,40,25,0,67574160,4838,81383460,5802,16897
2163,11,40,25,0,67574160,4838,81383460,5802,16908
2164,2,40,25,0,67574160,4838,81383460,5802,16910
2165,6,40,25,0,67574160,4838,81383460,5802,16916
2166,7,40,25,0,67574160,4838,81383460,5802,16923
2167,12,40,25,0,67574160,4838,81383460,5802,16935
2168,6,40,25,0,67574160,4838,81383460,5802,16941
2169,12,40,25,0,67574160,4838,81383460,5802,16953
2170,11,40,25,0,67574160,4838,81383460,5802,16964
2171,5,40,25,0,67574160,4838,81383460,5802,16969
2172,13,40,25,0,67574160,4838,81383460,5802,16982
2173,13,40,25,0,67574160,4838,81383460,5802,16995
2174,12,40,25,0,67574160,4838,81383460,5802,17007
2175,10,40,25,0,67574160,4838,81383460,5802,17017
2176,7,40,25,0,67574160,4838,81383460,5802,17024
2177,7,40,25,0,67574160,4838,81383460,5802,17031
2178,9,40,25,0,67574160,4838,81383460,5802,17040
2179,9,40,25,0,67574160,4838,81383460,5802,17049
2180,4,40,25,0,67574160,4838,81383460,5802,17053
2181,11,40,25,0,67574160,4838,81383460,5802,17064
2182,7,40,25,0,67574160,4838,81383460,5802,17071
2183,12,40,25,0,67574160,4838,81383460,5802,17083
2184,5,40,25,0,67574160,4838,81383460,5802,17088
2185,2,40,25,0,67574160,4838,81383460,5802,17090
2186,8,40,25,0,67574160,4838,81383460,5802,17098
2187,5,40,25,0,67574160,4838,81383460,5802,17103
2188,8,40,25,0,67574160,4838,81383460,5802,17111
2189,7,40,25,0,67574160,4838,81383460,5802,17118
2190,6,40,25,0,67574160,4838,81383460,5802,17124
2191,9,40,25,0,67574160,4838,81383460,5802,17133
2192,10,40,25,0,67574160,4838,81383460,5802,17143
2193,14,40,25,0,67574160,4838,81383460,5802,17157
2194,8,40,25,0,67574160,4838,81383460,5802,17165
2195,7,40,25,0,67574160,4838,81383460,5802,17172
2196,19,40,25,0,67574160,4838,81383460,5802,17191
2197,11,40,25,0,67574160,4838,81383460,5802,17202
2198,7,40,25,0,67574160,4838,81383460,5802,17209
2199,12,40,25,0,67574160,4838,81383460,5802,17221
2200,5,40,25,0,67574160,4838,81383460,5802,17226
2201,11,40,25,0,67574160,4838,81383460,5802,17237
2202,8,40,25,0,67574160,4838,81383460,5802,17245
2203,9,40,25,0,67574160,4838,81383460,5802,17254
2204,5,40,25,0,67574160,4838,81383460,5802,17259
2205,2,40,25,0,67574160,4838,81383460,5802,17261
2206,3,40,25,0,67574160,4838,81383460,5802,17264
2207,1,40,25,0,67574160,4838,81383460,5802,17265
2208,8,40,25,0,67574160,4838,81383460,5802,17273
2209,5,40,25,0,67574160,4838,81383460,5802,17278
2211,5,40,25,0,67574160,4838,81383460,5802,17283
2210,0,40,25,0,67574160,4838,81383460,5802,17283
2212,7,40,25,0,67574160,4838,81383460,5802,17290
2213,7,40,25,0,67574160,4838,81383460,5802,17297
2214,8,40,25,0,67574160,4838,81383460,5802,17305
2215,14,40,25,0,67574160,4838,81383460,5802,17319
2216,14,40,25,0,67574160,4838,81383460,5802,17333
2217,7,40,25,0,67574160,4838,81383460,5802,17340
2218,10,40,25,0,67574160,4838,81383460,5802,17350
2219,15,40,25,0,67574160,4838,81383460,5802,17365
2220,7,40,25,0,67574160,4838,81383460,5802,17372
2221,11,40,25,0,67574160,4838,81383460,5802,17383
2222,13,40,25,0,67574160,4838,81383460,5802,17396
2223,12,40,25,0,67574160,4838,81383460,5802,17408
2224,7,40,25,0,67574160,4838,81383460,5802,17415
2225,7,40,25,0,67574160,4838,81383460,5802,17422
2226,8,40,25,0,67574160,4838,81383460,5802,17430
2227,11,40,25,0,67574160,4838,81383460,5802,17441
2228,11,40,25,0,67574160,4838,81383460,5802,17452
2229,5,40,25,0,67574160,4838,81383460,5802,17457
2230,2,40,25,0,67574160,4838,81383460,5802,17459
2231,8,40,25,0,67574160,4838,81383460,5802,17467
2232,3,40,25,0,67574160,4838,81383460,5802,17470
2233,7,40,25,0,67574160,4838,81383460,5802,17477
2234,5,40,25,0,67574160,4838,81383460,5802,17482
2235,13,40,25,0,67574160,4838,81383460,5802,17495
2236,3,40,25,0,67574160,4838,81383460,5802,17498
2237,4,40,25,0,67574160,4838,81383460,5802,17502
2238,3,40,25,0,67574160,4838,81383460,5802,17505
2239,7,40,25,0,67574160,4838,81383460,5802,17512
2240,8,40,25,0,67574160,4838,81383460,5802,17520
2241,5,40,25,0,67574160,4838,81383460,5802,17525
2242,14,40,25,0,67574160,4838,81383460,5802,17539
2243,10,40,25,0,67574160,4838,81383460,5802,17549
2244,10,40,25,0,67574160,4838,81383460,5802,17559
2245,10,40,25,0,67574160,4838,81383460,5802,17569
2246,16,40,25,0,67574160,4838,81383460,5802,17585
2247,14,40,25,0,67574160,4838,81383460,5802,17599
2248,9,40,25,0,67574160,4838,81383460,5802,17608
2249,9,40,25,0,67574160,4838,81383460,5802,17617
2250,10,40,25,0,67574160,4838,81383460,5802,17627
2251,8,40,25,0,67574160,4838,81383460,5802,17635
2252,5,40,25,0,67574160,4838,81383460,5802,17640
2253,7,40,25,0,67574160,4838,81383460,5802,17647
2254,5,40,25,0,67574160,4838,81383460,5802,17652
2255,8,40,25,0,67574160,4838,81383460,5802,17660
2256,4,40,25,0,67574160,4838,81383460,5802,17664
2257,2,40,25,0,67574160,4838,81383460,5802,17666
2258,8,40,25,0,67574160,4838,81383460,5802,17674
2259,2,40,25,0,67574160,4838,81383460,5802,17676
2260,5,40,25,0,67574160,4838,81383460,5802,17681
2261,6,40,25,0,67574160,4838,81383460,5802,17687
2262,6,40,25,0,67574160,4838,81383460,5802,17693
2263,6,40,25,0,67574160,4838,81383460,5802,17699
2264,9,40,25,0,67574160,4838,81383460,5802,17708
2265,8,40,25,0,67574160,4838,81383460,5802,17716
2266,13,40,25,0,67574160,4838,81383460,5802,17729
2267,11,40,25,0,67574160,4838,81383460,5802,17740
2268,13,40,25,0,67574160,4838,81383460,5802,17753
2269,14,40,25,0,67574160,4838,81383460,5802,17767
2270,15,40,25,0,67574160,4838,81383460,5802,17782
2271,12,40,25,0,67574160,4838,81383460,5802,17794
2272,7,40,25,0,67574160,4838,81383460,5802,17801
2273,7,40,25,0,67574160,4838,81383460,5802,17808
2274,8,40,25,0,67574160,4838,81383460,5802,17816
2275,5,40,25,0,67574160,4838,81383460,5802,17821
2276,7,40,25,0,67574160,4838,81383460,5802,17828
2277,6,40,25,0,67574160,4838,81383460,5802,17834
2278,4,40,25,0,67574160,4838,81383460,5802,17838
2279,4,40,25,0,67574160,4838,81383460,5802,17842
2280,6,40,25,0,67574160,4838,81383460,5802,17848
2281,9,40,25,0,67574160,4838,81383460,5802,17857
2282,6,40,25,0,67574160,4838,81383460,5802,17863
2283,4,40,25,0,67574160,4838,81383460,5802,17867
2284,3,40,25,0,67574160,4838,81383460,5802,17870
2285,2,40,25,0,67574160,4838,81383460,5802,17872
2286,5,40,25,0,67574160,4838,81383460,5802,17877
2287,7,40,25,0,67574160,4838,81383460,5802,17884
2288,6,40,25,0,67574160,4838,81383460,5802,17890
2289,5,40,25,0,67574160,4838,81383460,5802,17895
2290,9,40,25,0,67574160,4838,81383460,5802,17904
2291,9,40,25,0,67574160,4838,81383460,5802,17913
2292,9,40,25,0,67574160,4838,81383460,5802,17922
2293,7,40,25,0,67574160,4838,81383460,5802,17929
2294,21,40,25,0,67574160,4838,81383460,5802,17950
2295,11,40,25,0,67574160,4838,81383460,5802,17961
2296,17,40,25,0,67574160,4838,81383460,5802,17978
2297,6,40,25,0,67574160,4838,81383460,5802,17984
2298,9,40,25,0,67574160,4838,81383460,5802,17993
2299,4,40,25,0,67574160,4838,81383460,5802,17997
2300,7,40,25,0,67574160,4838,81383460,5802,18004
2301,7,40,25,0,67574160,4838,81383460,5802,18011
2302,3,40,25,0,67574160,4838,81383460,5802,18014
2304,7,40,25,0,67574160,4838,81383460,5802,18021
2303,0,40,25,0,67574160,4838,81383460,5802,18021
2305,3,40,25,0,67574160,4838,81383460,5802,18024
2306,3,40,25,0,67574160,4838,81383460,5802,18027
2307,6,40,25,0,67574160,4838,81383460,5802,18033
2308,9,40,25,0,67574160,4838,81383460,5802,18042
2309,6,40,25,0,67574160,4838,81383460,5802,18048
2310,7,40,25,0,67574160,4838,81383460,5802,18055
2311,9,40,25,0,67574160,4838,81383460,5802,18064
2312,10,40,25,0,67574160,4838,81383460,5802,18074
2313,11,40,25,0,67574160,4838,81383460,5802,18085
2314,17,40,25,0,67574160,4838,81383460,5802,18102
2315,7,40,25,0,67574160,4838,81383460,5802,18109
2316,7,40,25,0,67574160,4838,81383460,5802,18116
2317,6,40,25,0,67574160,4838,81383460,5802,18122
2318,12,40,25,0,67574160,4838,81383460,5802,18134
2319,13,40,25,0,67574160,4838,81383460,5802,18147
2320,12,40,25,0,67574160,4838,81383460,5802,18159
2321,10,40,25,0,67574160,4838,81383460,5802,18169
2322,9,40,25,0,67574160,4838,81383460,5802,18178
2323,6,40,25,0,67574160,4838,81383460,5802,18184
2324,3,40,25,0,67574160,4838,81383460,5802,18187
2325,7,40,25,0,67574160,4838,81383460,5802,18194
2326,5,40,25,0,67574160,4838,81383460,5802,18199
2327,11,40,25,0,67574160,4838,81383460,5802,18210
2328,4,40,25,0,67574160,4838,81383460,5802,18214
2329,5,40,25,0,67574160,4838,81383460,5802,18219
2330,2,40,25,0,67574160,4838,81383460,5802,18221
2331,7,40,25,0,67574160,4838,81383460,5802,18228
2332,5,40,25,0,67574160,4838,81383460,5802,18233
2333,9,40,25,0,67574160,4838,81383460,5802,18242
2334,4,40,25,0,67574160,4838,81383460,5802,18246
2335,2,40,25,0,67574160,4838,81383460,5802,18248
2336,8,40,25,0,67574160,4838,81383460,5802,18256
2337,11,40,25,0,67574160,4838,81383460,5802,18267
2338,11,40,25,0,67574160,4838,81383460,5802,18278
2339,9,40,25,0,67574160,4838,81383460,5802,18287
2340,9,40,25,0,67574160,4838,81383460,5802,18296
2341,16,40,25,0,67574160,4838,81383460,5802,18312
2342,7,40,25,0,67574160,4838,81383460,5802,18319
2343,5,40,25,0,67574160,4838,81383460,5802,18324
2344,3,40,25,0,67574160,4838,81383460,5802,18327
2345,8,40,25,0,67574160,4838,81383460,5802,18335
2346,8,40,25,0,67574160,4838,81383460,5802,18343
2347,9,40,25,0,67574160,4838,81383460,5802,18352
2348,5,40,25,0,67574160,4838,81383460,5802,18357
2349,3,40,25,0,67574160,4838,81383460,5802,18360
2350,8,40,25,0,67574160,4838,81383460,5802,18368
2351,8,40,25,0,67574160,4838,81383460,5802,18376
2352,2,40,25,0,67574160,4838,81383460,5802,18378
2353,5,40,25,0,67574160,4838,81383460,5802,18383
2354,4,40,25,0,67574160,4838,81383460,5802,18387
2355,7,40,25,0,67574160,4838,81383460,5802,18394
2356,5,40,25,0,67574160,4838,81383460,5802,18399
2357,8,40,25,0,67574160,4838,81383460,5802,18407
2358,4,40,25,0,67574160,4838,81383460,5802,18411
2359,10,40,25,0,67574160,4838,81383460,5802,18421
2360,7,40,25,0,67574160,4838,81383460,5802,18428
2361,8,40,25,0,67574160,4838,81383460,5802,18436
2362,8,40,25,0,67574160,4838,81383460,5802,18444
2363,15,40,25,0,67574160,4838,81383460,5802,18459
2364,12,40,25,0,67574160,4838,81383460,5802,18471
2365,11,40,25,0,67574160,4838,81383460,5802,18482
2366,16,40,25,0,67574160,4838,81383460,5802,18498
2367,10,40,25,0,67574160,4838,81383460,5802,18508
2368,11,40,25,0,67574160,4838,81383460,5802,18519
2369,7,40,25,0,67574160,4838,81383460,5802,18526
2370,5,40,25,0,67574160,4838,81383460,5802,18531
2371,5,40,25,0,67574160,4838,81383460,5802,18536
2372,8,40,25,0,67574160,4838,81383460,5802,18544
2373,6,40,25,0,67574160,4838,81383460,5802,18550
2374,2,40,25,0,67574160,4838,81383460,5802,18552
2375,5,40,25,0,67574160,4838,81383460,5802,18557
2376,3,40,25,0,67574160,4838,81383460,5802,18560
2377,2,40,25,0,67574160,4838,81383460,5802,18562
2378,4,40,25,0,67574160,4838,81383460,5802,18566
2379,5,40,25,0,67574160,4838,81383460,5802,18571
2380,4,40,25,0,67574160,4838,81383460,5802,18575
2381,7,40,25,0,67574160,4838,81383460,5802,18582
2382,6,40,25,0,67574160,4838,81383460,5802,18588
2383,2,40,25,0,67574160,4838,81383460,5802,18590
2384,10,40,25,0,67574160,4838,81383460,5802,18600
2385,10,40,25,0,67574160,4838,81383460,5802,18610
2386,10,40,25,0,67574160,4838,81383460,5802,18620
2387,9,40,25,0,67574160,4838,81383460,5802,18629
2388,7,40,25,0,67574160,4838,81383460,5802,18636
2389,11,40,25,0,67574160,4838,81383460,5802,18647
2390,8,40,25,0,67574160,4838,81383460,5802,18655
2391,11,40,25,0,67574160,4838,81383460,5802,18666
2392,17,40,25,0,67574160,4838,81383460,5802,18683
2393,10,40,25,0,67574160,4838,81383460,5802,18693
2394,10,40,25,0,67574160,4838,81383460,5802,18703
2395,10,40,25,0,67574160,4838,81383460,5802,18713
2396,6,40,25,0,67574160,4838,81383460,5802,18719
2397,6,40,25,0,67574160,4838,81383460,5802,18725
2398,10,40,25,0,67574160,4838,81383460,5802,18735
2399,4,40,25,0,67574160,4838,81383460,5802,18739

