Hour,Arrivals,Waiting,Treating,Available Rooms,Total Treatment Time,Average Treatment Time,Total Wait Time,Average Wait Time,Total Arrivals
1,5,0,4,21,2340,2340,0,0,5
2,10,0,12,13,9480,3160,0,0,15
3,4,0,7,18,46620,3885,0,0,19
4,5,0,4,21,87780,4389,0,0,24
5,8,0,8,17,103080,4295,0,0,32
6,8,0,11,14,127200,4386,0,0,40
7,11,0,11,14,176880,4422,0,0,51
8,4,0,10,15,203220,4516,0,0,55
9,6,0,7,18,246120,4557,0,0,61
10,11,0,12,13,277920,4632,0,0,72
11,9,0,8,17,324480,4444,0,0,81
12,8,0,10,15,342960,4341,0,0,89
13,15,0,14,11,386760,4297,0,0,104
14,21,3,25,0,410880,4235,0,0,125
15,8,0,17,8,507720,4376,3840,28,133
16,12,0,14,11,586800,4479,3840,26,145
17,10,0,14,11,633840,4495,3840,24,155
18,7,0,7,18,697980,4503,3840,23,162
19,3,0,4,21,718380,4461,3840,23,165
20,5,0,5,20,738300,4474,3840,22,170
21,4,0,6,19,749340,4460,3840,22,174
22,10,0,13,12,762960,4461,3840,20,184
23,4,0,8,17,808560,4492,3840,20,188
24,6,0,7,18,850980,4550,3840,19,194
25,4,0,7,18,874680,4579,3840,19,198
26,3,0,6,19,901800,4624,3840,19,201
27,9,0,10,15,925080,4625,3840,18,210
28,7,0,11,14,960600,4663,3840,17,217
29,6,0,9,16,997740,4662,3840,17,223
30,7,0,10,15,1026420,4665,3840,16,230
31,6,0,7,18,1069620,4670,3840,16,236
32,12,0,12,13,1103280,4674,3840,15,248
33,5,0,8,17,1137360,4642,3840,15,253
34,7,0,7,18,1170600,4626,3840,14,260
35,8,0,11,14,1188780,4625,3840,14,268
36,8,0,10,15,1238160,4654,3840,13,276
37,8,0,11,14,1273920,4666,3840,13,284
38,5,0,9,16,1302360,4651,3840,13,289
39,10,0,12,13,1337520,4660,3840,12,299
40,11,0,9,16,1398240,4645,3840,12,310
41,7,0,12,13,1422240,4663,3840,12,317
42,6,0,7,18,1477680,4676,3840,11,323
43,5,0,8,17,1493580,4667,3840,11,328
44,5,0,6,19,1533780,4690,3840,11,333
45,8,0,10,15,1548000,4676,3840,11,341
46,5,0,8,17,1590120,4704,3840,11,346
47,6,0,10,15,1612080,4713,3840,10,352
48,11,0,14,11,1648860,4724,3840,10,363
49,3,0,8,17,1700040,4748,3840,10,366
50,7,0,8,17,1737780,4761,3840,10,373
51,8,0,8,17,1768620,4741,3840,10,381
52,4,0,10,15,1776240,4736,3840,9,385
53,5,0,6,19,1825680,4754,3840,9,390
54,6,0,6,19,1853760,4753,3840,9,396
55,5,0,8,17,1865700,4747,3840,9,401
56,7,0,8,17,1903980,4759,3840,9,408
57,8,0,13,12,1916460,4755,3840,9,416
58,9,0,10,15,1962960,4730,3840,9,425
59,8,0,9,16,2003220,4724,3840,8,433
60,9,0,12,13,2029860,4720,3840,8,442
61,9,0,15,10,2073780,4756,3840,8,451
62,8,0,10,15,2138880,4763,3840,8,459
63,14,0,16,9,2168760,4745,3840,8,473
64,5,0,10,15,2212380,4727,3840,8,478
65,9,0,12,13,2263740,4765,3840,7,487
66,13,0,16,9,2294520,4740,3840,7,500
67,9,0,15,10,2339880,4736,3840,7,509
68,8,0,11,14,2395500,4734,3840,7,517
69,8,0,12,13,2431980,4740,3840,7,525
70,6,0,9,16,2474640,4740,3840,7,531
71,2,0,5,20,2503260,4741,3840,7,533
72,6,0,6,19,2534520,4755,3840,7,539
73,7,0,11,14,2546160,4759,3840,7,546
74,6,0,8,17,2591760,4764,3840,6,552
75,1,0,2,23,2626380,4766,3840,6,553
76,2,0,2,23,2643600,4780,3840,6,555
77,5,0,6,19,2648340,4780,3840,6,560
78,10,0,13,12,2657820,4771,3840,6,570
79,5,0,10,15,2700600,4779,3840,6,575
80,8,0,10,15,2735460,4773,3840,6,583
81,8,0,12,13,2768760,4781,3840,6,591
82,12,0,15,10,2824860,4804,3840,6,603
83,12,0,18,7,2868360,4804,3840,6,615
84,9,0,11,14,2952900,4817,3840,6,624
85,2,0,9,16,2976780,4824,3840,6,626
86,10,0,11,14,3011940,4819,3840,6,636
87,8,0,10,15,3051360,4812,3840,5,644
88,8,0,11,14,3085380,4813,3840,5,652
89,7,0,11,14,3122220,4818,3840,5,659
90,11,0,14,11,3167340,4828,3840,5,670
91,10,0,14,11,3211560,4822,3840,5,680
92,7,0,13,12,3254880,4829,3840,5,687
93,7,0,9,16,3316380,4841,3840,5,694
94,5,0,9,16,3340080,4840,3840,5,699
95,7,0,7,18,3386760,4845,3840,5,706
96,9,0,10,15,3409740,4836,3840,5,715
97,7,0,13,12,3425520,4831,3840,5,722
98,7,0,8,17,3478080,4823,3840,5,729
99,6,0,7,18,3515400,4828,3840,5,735
100,6,0,9,16,3531960,4825,3840,5,741
101,7,0,8,17,3577740,4834,3840,5,748
102,7,0,9,16,3600540,4826,3840,5,755
103,3,0,4,21,3638400,4825,3840,5,758
104,5,0,5,20,3652980,4819,3840,5,763
105,8,0,9,16,3667560,4813,3840,4,771
106,2,0,5,20,3702180,4820,3840,4,773
107,6,0,5,20,3727260,4815,3840,4,779
108,11,0,13,12,3734340,4806,3840,4,790
109,6,0,9,16,3768360,4788,3840,4,796
110,9,0,10,15,3810600,4793,3840,4,805
111,12,0,17,8,3832980,4791,3840,4,817
112,7,0,10,15,3896880,4787,3840,4,824
113,9,0,13,12,3937380,4801,3840,4,833
114,13,0,14,11,3984060,4788,3840,4,846
115,7,0,12,13,4025940,4787,3840,4,853
116,7,0,11,14,4076880,4801,3840,4,860
117,9,0,13,12,4114380,4806,3840,4,869
118,3,0,5,20,4175400,4815,3840,4,872
119,4,0,3,22,4200060,4811,3840,4,876
120,6,0,7,18,4203060,4803,3840,4,882
121,6,0,8,17,4229520,4806,3840,4,888
122,5,0,6,19,4264440,4807,3840,4,893
123,8,0,7,18,4290360,4799,3840,4,901
124,7,0,6,19,4325820,4795,3840,4,908
125,7,0,11,14,4332720,4792,3840,4,915
126,8,0,11,14,4380000,4802,3840,4,923
127,11,0,14,11,4414200,4798,3840,4,934
128,6,0,8,17,4473540,4799,3840,4,940
129,9,0,12,13,4503180,4805,3840,4,949
130,6,0,12,13,4538460,4812,3840,4,955
131,8,0,10,15,4589340,4815,3840,3,963
132,15,0,19,6,4618260,4815,3840,3,978
133,10,0,16,9,4672740,4807,3840,3,988
134,6,0,9,16,4747680,4819,3840,3,994
135,17,0,19,6,4783140,4821,3840,3,1011
136,12,0,18,7,4846560,4822,3840,3,1023
137,7,0,13,12,4917540,4835,3840,3,1030
138,8,0,8,17,4973880,4829,3840,3,1038
139,4,0,5,20,5006340,4827,3840,3,1042
140,9,0,10,15,5028900,4830,3840,3,1051
141,8,0,11,14,5052540,4821,3840,3,1059
142,5,0,8,17,5084460,4814,3840,3,1064
143,6,0,7,18,5121960,4818,3840,3,1070
144,2,0,7,18,5136480,4822,3840,3,1072
145,6,0,4,21,5178960,4822,3840,3,1078
146,8,0,8,17,5189220,4813,3840,3,1086
147,5,0,6,19,5224860,4815,3840,3,1091
148,1,0,2,23,5248200,4814,3840,3,1092
149,3,0,3,22,5260620,4817,3840,3,1095
150,7,0,8,17,5272200,4819,3840,3,1102
151,12,0,12,13,5299680,4809,3840,3,1114
152,4,0,12,13,5317380,4807,3840,3,1118
153,13,0,17,8,5352360,4804,3840,3,1131
154,13,0,19,6,5410560,4809,3840,3,1144
155,6,0,10,15,5485140,4811,3840,3,1150
156,11,0,13,12,5524740,4812,3840,3,1161
157,10,0,13,12,5570760,4810,3840,3,1171
158,18,0,21,4,5619720,4811,3840,3,1189
159,7,0,14,11,5684460,4809,3840,3,1196
160,9,0,9,16,5759040,4815,3840,3,1205
161,5,0,12,13,5769840,4816,3840,3,1210
162,10,0,10,15,5833620,4821,3840,3,1220
163,8,0,11,14,5864580,4818,3840,3,1228
164,6,0,10,15,5895660,4816,3840,3,1234
165,10,0,13,12,5934180,4820,3840,3,1244
166,6,0,13,12,5963460,4820,3840,3,1250
167,10,0,13,12,6015900,4824,3840,3,1260
168,4,0,8,17,6058560,4823,3840,3,1264
169,10,0,10,15,6098460,4824,3840,3,1274
170,9,0,13,12,6113100,4813,3840,2,1283
171,2,0,4,21,6169860,4816,3840,2,1285
172,5,0,4,21,6205920,4825,3840,2,1290
173,6,0,6,19,6219180,4821,3840,2,1296
174,6,0,9,16,6235440,4822,3840,2,1302
175,7,0,9,16,6267360,4821,3840,2,1309
176,10,0,7,18,6312600,4811,3840,2,1319
177,8,0,11,14,6332760,4812,3840,2,1327
178,15,0,20,5,6354300,4806,3840,2,1342
179,8,0,14,11,6419220,4804,3840,2,1350
180,13,0,12,13,6500040,4811,3840,2,1363
181,13,0,14,11,6550620,4809,3840,2,1376
182,15,0,16,9,6601380,4801,3840,2,1391
183,10,0,20,5,6636240,4805,3840,2,1401
184,5,0,10,15,6720840,4814,3840,2,1406
185,7,0,10,15,6757620,4816,3840,2,1413
186,10,0,15,10,6792420,4824,3840,2,1423
187,6,0,9,16,6852600,4825,3840,2,1429
188,5,0,9,16,6882780,4830,3840,2,1434
189,5,0,8,17,6916920,4833,3840,2,1439
190,5,0,9,16,6937740,4834,3840,2,1444
191,3,0,3,22,6993300,4843,3840,2,1447
192,5,0,7,18,6998220,4843,3840,2,1452
193,4,0,8,17,7013520,4843,3840,2,1456
194,5,0,7,18,7049340,4848,3840,2,1461
195,3,0,6,19,7069260,4848,3840,2,1464
196,4,0,5,20,7096920,4850,3840,2,1468
197,6,0,7,18,7114140,4849,3840,2,1474
198,4,0,6,19,7141680,4851,3840,2,1478
199,5,0,4,21,7165380,4844,3840,2,1483
200,10,0,8,17,7182120,4836,3840,2,1493
201,12,0,9,16,7210920,4820,3840,2,1505
202,11,0,10,15,7251900,4815,3840,2,1516
203,15,0,15,10,7283760,4804,3840,2,1531
204,11,0,15,10,7331700,4801,3840,2,1542
205,3,0,9,16,7380060,4804,3840,2,1545
206,10,0,14,11,7419720,4814,3840,2,1555
207,8,0,10,15,7473000,4811,3840,2,1563
208,8,0,9,16,7519260,4813,3840,2,1571
209,8,0,11,14,7540140,4808,3840,2,1579
210,10,0,11,14,7589100,4809,3840,2,1589
211,7,0,11,14,7618620,4806,3840,2,1596
212,11,0,12,13,7669140,4808,3840,2,1607
213,10,0,11,14,7714740,4803,3840,2,1617
214,7,0,11,14,7756380,4808,3840,2,1624
215,5,0,9,16,7796700,4812,3840,2,1629
216,6,0,7,18,7835520,4812,3840,2,1635
217,2,0,6,19,7851300,4813,3840,2,1637
218,5,0,7,18,7886460,4823,3840,2,1642
219,11,0,8,17,7920360,4814,3840,2,1653
220,3,0,6,19,7939920,4812,3840,2,1656
221,5,0,6,19,7958280,4808,3840,2,1661
222,11,0,12,13,7988880,4812,3840,2,1672
223,10,0,18,7,8006160,4811,3840,2,1682
224,9,0,16,9,8066880,4816,3840,2,1691
225,9,0,13,12,8125320,4816,3840,2,1700
226,5,0,8,17,8175060,4817,3840,2,1705
227,13,0,16,9,8204040,4820,3840,2,1718
228,10,0,13,12,8258640,4815,3840,2,1728
229,11,0,13,12,8311320,4815,3840,2,1739
230,9,0,12,13,8345820,4807,3840,2,1748
231,8,0,10,15,8395980,4808,3840,2,1756
232,12,0,15,10,8428260,4807,3840,2,1768
233,16,0,18,7,8476020,4799,3840,2,1784
234,3,0,10,15,8533380,4802,3840,2,1787
235,7,0,10,15,8577120,4807,3840,2,1794
236,12,0,17,8,8596080,4804,3840,2,1806
237,10,0,15,10,8653380,4804,3840,2,1816
238,10,0,14,11,8704920,4804,3840,2,1826
239,6,0,11,14,8752140,4806,3840,2,1832
240,3,0,6,19,8811660,4817,3840,2,1835
241,7,0,9,16,8835060,4820,3840,2,1842
242,4,0,7,18,8867820,4822,3840,2,1846
243,3,0,3,22,8901180,4821,3840,2,1849
244,1,0,1,24,8915340,4821,3840,2,1850
245,5,0,6,19,8915340,4821,3840,2,1855
246,5,0,6,19,8931660,4817,3840,2,1860
247,9,0,11,14,8944140,4813,3840,2,1869
248,4,0,7,18,8979960,4812,3840,2,1873
249,12,0,13,12,9010440,4813,3840,2,1885
250,8,0,13,12,9041460,4809,3840,2,1893
251,9,0,12,13,9087360,4808,3840,2,1902
252,11,0,13,12,9123540,4801,3840,2,1913
253,8,0,13,12,9164280,4803,3840,1,1921
254,6,0,9,16,9202080,4797,3840,1,1927
255,8,0,9,16,9247620,4801,3840,1,1935
256,8,0,11,14,9270420,4798,3840,1,1943
257,8,0,11,14,9301680,4794,3840,1,1951
258,10,0,12,13,9348180,4796,3840,1,1961
259,7,0,10,15,9387540,4794,3840,1,1968
260,7,0,7,18,9427320,4790,3840,1,1975
261,7,0,8,17,9453960,4789,3840,1,1982
262,5,0,7,18,9489900,4792,3840,1,1987
263,8,0,11,14,9509520,4793,3840,1,1995
264,8,0,11,14,9544200,4791,3840,1,2003
265,5,0,7,18,9591060,4793,3840,1,2008
266,6,0,9,16,9617040,4796,3840,1,2014
267,5,0,6,19,9646320,4792,3840,1,2019
268,7,0,9,16,9670500,4794,3840,1,2026
269,5,0,10,15,9685140,4792,3840,1,2031
270,5,0,7,18,9727980,4794,3840,1,2036
271,11,0,11,14,9759540,4793,3840,1,2047
272,4,0,8,17,9793380,4793,3840,1,2051
273,11,0,10,15,9843660,4797,3840,1,2062
274,10,0,13,12,9875100,4796,3840,1,2072
275,12,0,17,8,9911280,4795,3840,1,2084
276,13,0,16,9,9973440,4792,3840,1,2097
277,9,0,14,11,10021620,4790,3840,1,2106
278,16,0,17,8,10088100,4792,3840,1,2122
279,9,0,15,10,10144560,4794,3840,1,2131
280,12,0,15,10,10204260,4795,3840,1,2143
281,9,0,9,16,10265400,4790,3840,1,2152
282,10,0,11,14,10300200,4788,3840,1,2162
283,10,0,13,12,10340940,4789,3840,1,2172
284,10,0,13,12,10384680,4787,3840,1,2182
285,3,0,6,19,10440960,4791,3840,1,2185
286,4,0,6,19,10463700,4793,3840,1,2189
287,8,0,11,14,10478760,4793,3840,1,2197
288,7,0,10,15,10513800,4792,3840,1,2204
289,3,0,6,19,10552680,4794,3840,1,2207
290,3,0,5,20,10576080,4796,3840,1,2210
291,5,0,6,19,10599120,4798,3840,1,2215
292,6,0,6,19,10620420,4794,3840,1,2221
293,6,0,7,18,10633800,4790,3840,1,2227
294,8,0,11,14,10659960,4793,3840,1,2235
295,7,0,10,15,10697700,4792,3840,1,2242
296,6,0,9,16,10733640,4793,3840,1,2248
297,10,0,10,15,10768500,4790,3840,1,2258
298,10,0,9,16,10806420,4783,3840,1,2268
299,7,0,10,15,10833720,4783,3840,1,2275
300,12,0,13,12,10873440,4781,3840,1,2287
301,8,0,8,17,10933620,4780,3840,1,2295
302,7,0,11,14,10955880,4782,3840,1,2302
303,14,0,18,7,10988820,4781,3840,1,2316
304,8,0,15,10,11042820,4782,3840,1,2324
305,8,0,12,13,11105400,4786,3840,1,2332
306,7,0,12,13,11138280,4786,3840,1,2339
307,10,0,13,12,11183220,4787,3840,1,2349
308,11,0,11,14,11244780,4787,3840,1,2360
309,8,0,12,13,11278740,4787,3840,1,2368
310,5,0,11,14,11310540,4788,3840,1,2373
311,5,0,6,19,11366880,4792,3840,1,2378
312,8,0,9,16,11388540,4791,3840,1,2386
313,6,0,8,17,11426040,4792,3840,1,2392
314,6,0,8,17,11457480,4793,3840,1,2398
315,5,0,8,17,11482800,4794,3840,1,2403
316,10,0,10,15,11515500,4792,3840,1,2413
317,6,0,12,13,11536200,4792,3840,1,2419
318,9,0,11,14,11590740,4795,3840,1,2428
319,6,0,9,16,11627400,4794,3840,1,2434
320,9,0,11,14,11662440,4795,3840,1,2443
321,7,0,14,11,11681280,4795,3840,1,2450
322,13,0,16,9,11742960,4798,3840,1,2463
323,9,0,15,10,11787780,4797,3840,1,2472
324,11,0,14,11,11848080,4798,3840,1,2483
325,4,0,5,20,11915400,4800,3840,1,2487
326,8,0,9,16,11927520,4797,3840,1,2495
327,13,0,11,14,11967540,4792,3840,1,2508
328,15,0,16,9,12004080,4788,3840,1,2523
329,7,0,11,14,12060060,4787,3840,1,2530
330,9,0,13,12,12109800,4794,3840,1,2539
331,5,0,7,18,12158940,4792,3840,1,2544
332,6,0,6,19,12190740,4791,3840,1,2550
333,5,0,8,17,12212160,4794,3840,1,2555
334,9,0,8,17,12248760,4792,3840,1,2564
335,4,0,7,18,12271200,4791,3840,1,2568
336,7,0,9,16,12296940,4792,3840,1,2575
337,6,0,10,15,12321000,4792,3840,1,2581
338,6,0,8,17,12363720,4793,3840,1,2587
339,7,0,9,16,12393720,4794,3840,1,2594
340,3,0,5,20,12428760,4795,3840,1,2597
341,5,0,6,19,12451740,4796,3840,1,2602
342,4,0,6,19,12468180,4795,3840,1,2606
343,11,0,12,13,12489480,4794,3840,1,2617
344,14,0,16,9,12529980,4791,3840,1,2631
345,10,0,19,6,12562440,4791,3840,1,2641
346,9,0,16,9,12623460,4792,3840,1,2650
347,13,0,13,12,12708840,4795,3840,1,2663
348,8,0,14,11,12738900,4794,3840,1,2671
349,10,0,14,11,12787800,4794,3840,1,2681
350,10,0,15,10,12840120,4798,3840,1,2691
351,9,0,15,10,12894900,4802,3840,1,2700
352,15,0,18,7,12954540,4803,3840,1,2715
353,11,0,13,12,13025340,4801,3840,1,2726
354,7,0,12,13,13061520,4800,3840,1,2733
355,9,0,8,17,13116840,4797,3840,1,2742
356,10,0,12,13,13150380,4799,3840,1,2752
357,4,0,8,17,13196160,4802,3840,1,2756
358,7,0,7,18,13233060,4801,3840,1,2763
359,5,0,8,17,13247220,4799,3840,1,2768
360,9,0,11,14,13282920,4802,3840,1,2777
361,6,0,9,16,13318140,4801,3840,1,2783
362,6,0,7,18,13353780,4800,3840,1,2789
363,2,0,4,21,13380180,4800,3840,1,2791
364,8,0,9,16,13398960,4802,3840,1,2799
365,9,0,13,12,13416720,4800,3840,1,2808
366,6,0,6,19,13476960,4799,3840,1,2814
367,6,0,10,15,13484820,4798,3840,1,2820
368,8,0,13,12,13514160,4800,3840,1,2828
369,8,0,11,14,13568520,4803,3840,1,2836
370,11,0,14,11,13600800,4800,3840,1,2847
371,14,0,18,7,13651800,4801,3840,1,2861
372,12,0,19,6,13709100,4803,3840,1,2873
373,6,0,10,15,13783500,4804,3840,1,2879
374,16,0,17,8,13823460,4803,3840,1,2895
375,9,0,17,8,13859100,4800,3840,1,2904
376,7,0,8,17,13945440,4803,3840,1,2911
377,9,0,10,15,13978980,4803,3840,1,2920
378,3,0,6,19,14012520,4803,3840,1,2923
379,7,0,10,15,14029020,4804,3840,1,2930
380,9,0,10,15,14075640,4805,3840,1,2939
381,10,0,16,9,14093400,4805,3840,1,2949
382,5,0,9,16,14145120,4803,3840,1,2954
383,5,0,8,17,14173800,4803,3840,1,2959
384,7,0,8,17,14200620,4800,3840,1,2966
385,4,0,8,17,14227320,4803,3840,1,2970
386,7,0,8,17,14260320,4803,3840,1,2977
387,7,0,10,15,14286180,4803,3840,1,2984
388,4,0,7,18,14321160,4804,3840,1,2988
389,4,0,5,20,14348580,4803,3840,1,2992
390,7,0,6,19,14374860,4802,3840,1,2999
391,15,0,15,10,14397120,4800,3840,1,3014
392,12,0,18,7,14431980,4797,3840,1,3026
393,11,0,19,6,14487120,4800,3840,1,3037
394,12,0,17,8,14553840,4800,3840,1,3049
395,7,0,13,12,14602320,4798,3840,1,3056
396,7,0,9,16,14672880,4804,3840,1,3063
397,15,0,18,7,14701680,4804,3840,1,3078
398,11,0,13,12,14771580,4802,3840,1,3089
399,14,0,18,7,14821260,4804,3840,1,3103
400,12,0,16,9,14887920,4804,3840,1,3115
401,12,0,16,9,14950860,4805,3840,1,3127
402,12,0,10,15,15033360,4804,3840,1,3139
403,7,0,6,19,15074580,4800,3840,1,3146
404,6,0,8,17,15100140,4802,3840,1,3152
405,7,0,10,15,15121200,4801,3840,1,3159
406,2,0,5,20,15154740,4801,3840,1,3161
407,7,0,6,19,15186240,4802,3840,1,3168
408,5,0,7,18,15201300,4801,3840,1,3173
409,5,0,6,19,15226620,4800,3840,1,3178
410,6,0,8,17,15248760,4801,3840,1,3184
411,2,0,3,22,15288660,4803,3840,1,3186
412,7,0,6,19,15305640,4802,3840,1,3193
413,9,0,10,15,15322740,4800,3840,1,3202
414,4,0,8,17,15350280,4799,3840,1,3206
415,6,0,8,17,15386400,4802,3840,1,3212
416,10,0,13,12,15411660,4802,3840,1,3222
417,8,0,14,11,15441780,4801,3840,1,3230
418,12,0,16,9,15489300,4801,3840,1,3242
419,5,0,9,16,15551400,4802,3840,1,3247
420,8,0,8,17,15607200,4806,3840,1,3255
421,8,0,11,14,15624960,4804,3840,1,3263
422,10,0,12,13,15661440,4802,3840,1,3273
423,15,0,16,9,15703620,4799,3840,1,3288
424,12,0,15,10,15754080,4795,3840,1,3300
425,10,0,12,13,15808740,4793,3840,1,3310
426,10,0,16,9,15840300,4794,3840,1,3320
427,7,0,12,13,15890880,4793,3840,1,3327
428,6,0,9,16,15942600,4796,3840,1,3333
429,7,0,9,16,15978000,4796,3840,1,3340
430,4,0,10,15,15991380,4796,3840,1,3344
431,8,0,11,14,16030440,4798,3840,1,3352
432,5,0,8,17,16073940,4799,3840,1,3357
433,1,0,4,21,16107840,4802,3840,1,3358
434,5,0,6,19,16120500,4802,3840,1,3363
435,5,0,6,19,16143660,4801,3840,1,3368
436,9,0,11,14,16157220,4800,3840,1,3377
437,10,0,9,16,16214280,4799,3840,1,3387
438,8,0,11,14,16241700,4799,3840,1,3395
439,5,0,10,15,16264380,4797,3840,1,3400
440,12,0,13,12,16313280,4799,3840,1,3412
441,9,0,12,13,16360260,4799,3840,1,3421
442,7,0,12,13,16404780,4802,3840,1,3428
443,4,0,10,15,16442760,4805,3840,1,3432
444,13,0,15,10,16488840,4807,3840,1,3445
445,10,0,14,11,16534200,4805,3840,1,3455
446,12,0,14,11,16593000,4805,3840,1,3467
447,13,0,19,6,16625280,4803,3840,1,3480
448,10,0,13,12,16710300,4805,3840,1,3490
449,7,0,11,14,16751460,4805,3840,1,3497
450,2,0,7,18,16782780,4806,3840,1,3499
451,8,0,9,16,16813020,4806,3840,1,3507
452,6,0,10,15,16836060,4806,3840,1,3513
453,8,0,13,12,16869780,4808,3840,1,3521
454,7,0,11,14,16917780,4810,3840,1,3528
455,4,0,7,18,16961340,4811,3840,1,3532
456,4,0,5,20,16985880,4810,3840,1,3536
457,7,0,7,18,17015580,4812,3840,1,3543
458,6,0,12,13,17019360,4811,3840,1,3549
459,13,0,14,11,17076360,4812,3840,1,3562
460,11,0,16,9,17111520,4810,3840,1,3573
461,3,0,10,15,17153160,4810,3840,1,3576
462,9,0,9,16,17215020,4814,3840,1,3585
463,9,0,10,15,17240340,4810,3840,1,3594
464,8,0,10,15,17265600,4806,3840,1,3602
465,9,0,11,14,17305140,4806,3840,1,3611
466,14,0,16,9,17340960,4804,3840,1,3625
467,12,0,17,8,17386020,4802,3840,1,3637
468,10,0,15,10,17450340,4804,3840,1,3647
469,7,0,8,17,17529300,4807,3840,1,3654
470,12,0,14,11,17560920,4808,3840,1,3666
471,11,0,15,10,17606280,4807,3840,1,3677
472,4,0,7,18,17659740,4806,3840,1,3681
473,11,0,11,14,17695440,4807,3840,1,3692
474,13,0,17,8,17718420,4804,3840,1,3705
475,9,0,15,10,17766720,4803,3840,1,3714
476,7,0,9,16,17836440,4805,3840,1,3721
477,5,0,9,16,17861160,4805,3840,1,3726
478,3,0,5,20,17904960,4807,3840,1,3729
479,5,0,7,18,17914500,4806,3840,1,3734
480,6,0,8,17,17941080,4807,3840,1,3740
481,6,0,9,16,17960160,4806,3840,1,3746
482,9,0,9,16,18018780,4810,3840,1,3755
483,5,0,5,20,18058620,4809,3840,1,3760
484,6,0,7,18,18071820,4807,3840,1,3766
485,4,0,5,20,18093900,4805,3840,1,3770
486,5,0,4,21,18116340,4804,3840,1,3775
487,11,0,10,15,18130620,4801,3840,1,3786
488,10,0,15,10,18142620,4798,3840,1,3796
489,13,0,17,8,18199440,4799,3840,1,3809
490,8,0,16,9,18244140,4799,3840,1,3817
491,15,0,19,6,18309660,4801,3840,1,3832
492,7,0,12,13,18377760,4802,3840,1,3839
493,8,0,13,12,18409260,4801,3840,0,3847
494,13,0,17,8,18447780,4800,3840,0,3860
495,7,0,12,13,18498900,4798,3840,0,3867
496,12,0,12,13,18557340,4798,3840,0,3879
497,9,0,16,9,18585840,4800,3840,0,3888
498,6,0,6,19,18652800,4797,3840,0,3894
499,6,0,6,19,18679560,4797,3840,0,3900
500,8,0,9,16,18693600,4794,3840,0,3908
501,2,0,6,19,18720540,4795,3840,0,3910
502,3,0,4,21,18745860,4795,3840,0,3913
503,4,0,5,20,18763200,4796,3840,0,3917
504,8,0,10,15,18777240,4796,3840,0,3925
505,7,0,12,13,18803220,4796,3840,0,3932
506,4,0,7,18,18847620,4797,3840,0,3936
507,2,0,4,21,18878280,4798,3840,0,3938
508,8,0,8,17,18897120,4798,3840,0,3946
509,6,0,4,21,18932820,4795,3840,0,3952
510,7,0,7,18,18948600,4794,3840,0,3959
511,11,0,15,10,18962760,4794,3840,0,3970
512,4,0,14,11,18986220,4794,3840,0,3974
513,9,0,9,16,19069440,4798,3840,0,3983
514,11,0,14,11,19099860,4798,3840,0,3994
515,12,0,15,10,19145220,4797,3840,0,4006
516,8,0,13,12,19193160,4797,3840,0,4014
517,6,0,11,14,19235340,4798,3840,0,4020
518,7,0,10,15,19288740,4801,3840,0,4027
519,12,0,14,11,19323420,4800,3840,0,4039
520,9,0,14,11,19367940,4801,3840,0,4048
521,7,0,11,14,19416840,4801,3840,0,4055
522,11,0,14,11,19468740,4804,3840,0,4066
523,7,0,7,18,19531080,4803,3840,0,4073
524,5,0,8,17,19557960,4805,3840,0,4078
525,5,0,6,19,19585020,4803,3840,0,4083
526,6,0,8,17,19603140,4803,3840,0,4089
527,4,0,5,20,19631700,4802,3840,0,4093
528,4,0,5,20,19647840,4801,3840,0,4097
529,8,0,9,16,19667820,4801,3840,0,4105
530,6,0,8,17,19700460,4801,3840,0,4111
531,6,0,5,20,19731900,4798,3840,0,4117
532,4,0,4,21,19758300,4799,3840,0,4121
533,7,0,8,17,19768320,4798,3840,0,4128
534,3,0,6,19,19791540,4797,3840,0,4131
535,10,0,8,17,19828860,4797,3840,0,4141
536,4,0,5,20,19853340,4795,3840,0,4145
537,13,0,15,10,19868940,4795,3840,0,4158
538,10,0,18,7,19892160,4793,3840,0,4168
539,9,0,11,14,19968600,4793,3840,0,4177
540,10,0,14,11,20014920,4796,3840,0,4187
541,8,0,14,11,20056620,4797,3840,0,4195
542,19,0,19,6,20135340,4799,3840,0,4214
543,9,0,18,7,20176680,4798,3840,0,4223
544,21,1,25,0,20238540,4798,4200,0,4244
545,13,0,23,2,20304300,4795,4680,1,4257
546,10,0,18,7,20385540,4797,5160,1,4267
547,3,0,5,20,20480460,4801,5160,1,4270
548,4,0,4,21,20508300,4802,5160,1,4274
549,7,0,10,15,20516520,4803,5160,1,4281
550,4,0,7,18,20553240,4804,5160,1,4285
551,6,0,8,17,20585220,4806,5160,1,4291
552,6,0,10,15,20608320,4807,5160,1,4297
553,6,0,7,18,20661540,4809,5160,1,4303
554,9,0,12,13,20675820,4808,5160,1,4312
555,3,0,7,18,20711880,4807,5160,1,4315
556,2,0,3,22,20743620,4808,5160,1,4317
557,10,0,10,15,20765040,4810,5160,1,4327
558,5,0,8,17,20791560,4808,5160,1,4332
559,7,0,8,17,20830620,4809,5160,1,4339
560,11,0,11,14,20857740,4807,5160,1,4350
561,10,0,11,14,20898720,4805,5160,1,4360
562,9,0,13,12,20929380,4804,5160,1,4369
563,12,0,15,10,20983080,4806,5160,1,4381
564,5,0,8,17,21035580,4804,5160,1,4386
565,10,0,11,14,21073500,4805,5160,1,4396
566,12,0,16,9,21105960,4805,5160,1,4408
567,10,0,17,8,21151980,4806,5160,1,4418
568,9,0,14,11,21210120,4806,5160,1,4427
569,10,0,15,10,21271680,4810,5160,1,4437
570,7,0,11,14,21325860,4810,5160,1,4444
571,7,0,9,16,21370260,4810,5160,1,4451
572,8,0,9,16,21403980,4809,5160,1,4459
573,7,0,10,15,21434700,4810,5160,1,4466
574,5,0,6,19,21476040,4809,5160,1,4471
575,7,0,8,17,21501600,4810,5160,1,4478
576,5,0,9,16,21516540,4809,5160,1,4483
577,4,0,6,19,21554640,4810,5160,1,4487
578,1,0,3,22,21579300,4811,5160,1,4488
579,11,0,12,13,21595560,4812,5160,1,4499
580,4,0,7,18,21628500,4810,5160,1,4503
581,6,0,5,20,21667560,4810,5160,1,4509
582,10,0,12,13,21677760,4809,5160,1,4519
583,4,0,10,15,21706440,4809,5160,1,4523
584,12,0,13,12,21755160,4810,5160,1,4535
585,7,0,10,15,21803460,4811,5160,1,4542
586,8,0,12,13,21830640,4810,5160,1,4550
587,7,0,9,16,21882120,4811,5160,1,4557
588,10,0,15,10,21903060,4811,5160,1,4567
589,6,0,9,16,21958260,4811,5160,1,4573
590,8,0,8,17,22003380,4811,5160,1,4581
591,12,0,13,12,22030440,4810,5160,1,4593
592,11,0,15,10,22070580,4809,5160,1,4604
593,7,0,9,16,22128780,4808,5160,1,4611
594,12,0,14,11,22162620,4808,5160,1,4623
595,4,0,6,19,22217880,4808,5160,1,4627
596,7,0,10,15,22233060,4808,5160,1,4634
597,3,0,5,20,22275060,4808,5160,1,4637
598,5,0,7,18,22298040,4810,5160,1,4642
599,4,0,6,19,22324080,4811,5160,1,4646
600,6,0,6,19,22358280,4812,5160,1,4652
601,6,0,10,15,22364340,4811,5160,1,4658
602,5,0,7,18,22404660,4811,5160,1,4663
603,6,0,7,18,22432800,4811,5160,1,4669
604,3,0,6,19,22453380,4812,5160,1,4672
605,4,0,7,18,22466340,4811,5160,1,4676
606,5,0,6,19,22500180,4812,5160,1,4681
607,5,0,7,18,22521780,4813,5160,1,4686
608,7,0,9,16,22543740,4812,5160,1,4693
609,10,0,13,12,22573080,4813,5160,1,4703
610,17,0,20,5,22625340,4813,5160,1,4720
611,8,0,13,12,22690860,4812,5160,1,4728
612,8,0,13,12,22735560,4813,5160,1,4736
613,9,0,16,9,22764360,4813,5160,1,4745
614,6,0,12,13,22825080,4816,5160,1,4751
615,19,0,21,4,22873740,4816,5160,1,4770
616,7,0,15,10,22928940,4814,5160,1,4777
617,5,0,6,19,22987740,4813,5160,1,4782
618,6,0,6,19,23017500,4813,5160,1,4788
619,8,0,9,16,23036880,4812,5160,1,4796
620,8,0,10,15,23065860,4811,5160,1,4804
621,6,0,10,15,23091300,4810,5160,1,4810
622,3,0,5,20,23131380,4811,5160,1,4813
623,12,0,11,14,23158860,4810,5160,1,4825
624,7,0,8,17,23203020,4809,5160,1,4832
625,5,0,6,19,23239680,4810,5160,1,4837
626,4,0,5,20,23263080,4810,5160,1,4841
627,6,0,8,17,23275440,4809,5160,1,4847
628,9,0,12,13,23298720,4809,5160,1,4856
629,6,0,8,17,23355720,4811,5160,1,4862
630,5,0,11,14,23366520,4811,5160,1,4867
631,9,0,12,13,23403900,4811,5160,1,4876
632,5,0,8,17,23450400,4812,5160,1,4881
633,10,0,10,15,23488560,4812,5160,1,4891
634,14,0,20,5,23503740,4811,5160,1,4905
635,9,0,13,12,23573160,4809,5160,1,4914
636,14,0,18,7,23624280,4811,5160,1,4928
637,11,0,16,9,23688420,4811,5160,1,4939
638,9,0,16,9,23731980,4811,5160,1,4948
639,12,0,17,8,23786040,4812,5160,1,4960
640,9,0,12,13,23855940,4812,5160,1,4969
641,8,0,14,11,23885700,4812,5160,1,4977
642,11,0,16,9,23934600,4813,5160,1,4988
643,11,0,13,12,24004200,4814,5160,1,4999
644,6,0,11,14,24042180,4814,5160,1,5005
645,5,0,6,19,24090960,4814,5160,1,5010
646,4,0,4,21,24120420,4814,5160,1,5014
647,3,0,4,21,24130860,4813,5160,1,5017
648,2,0,4,21,24144780,4814,5160,1,5019
649,3,0,3,22,24162780,4814,5160,1,5022
650,4,0,4,21,24175020,4813,5160,1,5026
651,8,0,9,16,24186960,4813,5160,1,5034
652,4,0,7,18,24215580,4813,5160,1,5038
653,9,0,11,14,24243240,4813,5160,1,5047
654,7,0,12,13,24262680,4812,5160,1,5054
655,13,0,17,8,24316800,4815,5160,1,5067
656,4,0,6,19,24382740,4813,5160,1,5071
657,3,0,4,21,24418200,4816,5160,1,5074
658,10,0,12,13,24432240,4817,5160,1,5084
659,7,0,10,15,24475440,4817,5160,1,5091
660,17,0,19,6,24506760,4815,5160,1,5108
661,6,0,13,12,24563820,4815,5160,1,5114
662,6,0,7,18,24631020,4817,5160,1,5120
663,10,0,13,12,24662040,4819,5160,1,5130
664,8,0,15,10,24691260,4819,5160,1,5138
665,10,0,15,10,24746520,4821,5160,1,5148
666,11,0,13,12,24814920,4822,5160,1,5159
667,5,0,10,15,24856800,4822,5160,0,5164
668,3,0,7,18,24889500,4823,5160,0,5167
669,6,0,6,19,24928200,4824,5160,0,5173
670,12,0,14,11,24937080,4822,5160,0,5185
671,5,0,8,17,25000920,4824,5160,0,5190
672,5,0,8,17,25024080,4824,5160,0,5195
673,9,0,13,12,25029540,4821,5160,0,5204
674,7,0,13,12,25051200,4819,5160,0,5211
675,3,0,15,10,25055880,4819,5160,0,5214
676,3,0,14,11,25081200,4820,5160,0,5217
677,10,0,18,7,25114140,4821,5160,0,5227
678,13,0,22,3,25149660,4819,5160,0,5240
679,12,0,25,0,25192380,4819,6540,1,5252
680,7,0,22,3,25246200,4820,6540,1,5259
681,9,0,20,5,25310220,4822,6540,1,5268
682,14,1,25,0,25344600,4822,7080,1,5282
683,9,0,22,3,25419480,4824,9120,1,5291
684,18,5,25,0,25470960,4824,12000,2,5309
685,10,0,25,0,25542360,4824,18180,3,5319
686,5,0,14,11,25612560,4823,18300,3,5324
687,16,0,22,3,25641420,4821,18300,3,5340
688,7,0,24,1,25667160,4821,19260,3,5347
689,11,0,21,4,25736280,4822,19260,3,5358
690,10,0,19,6,25796760,4822,19260,3,5368
691,7,0,15,10,25849740,4822,19260,3,5375
692,10,0,16,9,25889460,4822,19260,3,5385
693,9,0,19,6,25913460,4821,19260,3,5394
694,4,0,14,11,25953660,4820,19260,3,5398
695,5,0,12,13,25983060,4819,19260,3,5403
696,7,0,15,10,26004960,4820,19260,3,5410
697,7,0,16,9,26034840,4820,19260,3,5417
698,8,0,18,7,26062320,4820,19260,3,5425
699,6,0,18,7,26092320,4820,19260,3,5431
700,6,0,15,10,26137140,4820,19260,3,5437
701,9,0,17,8,26171700,4820,19260,3,5446
702,1,0,10,15,26205060,4819,19260,3,5447
703,1,0,9,16,26218740,4820,19260,3,5448
704,11,0,18,7,26231820,4821,19260,3,5459
705,6,0,19,6,26251380,4820,19260,3,5465
706,9,0,19,6,26293800,4820,19260,3,5474
707,14,0,24,1,26342220,4821,19260,3,5488
708,15,5,25,0,26388060,4821,26160,4,5503
709,12,6,25,0,26452680,4823,39600,7,5515
710,15,8,25,0,26518860,4824,48420,8,5530
711,6,0,25,0,26591640,4825,101700,18,5536
712,6,0,16,9,26662740,4824,101700,18,5542
713,8,0,17,8,26693160,4824,101700,18,5550
714,4,0,16,9,26720640,4824,101700,18,5554
715,9,0,17,8,26761860,4825,101700,18,5563
716,7,0,17,8,26791800,4824,101700,18,5570
717,11,0,19,6,26839920,4825,101700,18,5581
718,5,0,18,7,26862420,4824,101700,18,5586
719,7,0,18,7,26908080,4826,101700,18,5593
720,2,0,11,14,26960100,4828,101700,18,5595
721,2,0,9,16,26980500,4828,101700,18,5597
722,6,0,14,11,26984160,4828,101700,18,5603
723,6,0,12,13,27013980,4826,101700,18,5609
724,6,0,15,10,27024240,4825,101700,18,5615
725,10,0,20,5,27046980,4825,101700,18,5625
726,2,0,11,14,27100680,4825,101700,18,5627
727,4,0,12,13,27123180,4827,101700,18,5631
728,12,0,21,4,27139440,4827,101700,18,5643
729,5,0,17,8,27174720,4825,101700,18,5648
730,10,0,16,9,27225660,4825,101700,17,5658
731,10,0,20,5,27256260,4825,101700,17,5668
732,12,0,23,2,27299880,4825,101700,17,5680
733,8,0,21,4,27351420,4826,101700,17,5688
734,11,0,22,3,27403560,4827,101700,17,5699
735,12,0,23,2,27448620,4825,101700,17,5711
736,7,0,19,6,27499620,4825,101700,17,5718
737,6,0,16,9,27546000,4825,101700,17,5724
738,6,0,18,7,27567840,4826,101700,17,5730
739,7,0,13,12,27620580,4825,101700,17,5737
740,8,0,19,6,27634200,4826,101700,17,5745
741,10,0,24,1,27662220,4826,101700,17,5755
742,7,0,18,7,27740700,4829,101700,17,5762
743,6,0,18,7,27774420,4830,101700,17,5768
744,5,0,13,12,27827700,4831,101700,17,5773
745,5,0,15,10,27843600,4831,101700,17,5778
746,12,0,19,6,27875940,4830,101700,17,5790
747,6,0,14,11,27928440,4830,101700,17,5796
748,3,0,10,15,27959040,4829,101700,17,5799
749,4,0,13,12,27960840,4829,101700,17,5803
750,9,0,16,9,27988140,4828,101700,17,5812
751,7,0,20,5,28002120,4828,101700,17,5819
752,11,0,24,1,28036440,4828,101700,17,5830
753,8,0,17,8,28120320,4830,101700,17,5838
754,11,0,22,3,28140540,4829,101700,17,5849
755,10,0,23,2,28183020,4829,101700,17,5859
756,10,0,23,2,28240020,4830,101700,17,5869
757,6,0,18,7,28304940,4832,101700,17,5875
758,8,0,18,7,28352880,4834,101700,17,5883
759,13,0,23,2,28396380,4835,101700,17,5896
760,5,0,18,7,28442460,4834,101700,17,5901
761,6,0,14,11,28499700,4836,101700,17,5907
762,10,0,18,7,28529460,4836,101700,17,5917
763,6,0,15,10,28570980,4835,101700,17,5923
764,8,0,18,7,28597680,4836,101700,17,5931
765,7,0,17,8,28630080,4835,101700,17,5938
766,3,0,11,14,28674540,4835,101700,17,5941
767,4,0,13,12,28683000,4835,101700,17,5945
768,5,0,13,12,28705260,4834,101700,17,5950
769,5,0,17,8,28713960,4835,101700,17,5955
770,6,0,15,10,28753140,4835,101700,17,5961
771,3,0,13,12,28775640,4835,101700,17,5964
772,7,0,14,11,28805580,4835,101700,17,5971
773,3,0,13,12,28824960,4835,101700,17,5974
774,5,0,13,12,28848780,4835,101700,17,5979
775,7,0,16,9,28865580,4835,101700,16,5986
776,10,0,21,4,28886640,4834,101700,16,5996
777,12,0,24,1,28931160,4834,101700,16,6008
778,10,0,22,3,28986480,4834,101700,16,6018
779,13,0,21,4,29049300,4833,101700,16,6031
780,10,0,21,4,29086980,4831,101700,16,6041
781,13,0,24,1,29134080,4831,105480,17,6054
782,9,0,19,6,29213760,4833,106020,17,6063
783,8,0,17,8,29261820,4833,106020,17,6071
784,14,0,23,2,29297460,4832,106020,17,6085
785,7,0,21,4,29342880,4833,106020,17,6092
786,5,0,17,8,29392560,4834,106020,17,6097
787,11,0,20,5,29432880,4834,106020,17,6108
788,4,0,16,9,29472480,4834,106020,17,6112
789,6,0,14,11,29518200,4835,106020,17,6118
790,12,0,21,4,29539320,4835,106020,17,6130
791,6,0,19,6,29577960,4835,106020,17,6136
792,8,0,19,6,29628060,4837,106020,17,6144
793,3,0,12,13,29675340,4837,106020,17,6147
794,6,0,14,11,29689740,4836,106020,17,6153
795,9,0,20,5,29706900,4836,106020,17,6162
796,5,0,16,9,29745720,4835,106020,17,6167
797,8,0,17,8,29783100,4836,106020,17,6175
798,3,0,14,11,29812440,4836,106020,17,6178
799,12,0,20,5,29838480,4836,106020,17,6190
800,5,0,21,4,29851380,4835,106020,17,6195
801,8,0,17,8,29932200,4838,106020,17,6203
802,8,0,17,8,29962140,4837,106020,17,6211
803,10,0,17,8,30008160,4836,106020,17,6221
804,13,0,24,1,30030540,4835,106020,17,6234
805,13,0,21,4,30097740,4834,106080,16,6247
806,13,0,21,4,30156840,4833,106080,16,6260
807,14,2,25,0,30198360,4834,110100,17,6274
808,9,1,25,0,30254220,4835,114360,18,6283
809,7,0,20,5,30321600,4835,116520,18,6290
810,8,0,15,10,30382440,4835,116520,18,6298
811,5,0,14,11,30415260,4836,116520,18,6303
812,7,0,14,11,30446760,4835,116520,18,6310
813,7,0,18,7,30460860,4835,116520,18,6317
814,4,0,15,10,30497820,4836,116520,18,6321
815,4,0,15,10,30528660,4838,116520,18,6325
816,2,0,11,14,30555600,4837,116520,18,6327
817,1,0,7,18,30579420,4837,116520,18,6328
818,2,0,9,16,30579420,4837,116520,18,6330
819,9,0,18,7,30579420,4837,116520,18,6339
820,7,0,17,8,30612900,4836,116520,18,6346
821,4,0,12,13,30658860,4837,116520,18,6350
822,6,0,13,12,30680160,4836,116520,18,6356
823,7,0,15,10,30696480,4835,116520,18,6363
824,8,0,18,7,30722880,4835,116520,18,6371
825,13,0,21,4,30767040,4835,116520,18,6384
826,7,0,20,5,30805380,4835,116520,18,6391
827,11,0,20,5,30860040,4835,116520,18,6402
828,15,1,25,0,30903840,4835,116520,18,6417
829,10,0,19,6,30976320,4834,118980,18,6427
830,13,0,21,4,31015140,4831,118980,18,6440
831,9,0,19,6,31063860,4831,118980,18,6449
832,14,1,25,0,31099260,4831,118980,18,6463
833,9,0,21,4,31175400,4832,119940,18,6472
834,16,3,25,0,31224240,4833,123960,19,6488
835,12,0,25,0,31280280,4830,128340,19,6500
836,8,0,23,2,31334100,4831,129840,19,6508
837,6,0,17,8,31401180,4833,129840,19,6514
838,7,0,16,9,31452600,4835,129840,19,6521
839,3,0,10,15,31489680,4834,129840,19,6524
840,6,0,13,12,31506300,4834,129840,19,6530
841,6,0,14,11,31522500,4833,129840,19,6536
842,6,0,15,10,31546080,4833,129840,19,6542
843,6,0,19,6,31554600,4832,129840,19,6548
844,7,0,15,10,31609080,4833,129840,19,6555
845,6,0,15,10,31650420,4835,129840,19,6561
846,6,0,15,10,31683120,4835,129840,19,6567
847,5,0,12,13,31712340,4834,129840,19,6572
848,11,0,21,4,31723320,4834,129840,19,6583
849,12,0,24,1,31766520,4834,129840,19,6595
850,10,0,22,3,31824540,4834,129900,19,6605
851,16,2,25,0,31876440,4834,130380,19,6621
852,8,1,25,0,31932000,4835,142320,21,6629
853,16,2,25,0,32005800,4836,143580,21,6645
854,9,0,20,5,32078460,4835,147360,22,6654
855,9,0,20,5,32123580,4835,147360,22,6663
856,9,0,21,4,32167140,4836,147360,22,6672
857,7,0,17,8,32227320,4837,147360,22,6679
858,9,0,18,7,32264280,4837,147360,22,6688
859,7,0,18,7,32295900,4836,147360,22,6695
860,10,0,18,7,32347020,4837,147360,21,6705
861,5,0,16,9,32378880,4837,147360,21,6710
862,4,0,15,10,32413800,4838,147360,21,6714
863,3,0,11,14,32448300,4838,147360,21,6717
864,6,0,11,14,32470500,4837,147360,21,6723
865,5,0,14,11,32476620,4837,147360,21,6728
866,8,0,17,8,32501160,4837,147360,21,6736
867,7,0,20,5,32516100,4836,147360,21,6743
868,6,0,14,11,32570220,4835,147360,21,6749
869,4,0,11,14,32608740,4836,147360,21,6753
870,7,0,12,13,32625420,4834,147360,21,6760
871,7,0,16,9,32637120,4834,147360,21,6767
872,13,0,23,2,32664780,4834,147360,21,6780
873,6,0,18,7,32722320,4834,147360,21,6786
874,14,0,23,2,32769540,4835,147360,21,6800
875,13,2,25,0,32814960,4835,147480,21,6813
876,8,0,19,6,32893020,4835,154980,22,6821
877,12,0,20,5,32942580,4835,154980,22,6833
878,6,0,18,7,32979300,4834,154980,22,6839
879,9,0,20,5,33018060,4835,154980,22,6848
880,14,1,25,0,33062700,4836,157500,22,6862
881,13,0,24,1,33149400,4838,163740,23,6875
882,10,0,24,1,33190380,4837,163740,23,6885
883,6,0,18,7,33258240,4838,163740,23,6891
884,9,0,22,3,33286860,4839,163740,23,6900
885,8,0,21,4,33342180,4841,163740,23,6908
886,5,0,15,10,33399720,4841,163740,23,6913
887,6,0,15,10,33428220,4841,163740,23,6919
888,5,0,15,10,33447840,4841,163740,23,6924
889,5,0,14,11,33485280,4842,163740,23,6929
890,4,0,14,11,33504780,4842,163740,23,6933
891,4,0,11,14,33534900,4841,163740,23,6937
892,6,0,14,11,33546780,4841,163740,23,6943
893,6,0,15,10,33571500,4841,163740,23,6949
894,7,0,17,8,33600540,4842,163740,23,6956
895,11,0,21,4,33631080,4841,163740,23,6967
896,5,0,17,8,33675120,4841,163740,23,6972
897,9,0,17,8,33722640,4842,163740,23,6981
898,6,0,15,10,33763980,4842,163740,23,6987
899,10,0,19,6,33796380,4843,163740,23,6997
900,10,0,20,5,33830520,4841,163740,23,7007
901,7,0,17,8,33874740,4841,163740,23,7014
902,10,0,19,6,33916680,4841,163740,23,7024
903,11,0,19,6,33962160,4840,163740,23,7035
904,7,0,16,9,34008180,4840,163740,23,7042
905,8,0,20,5,34025400,4840,163740,23,7050
906,12,0,25,0,34063200,4840,163740,23,7062
907,10,0,24,1,34124940,4841,164280,23,7072
908,5,0,20,5,34172880,4842,164460,23,7077
909,7,0,15,10,34245180,4844,164460,23,7084
910,4,0,11,14,34288440,4845,164460,23,7088
911,11,0,20,5,34302480,4845,164460,23,7099
912,4,0,18,7,34328640,4845,164460,23,7103
913,5,0,14,11,34379460,4846,164460,23,7108
914,8,0,17,8,34400160,4845,164460,23,7116
915,5,0,16,9,34421520,4844,164460,23,7121
916,16,0,24,1,34469100,4845,164460,23,7137
917,4,0,14,11,34532460,4845,164460,23,7141
918,11,0,19,6,34558500,4844,164460,22,7152
919,9,0,19,6,34600320,4844,164460,22,7161
920,10,0,20,5,34652280,4845,164460,22,7171
921,12,0,22,3,34692360,4844,164460,22,7183
922,10,0,22,3,34743000,4844,164460,22,7193
923,10,0,22,3,34797180,4845,164460,22,7203
924,10,0,25,0,34832640,4845,165120,22,7213
925,7,0,19,6,34907580,4847,165240,22,7220
926,14,0,23,2,34965240,4848,165240,22,7234
927,7,0,20,5,35015820,4849,165240,22,7241
928,8,0,18,7,35066460,4849,165240,22,7249
929,11,0,16,9,35120040,4848,165240,22,7260
930,8,0,12,13,35160840,4845,165240,22,7268
931,10,0,18,7,35175360,4845,165240,22,7278
932,7,0,16,9,35226060,4846,165240,22,7285
933,8,0,19,6,35249880,4846,165240,22,7293
934,6,0,19,6,35283720,4846,165240,22,7299
935,8,0,19,6,35330040,4847,165240,22,7307
936,5,0,16,9,35376360,4848,165240,22,7312
937,10,0,15,10,35415540,4846,165240,22,7322
938,6,0,16,9,35437500,4846,165240,22,7328
939,4,0,13,12,35479140,4847,165240,22,7332
940,6,0,15,10,35500140,4847,165240,22,7338
941,4,0,15,10,35528280,4848,165240,22,7342
942,6,0,16,9,35554980,4849,165240,22,7348
943,5,0,14,11,35594280,4850,165240,22,7353
944,12,0,20,5,35618940,4849,165240,22,7365
945,9,0,22,3,35646060,4848,165240,22,7374
946,10,0,23,2,35687640,4848,165240,22,7384
947,13,4,25,0,35733600,4849,171480,23,7397
948,8,0,24,1,35811600,4851,184920,24,7405
949,3,0,15,10,35875080,4852,184920,24,7408
950,16,0,24,1,35912460,4853,184920,24,7424
951,15,6,25,0,35941860,4851,188040,25,7439
952,8,0,22,3,36015960,4850,197820,26,7447
953,9,0,19,6,36076620,4850,197820,26,7456
954,9,0,22,3,36106140,4851,197820,26,7465
955,5,0,15,10,36170400,4851,197820,26,7470
956,8,0,17,8,36202500,4852,197820,26,7478
957,12,0,21,4,36240240,4852,197820,26,7490
958,10,0,23,2,36273780,4851,197820,26,7500
959,4,0,16,9,36334620,4852,197820,26,7504
960,8,0,16,9,36382800,4853,197820,26,7512
961,5,0,17,8,36401160,4853,197820,26,7517
962,5,0,14,11,36444540,4854,197820,26,7522
963,9,0,18,7,36465000,4853,197820,26,7531
964,5,0,16,9,36506940,4854,197820,26,7536
965,3,0,15,10,36535620,4855,197820,26,7539
966,3,0,12,13,36577020,4857,197820,26,7542
967,4,0,11,14,36599640,4857,197820,26,7546
968,9,0,17,8,36610020,4856,197820,26,7555
969,10,0,21,4,36632220,4855,197820,26,7565
970,5,0,16,9,36685200,4856,197820,26,7570
971,9,0,17,8,36718560,4855,197820,26,7579
972,11,0,18,7,36769920,4856,197820,26,7590
973,5,0,16,9,36792360,4854,197820,26,7595
974,10,0,18,7,36836640,4855,197820,26,7605
975,18,5,25,0,36859680,4854,198780,26,7623
976,6,0,22,3,36920340,4853,210060,27,7629
977,7,0,15,10,36993000,4854,210060,27,7636
978,11,0,21,4,37005180,4852,210060,27,7647
979,6,0,18,7,37062000,4854,210060,27,7653
980,4,0,13,12,37110540,4854,210060,27,7657
981,5,0,12,13,37133280,4854,210060,27,7662
982,4,0,11,14,37152960,4853,210060,27,7666
983,6,0,14,11,37167900,4853,210060,27,7672
984,4,0,14,11,37186680,4853,210060,27,7676
985,6,0,15,10,37204560,4852,210060,27,7682
986,7,0,15,10,37245120,4853,210060,27,7689
987,1,0,10,15,37271220,4853,210060,27,7690
988,4,0,10,15,37289700,4852,210060,27,7694
989,10,0,18,7,37294920,4852,210060,27,7704
990,4,0,17,8,37312920,4851,210060,27,7708
991,8,0,17,8,37357680,4852,210060,27,7716
992,12,0,21,4,37388280,4851,210060,27,7728
993,8,0,18,7,37443780,4851,210060,27,7736
994,14,0,19,6,37479840,4847,210060,27,7750
995,12,0,24,1,37509060,4847,210060,27,7762
996,16,8,25,0,37548900,4848,210300,27,7778
997,10,3,25,0,37634340,4849,228600,29,7788
998,11,0,19,6,37704240,4846,242040,31,7799
999,9,0,19,6,37748880,4846,242040,30,7808
1000,8,0,19,6,37787700,4846,242040,30,7816
1001,14,0,22,3,37836840,4845,242040,30,7830
1002,12,0,25,0,37880100,4845,242580,30,7842
1003,11,0,19,6,37957380,4845,242580,30,7853
1004,7,0,16,9,37999140,4844,242580,30,7860
1005,7,0,14,11,38042520,4844,242580,30,7867
1006,10,0,17,8,38073900,4844,242580,30,7877
1007,3,0,11,14,38107020,4842,242580,30,7880
1008,3,0,7,18,38136900,4842,242580,30,7883
1009,6,0,13,12,38136900,4842,242580,30,7889
1010,4,0,12,13,38152440,4841,242580,30,7893
1011,5,0,12,13,38179620,4841,242580,30,7898
1012,5,0,13,12,38193780,4840,242580,30,7903
1013,6,0,15,10,38208600,4840,242580,30,7909
1014,7,0,18,7,38233560,4840,242580,30,7916
1015,7,0,20,5,38251800,4840,242580,30,7923
1016,7,0,20,5,38304780,4842,242580,30,7930
1017,7,0,15,10,38369640,4843,242580,30,7937
1018,4,0,15,10,38388840,4843,242580,30,7941
1019,9,0,20,5,38409900,4843,242580,30,7950
1020,8,0,18,7,38466540,4844,242580,30,7958
1021,12,0,24,1,38493420,4844,242580,30,7970
1022,12,0,23,2,38553720,4844,242580,30,7982
1023,9,0,16,9,38613480,4841,242580,30,7991
1024,4,0,12,13,38656140,4842,242580,30,7995
1025,5,0,13,12,38680380,4842,242580,30,8000
1026,7,0,18,7,38689140,4842,242580,30,8007
1027,11,0,17,8,38742960,4842,242580,30,8018
1028,9,0,17,8,38778360,4841,242580,30,8027
1029,2,0,12,13,38814780,4841,242580,30,8029
1030,3,0,10,15,38837880,4841,242580,30,8032
1031,5,0,13,12,38843640,4840,242580,30,8037
1032,4,0,14,11,38860680,4841,242580,30,8041
1033,2,0,10,15,38893620,4841,242580,30,8043
1034,6,0,11,14,38908500,4840,242580,30,8049
1035,7,0,14,11,38922660,4839,242580,30,8056
1036,9,0,18,7,38938200,4838,242580,30,8065
1037,9,0,18,7,38980620,4838,242580,30,8074
1038,9,0,23,2,38994120,4837,242580,30,8083
1039,9,0,18,7,39078360,4840,242580,29,8092
1040,9,0,22,3,39110040,4840,242580,29,8101
1041,9,0,21,4,39164820,4841,242580,29,8110
1042,11,0,20,5,39229200,4842,242580,29,8121
1043,10,0,21,4,39267420,4841,242580,29,8131
1044,17,1,25,0,39314220,4840,243480,29,8148
1045,9,0,23,2,39369420,4840,244140,29,8157
1046,7,0,17,8,39426120,4839,244140,29,8164
1047,13,0,23,2,39463140,4839,244140,29,8177
1048,12,0,22,3,39516840,4838,244140,29,8189
1049,7,0,20,5,39570780,4839,244140,29,8196
1050,7,0,17,8,39622380,4840,244140,29,8203
1051,9,0,18,7,39656400,4839,244140,29,8212
1052,8,0,20,5,39689760,4840,244140,29,8220
1053,5,0,17,8,39729120,4840,244140,29,8225
1054,3,0,13,12,39767760,4840,244140,29,8228
1055,8,0,16,9,39793860,4841,244140,29,8236
1056,4,0,14,11,39819480,4840,244140,29,8240
1057,5,0,13,12,39855600,4841,244140,29,8245
1058,5,0,14,11,39875340,4841,244140,29,8250
1059,2,0,11,14,39894660,4840,244140,29,8252
1060,7,0,14,11,39916560,4841,244140,29,8259
1061,3,0,10,15,39940320,4840,244140,29,8262
1062,12,0,20,5,39948960,4839,244140,29,8274
1063,5,0,15,10,39990960,4839,244140,29,8279
1064,2,0,10,15,40030500,4839,244140,29,8281
1065,7,0,14,11,40046160,4840,244140,29,8288
1066,11,0,20,5,40062300,4839,244140,29,8299
1067,16,2,25,0,40101120,4838,245160,29,8315
1068,14,2,25,0,40166280,4838,247260,29,8329
1069,12,0,25,0,40219620,4836,248580,29,8341
1070,10,0,20,5,40291080,4836,248640,29,8351
1071,7,0,16,9,40350060,4836,248640,29,8358
1072,8,0,17,8,40385760,4837,248640,29,8366
1073,6,0,18,7,40414500,4837,248640,29,8372
1074,7,0,18,7,40454280,4838,248640,29,8379
1075,10,0,20,5,40501080,4839,248640,29,8389
1076,7,0,17,8,40547940,4839,248640,29,8396
1077,8,0,18,7,40586220,4839,248640,29,8404
1078,8,0,17,8,40620480,4838,248640,29,8412
1079,9,0,21,4,40654740,4839,248640,29,8421
1080,5,0,15,10,40712640,4840,248640,29,8426
1081,5,0,13,12,40746960,4840,248640,29,8431
1082,7,0,14,11,40772400,4840,248640,29,8438
1083,3,0,14,11,40784880,4839,248640,29,8441
1084,7,0,12,13,40834500,4840,248640,29,8448
1085,7,0,14,11,40851660,4839,248640,29,8455
1086,4,0,14,11,40866000,4839,248640,29,8459
1087,10,0,19,6,40893660,4839,248640,29,8469
1088,12,0,23,2,40933980,4839,248640,29,8481
1089,6,0,17,8,40984260,4838,248640,29,8487
1090,7,0,15,10,41024520,4838,248640,29,8494
1091,10,0,18,7,41062140,4838,248640,29,8504
1092,13,0,21,4,41101620,4837,248640,29,8517
1093,9,0,24,1,41126160,4837,248820,29,8526
1094,13,0,19,6,41213280,4837,248820,29,8539
1095,11,0,21,4,41254080,4836,248820,29,8550
1096,10,0,19,6,41307240,4836,248940,29,8560
1097,11,0,19,6,41358960,4836,248940,29,8571
1098,8,0,20,5,41393640,4836,248940,29,8579
1099,11,0,16,9,41448360,4834,248940,28,8590
1100,7,0,18,7,41477280,4834,248940,28,8597
1101,4,0,14,11,41525220,4835,248940,28,8601
1102,2,0,11,14,41547660,4835,248940,28,8603
1103,5,0,13,12,41566320,4836,248940,28,8608
1104,8,0,15,10,41588580,4835,248940,28,8616
1105,7,0,18,7,41604840,4834,248940,28,8623
1106,7,0,19,6,41638020,4835,248940,28,8630
1107,1,0,13,12,41678820,4836,248940,28,8631
1108,7,0,14,11,41720280,4837,248940,28,8638
1109,1,0,10,15,41739240,4837,248940,28,8639
1110,10,0,17,8,41754420,4837,248940,28,8649
1111,8,0,17,8,41783760,4836,248940,28,8657
1112,5,0,14,11,41825940,4836,248940,28,8662
1113,10,0,18,7,41854200,4836,248940,28,8672
1114,8,0,19,6,41886960,4836,248940,28,8680
1115,7,0,17,8,41930580,4836,248940,28,8687
1116,13,0,22,3,41967600,4836,248940,28,8700
1117,11,0,18,7,42022320,4834,248940,28,8711
1118,17,0,24,1,42073020,4833,249120,28,8728
1119,9,0,21,4,42118200,4832,249120,28,8737
1120,3,0,14,11,42173520,4833,249120,28,8740
1121,7,0,15,10,42208800,4833,249120,28,8747
1122,8,0,16,9,42232800,4832,249120,28,8755
1123,5,0,13,12,42272040,4832,249120,28,8760
1124,13,0,18,7,42295920,4831,249120,28,8773
1125,5,0,14,11,42336720,4830,249120,28,8778
1126,10,0,19,6,42365820,4831,249120,28,8788
1127,2,0,10,15,42413040,4830,249120,28,8790
1128,1,0,10,15,42422340,4831,249120,28,8791
1129,6,0,12,13,42441540,4831,249120,28,8797
1130,3,0,11,14,42457800,4830,249120,28,8800
1131,0,0,9,16,42471000,4831,249120,28,8800
1132,6,0,13,12,42479460,4831,249120,28,8806
1133,7,0,18,7,42487980,4830,249120,28,8813
1134,8,0,21,4,42511020,4830,249120,28,8821
1135,8,0,19,6,42568140,4831,249120,28,8829
1136,9,0,19,6,42608880,4831,249120,28,8838
1137,10,0,19,6,42654960,4831,249120,28,8848
1138,11,0,22,3,42696480,4831,249120,28,8859
1139,4,0,16,9,42739800,4830,249120,28,8863
1140,5,0,13,12,42783720,4831,249120,28,8868
1141,7,0,15,10,42799260,4830,249120,28,8875
1142,12,0,21,4,42835800,4831,249120,28,8887
1143,2,0,14,11,42876300,4831,249120,28,8889
1144,7,0,14,11,42922620,4832,249120,28,8896
1145,11,0,20,5,42942900,4832,249120,27,8907
1146,11,0,21,4,42988920,4831,249120,27,8918
1147,7,0,19,6,43031040,4831,249120,27,8925
1148,9,0,20,5,43072860,4832,249120,27,8934
1149,6,0,15,10,43136640,4833,249120,27,8940
1150,3,0,10,15,43172220,4832,249120,27,8943
1151,3,0,11,14,43185120,4833,249120,27,8946
1152,3,0,11,14,43195680,4832,249120,27,8949
1153,6,0,14,11,43212000,4833,249120,27,8955
1154,4,0,13,12,43237980,4833,249120,27,8959
1155,7,0,15,10,43260660,4833,249120,27,8966
1156,6,0,16,9,43284780,4833,249120,27,8972
1157,9,0,16,9,43319880,4832,249120,27,8981
1158,7,0,16,9,43354320,4832,249120,27,8988
1159,10,0,21,4,43380600,4832,249120,27,8998
1160,9,0,21,4,43426740,4832,249120,27,9007
1161,8,0,17,8,43491480,4833,249120,27,9015
1162,14,0,22,3,43528020,4832,249300,27,9029
1163,11,0,22,3,43581720,4832,249300,27,9040
1164,9,0,21,4,43627320,4832,249300,27,9049
1165,14,0,23,2,43684140,4832,249300,27,9063
1166,10,0,20,5,43748700,4832,249300,27,9073
1167,8,0,19,6,43790400,4832,249300,27,9081
1168,9,0,15,10,43841280,4830,249300,27,9090
1169,16,0,23,2,43874760,4830,249300,27,9106
1170,14,3,25,0,43912860,4829,249660,27,9120
1171,9,2,25,0,43966680,4830,257520,28,9129
1172,7,0,19,6,44043060,4830,263160,28,9136
1173,9,0,15,10,44098620,4830,263160,28,9145
1174,4,0,13,12,44126640,4829,263160,28,9149
1175,5,0,14,11,44152200,4830,263160,28,9154
1176,9,0,17,8,44179980,4830,263160,28,9163
1177,5,0,16,9,44208660,4830,263160,28,9168
1178,9,0,18,7,44244720,4830,263160,28,9177
1179,4,0,14,11,44280840,4830,263160,28,9181
1180,5,0,14,11,44306580,4830,263160,28,9186
1181,6,0,13,12,44343780,4831,263160,28,9192
1182,6,0,14,11,44367780,4830,263160,28,9198
1183,9,0,16,9,44388000,4829,263160,28,9207
1184,6,0,15,10,44422200,4829,263160,28,9213
1185,6,0,15,10,44456760,4830,263160,28,9219
1186,6,0,13,12,44496000,4830,263160,28,9225
1187,10,0,17,8,44513520,4828,263160,28,9235
1188,9,0,19,6,44549160,4829,263160,28,9244
1189,5,0,16,9,44587680,4829,263160,28,9249
1190,13,0,21,4,44621040,4828,263160,28,9262
1191,19,7,25,0,44658120,4828,267960,28,9281
1192,9,5,25,0,44730660,4830,282240,30,9290
1193,6,0,19,6,44804760,4829,303300,32,9296
1194,8,0,15,10,44858040,4829,303300,32,9304
1195,3,0,11,14,44892720,4829,303300,32,9307
1196,8,0,16,9,44904900,4829,303300,32,9315
1197,8,0,17,8,44931960,4828,303300,32,9323
1198,8,0,16,9,44973420,4828,303300,32,9331
1199,9,0,16,9,45007440,4827,303300,32,9340
1200,3,0,13,12,45033420,4826,303300,32,9343
1201,4,0,12,13,45063300,4827,303300,32,9347
1202,4,0,12,13,45081000,4827,303300,32,9351
1203,4,0,13,12,45095340,4827,303300,32,9355
1204,14,0,21,4,45118920,4826,303300,32,9369
1205,4,0,15,10,45162180,4826,303300,32,9373
1206,14,0,24,1,45191880,4826,303300,32,9387
1207,10,0,25,0,45233280,4826,303300,32,9397
1208,10,0,24,1,45299280,4827,310080,32,9407
1209,8,0,16,9,45375600,4827,310080,32,9415
1210,9,0,19,6,45410700,4828,310080,32,9424
1211,12,0,22,3,45458880,4828,310080,32,9436
1212,9,0,20,5,45517380,4829,310080,32,9445
1213,6,0,15,10,45570000,4829,310080,32,9451
1214,10,0,17,8,45601740,4828,310080,32,9461
1215,11,0,20,5,45628740,4827,310080,32,9472
1216,16,3,25,0,45663060,4826,310440,32,9488
1217,8,0,24,1,45717960,4826,311640,32,9496
1218,5,0,15,10,45799440,4828,311640,32,9501
1219,7,0,16,9,45833220,4828,311640,32,9508
1220,7,0,16,9,45861780,4828,311640,32,9515
1221,12,0,20,5,45897240,4827,311640,32,9527
1222,4,0,16,9,45930660,4827,311640,32,9531
1223,10,0,19,6,45973680,4828,311640,32,9541
1224,5,0,15,10,46017120,4828,311640,32,9546
1225,4,0,16,9,46035420,4828,311640,32,9550
1226,5,0,17,8,46064700,4829,311640,32,9555
1227,12,0,16,9,46126260,4829,311640,32,9567
1228,5,0,17,8,46146840,4829,311640,32,9572
1229,1,0,10,15,46197900,4830,311640,32,9573
1230,4,0,12,13,46210020,4831,311640,32,9577
1231,6,0,14,11,46223940,4830,311640,32,9583
1232,8,0,20,5,46235760,4830,311640,32,9591
1233,8,0,18,7,46284300,4830,311640,32,9599
1234,5,0,16,9,46319640,4831,311640,32,9604
1235,9,0,16,9,46364220,4831,311640,32,9613
1236,6,0,18,7,46387440,4831,311640,32,9619
1237,8,0,16,9,46426740,4830,311640,32,9627
1238,6,0,15,10,46458900,4830,311640,32,9633
1239,11,0,19,6,46494300,4830,311640,32,9644
1240,10,0,22,3,46527480,4830,311640,32,9654
1241,6,0,16,9,46591320,4831,311640,32,9660
1242,5,0,17,8,46612620,4831,311640,32,9665
1243,10,0,18,7,46657680,4831,311640,32,9675
1244,6,0,12,13,46712400,4831,311640,32,9681
1245,6,0,15,10,46722120,4830,311640,32,9687
1246,5,0,13,12,46758180,4830,311640,32,9692
1247,4,0,12,13,46778580,4830,311640,32,9696
1248,3,0,11,14,46800480,4830,311640,32,9699
1249,5,0,13,12,46812660,4830,311640,32,9704
1250,2,0,9,16,46845180,4830,311640,32,9706
1251,5,0,13,12,46852320,4831,311640,32,9711
1252,7,0,17,8,46864080,4830,311640,32,9718
1253,6,0,15,10,46895160,4830,311640,32,9724
1254,7,0,19,6,46911000,4830,311640,32,9731
1255,4,0,13,12,46967280,4831,311640,32,9735
1256,10,0,18,7,46992900,4831,311640,31,9745
1257,6,0,16,9,47029320,4830,311640,31,9751
1258,5,0,15,10,47071020,4832,311640,31,9756
1259,8,0,19,6,47093520,4832,311640,31,9764
1260,11,0,21,4,47131260,4831,311640,31,9775
1261,9,0,19,6,47179080,4831,311640,31,9784
1262,9,0,18,7,47237460,4832,311640,31,9793
1263,14,0,21,4,47286420,4832,311640,31,9807
1264,6,0,16,9,47335080,4831,311640,31,9813
1265,10,0,19,6,47362500,4830,311640,31,9823
1266,9,0,18,7,47408700,4830,311640,31,9832
1267,5,0,18,7,47433240,4830,311640,31,9837
1268,8,0,19,6,47478660,4831,311640,31,9845
1269,10,0,22,3,47513460,4832,311640,31,9855
1270,6,0,14,11,47578020,4831,311640,31,9861
1271,7,0,16,9,47600100,4831,311640,31,9868
1272,6,0,15,10,47628600,4830,311640,31,9874
1273,4,0,13,12,47669340,4832,311640,31,9878
1274,7,0,18,7,47680440,4832,311640,31,9885
1275,7,0,17,8,47714640,4831,311640,31,9892
1276,7,0,18,7,47748780,4832,311640,31,9899
1277,9,0,20,5,47795100,4833,311640,31,9908
1278,6,0,15,10,47838780,4832,311640,31,9914
1279,8,0,17,8,47865300,4832,311640,31,9922
1280,11,0,23,2,47886480,4832,311640,31,9933
1281,9,0,20,5,47942640,4831,311640,31,9942
1282,12,0,18,7,48004740,4831,311640,31,9954
1283,10,0,22,3,48032340,4831,311640,31,9964
1284,16,1,25,0,48094680,4831,315120,31,9980
1285,14,2,25,0,48159420,4831,321840,32,9994
1286,10,0,22,3,48225840,4831,322860,32,10004
1287,7,0,19,6,48276660,4831,322860,32,10011
1288,10,0,20,5,48324540,4831,322860,32,10021
1289,16,4,25,0,48359760,4832,328020,32,10037
1290,14,2,25,0,48433680,4831,341040,33,10051
1291,5,0,17,8,48503400,4831,343620,34,10056
1292,11,0,19,6,48554520,4832,343620,34,10067
1293,4,0,15,10,48586200,4831,343620,34,10071
1294,5,0,13,12,48626760,4832,343620,34,10076
1295,2,0,12,13,48640320,4832,343620,34,10078
1296,9,0,16,9,48660300,4831,343620,34,10087
1297,6,0,15,10,48688380,4831,343620,34,10093
1298,3,0,12,13,48721380,4831,343620,34,10096
1299,4,0,12,13,48734760,4830,343620,34,10100
1300,6,0,12,13,48763800,4830,343620,34,10106
1301,7,0,16,9,48778440,4830,343620,33,10113
1302,9,0,21,4,48798120,4831,343620,33,10122
1303,11,0,21,4,48841320,4830,343620,33,10133
1304,9,0,20,5,48892980,4830,343620,33,10142
1305,4,0,16,9,48929880,4830,343620,33,10146
1306,10,0,17,8,48976500,4830,343620,33,10156
1307,8,0,19,6,49004700,4830,343620,33,10164
1308,17,0,24,1,49053060,4829,345600,33,10181
1309,11,1,25,0,49102920,4830,346860,34,10192
1310,9,0,20,5,49176420,4830,347280,34,10201
1311,10,0,22,3,49221420,4830,347280,34,10211
1312,9,0,21,4,49277040,4831,347280,33,10220
1313,11,0,22,3,49331640,4832,347760,33,10231
1314,11,0,21,4,49389600,4832,348540,34,10242
1315,7,0,18,7,49438200,4832,348540,34,10249
1316,8,0,18,7,49491300,4833,348540,33,10257
1317,4,0,14,11,49524120,4833,348540,33,10261
1318,7,0,17,8,49550160,4833,348540,33,10268
1319,3,0,16,9,49573380,4834,348540,33,10271
1320,4,0,12,13,49617780,4834,348540,33,10275
1321,4,0,12,13,49637040,4834,348540,33,10279
1322,4,0,13,12,49651920,4834,348540,33,10283
1323,7,0,15,10,49671540,4834,348540,33,10290
1324,6,0,15,10,49700760,4834,348540,33,10296
1325,7,0,17,8,49718640,4833,348540,33,10303
1326,5,0,15,10,49762920,4834,348540,33,10308
1327,4,0,12,13,49806000,4835,348540,33,10312
1328,7,0,15,10,49820580,4835,348540,33,10319
1329,4,0,14,11,49842420,4834,348540,33,10323
1330,12,0,20,5,49873080,4835,348540,33,10335
1331,13,0,24,1,49911660,4834,348540,33,10348
1332,12,1,25,0,49960980,4834,353400,34,10360
1333,6,0,20,5,50028060,4835,353400,34,10366
1334,8,0,16,9,50091900,4836,353400,34,10374
1335,11,0,20,5,50123100,4835,353400,34,10385
1336,11,0,19,6,50175360,4835,353400,33,10396
1337,9,0,17,8,50214900,4833,353400,33,10405
1338,16,0,23,2,50268540,4834,353400,33,10421
1339,6,0,19,6,50300400,4832,353400,33,10427
1340,9,0,17,8,50354580,4832,353400,33,10436
1341,5,0,12,13,50396280,4832,353400,33,10441
1342,9,0,17,8,50417460,4832,353400,33,10450
1343,6,0,17,8,50437260,4831,353400,33,10456
1344,5,0,15,10,50475480,4832,353400,33,10461
1345,5,0,19,6,50477700,4831,353400,33,10466
1346,9,0,23,2,50494620,4831,353400,33,10475
1347,3,0,20,5,50522100,4830,353400,33,10478
1348,4,0,19,6,50546520,4830,353400,33,10482
1349,2,0,19,6,50560140,4831,353400,33,10484
1350,7,0,20,5,50588280,4831,353400,33,10491
1351,6,0,24,1,50598600,4831,353400,33,10497
1352,8,0,23,2,50643360,4831,353400,33,10505
1353,6,0,23,2,50674620,4831,353400,33,10511
1354,9,2,25,0,50699700,4831,354780,33,10520
1355,10,3,25,0,50740920,4831,360360,34,10530
1356,18,15,25,0,50778120,4832,364500,34,10548
1357,17,26,25,0,50814840,4833,372720,35,10565
1358,14,33,25,0,50855640,4833,383100,36,10579
1359,12,39,25,0,50890500,4834,402780,38,10591
1360,12,40,25,0,50942700,4835,429420,40,10603
1361,5,37,25,0,50978640,4836,443880,41,10608
1362,14,40,25,0,51010740,4837,482160,45,10622
1363,6,36,25,0,51067500,4838,577020,54,10628
1364,4,33,25,0,51101940,4838,661080,62,10632
1365,7,32,25,0,51142080,4838,729960,68,10639
1366,3,28,25,0,51185520,4839,769740,72,10642
1367,7,29,25,0,51209640,4838,826560,77,10649
1368,2,18,25,0,51269760,4838,1126620,105,10651
1369,5,13,25,0,51299100,4836,1410060,132,10656
1370,9,8,25,0,51353400,4835,1553940,145,10665
1371,5,6,25,0,51371460,4834,1710780,160,10670
1372,6,0,25,0,51421200,4833,1898220,178,10676
1373,3,0,19,6,51466080,4833,1898220,177,10679
1374,5,0,18,7,51487080,4832,1898220,177,10684
1375,7,0,22,3,51503760,4832,1898220,177,10691
1376,11,5,25,0,51520680,4833,1899780,177,10702
1377,14,12,25,0,51557520,4833,1905120,178,10716
1378,10,14,25,0,51600540,4833,1917540,178,10726
1379,10,15,25,0,51649260,4834,1944240,181,10736
1380,11,19,25,0,51676800,4833,1951680,181,10747
1381,7,20,25,0,51713100,4834,1962960,182,10754
1382,6,18,25,0,51766380,4835,1982100,184,10760
1383,9,22,25,0,51795300,4836,1992180,185,10769
1384,9,25,25,0,51831600,4836,2002440,185,10778
1385,9,24,25,0,51889080,4837,2011920,186,10787
1386,5,23,25,0,51915180,4837,2069040,191,10792
1387,10,25,25,0,51958440,4837,2119260,196,10802
1388,10,25,25,0,52006080,4837,2132220,197,10812
1389,5,23,25,0,52045020,4838,2164740,200,10817
1390,5,17,25,0,52090020,4837,2399700,221,10822
1391,4,10,25,0,52130460,4836,2670600,246,10826
1392,8,5,25,0,52178280,4834,2822640,260,10834
1393,2,0,20,5,52206780,4832,2985000,275,10836
1394,8,0,25,0,52220400,4832,2985000,275,10844
1395,3,0,19,6,52266600,4832,2985000,275,10847
1396,4,0,18,7,52292580,4832,2985000,275,10851
1397,3,0,19,6,52298760,4832,2985000,275,10854
1398,6,0,23,2,52310520,4832,2985000,275,10860
1399,5,0,19,6,52349940,4832,2985000,275,10865
1400,4,0,20,5,52363140,4831,2985000,274,10869
1401,8,0,25,0,52381440,4832,2985060,274,10877
1402,9,3,25,0,52404960,4831,2988360,274,10886
1403,8,0,24,1,52460760,4831,2997900,275,10894
1404,6,0,22,3,52490700,4830,2997900,275,10900
1405,9,1,25,0,52510860,4830,2997900,275,10909
1406,1,0,17,8,52564980,4830,2997960,275,10910
1407,11,2,25,0,52573260,4831,2997960,274,10921
1408,12,7,25,0,52608600,4831,3002340,274,10933
1409,14,14,25,0,52649460,4831,3012480,275,10947
1410,10,17,25,0,52695720,4833,3032880,277,10957
1411,9,21,25,0,52724760,4833,3054180,278,10966
1412,7,20,25,0,52768260,4834,3077820,280,10973
1413,1,12,25,0,52820340,4834,3179040,290,10974
1414,6,12,25,0,52846920,4834,3218160,293,10980
1415,8,12,25,0,52891020,4835,3234180,294,10988
1416,2,6,25,0,52922880,4834,3318540,302,10990
1417,6,0,25,0,52979280,4834,3441900,313,10996
1418,7,0,23,2,53008080,4832,3441900,313,11003
1419,3,0,21,4,53035680,4833,3441900,313,11006
1420,6,0,22,3,53062080,4833,3441900,312,11012
1421,9,0,23,2,53093640,4832,3442860,312,11021
1422,6,0,22,3,53126760,4832,3442860,312,11027
1423,6,0,22,3,53151420,4832,3442860,312,11033
1424,7,0,21,4,53188680,4832,3442860,312,11040
1425,9,0,25,0,53206560,4831,3442860,311,11049
1426,7,1,25,0,53244900,4832,3445260,311,11056
1427,16,12,25,0,53273280,4832,3450780,312,11072
1428,6,10,25,0,53318940,4833,3458880,312,11078
1429,9,12,25,0,53356140,4833,3472200,313,11087
1430,12,14,25,0,53410260,4834,3487260,314,11099
1431,7,13,25,0,53447220,4834,3509880,316,11106
1432,8,10,25,0,53493720,4833,3567120,321,11114
1433,8,11,25,0,53523900,4833,3586980,322,11122
1434,8,9,25,0,53570820,4833,3613620,325,11130
1435,15,16,25,0,53607180,4832,3621240,325,11145
1436,6,16,25,0,53638320,4833,3629580,325,11151
1437,6,12,25,0,53690940,4833,3655560,328,11157
1438,6,5,25,0,53733960,4831,3818820,342,11163
1439,6,0,22,3,53764200,4828,3939900,353,11169
1440,5,0,20,5,53792520,4827,3939900,352,11174
1441,6,0,19,6,53825220,4827,3939900,352,11180
1442,3,0,18,7,53845380,4827,3939900,352,11183
1443,5,0,19,6,53852700,4826,3939900,352,11188
1444,7,0,20,5,53876580,4826,3939900,352,11195
1445,6,0,24,1,53884260,4826,3939900,352,11201
1446,7,0,23,2,53917440,4825,3939900,351,11208
1447,4,0,24,1,53937060,4826,3939900,351,11212
1448,8,0,23,2,53983860,4826,3940200,351,11220
1449,7,0,22,3,54018120,4826,3940260,351,11227
1450,6,0,22,3,54046080,4825,3940260,351,11233
1451,11,3,25,0,54074760,4826,3940320,350,11244
1452,13,11,25,0,54101520,4826,3945480,350,11257
1453,14,17,25,0,54150420,4827,3958140,351,11271
1454,10,19,25,0,54191280,4827,3969240,352,11281
1455,9,23,25,0,54227700,4828,3985200,353,11290
1456,9,25,25,0,54267180,4829,4009920,355,11299
1457,6,24,25,0,54312540,4830,4036920,357,11305
1458,8,28,25,0,54337500,4830,4059300,359,11313
1459,10,30,25,0,54392940,4832,4071900,359,11323
1460,5,29,25,0,54427020,4832,4098600,362,11328
1461,7,28,25,0,54474060,4833,4155420,366,11335
1462,5,23,25,0,54514860,4832,4251960,375,11340
1463,4,15,25,0,54559860,4831,4518660,398,11344
1464,4,7,25,0,54605160,4830,4818960,425,11348
1465,9,6,25,0,54641760,4829,4831740,425,11357
1466,6,5,25,0,54662760,4828,4854540,427,11363
1467,6,5,25,0,54693180,4828,4922280,433,11369
1468,6,0,20,5,54756780,4827,5042220,443,11375
1469,9,1,25,0,54770940,4827,5042220,443,11384
1470,6,0,25,0,54815700,4828,5048220,443,11390
1471,6,0,24,1,54852600,4828,5050620,443,11396
1472,13,4,25,0,54889560,4828,5051340,443,11409
1473,16,12,25,0,54928620,4828,5058120,443,11425
1474,7,13,25,0,54965340,4829,5078160,444,11432
1475,9,16,25,0,54999780,4829,5093580,445,11441
1476,12,20,25,0,55048020,4830,5116320,447,11453
1477,17,33,25,0,55070580,4830,5124300,447,11470
1478,13,37,25,0,55124520,4831,5137020,447,11483
1479,10,39,25,0,55158300,4832,5153820,448,11493
1480,6,36,25,0,55206000,4833,5186700,451,11499
1481,13,40,25,0,55243620,4833,5202900,452,11512
1482,6,36,25,0,55279200,4834,5216220,453,11518
1483,13,40,25,0,55321020,4834,5273340,458,11531
1484,5,39,25,0,55353840,4834,5329500,462,11536
1485,8,39,25,0,55398540,4835,5397540,468,11544
1486,5,38,25,0,55427340,4835,5465220,474,11549
1487,6,36,25,0,55483920,4837,5507880,477,11555
1488,4,32,25,0,55520100,4837,5664120,491,11559
1489,5,27,25,0,55559520,4836,5855520,507,11564
1490,7,23,25,0,55604820,4835,6036600,522,11571
1491,6,22,25,0,55632060,4835,6151500,532,11577
1492,7,24,25,0,55667160,4835,6220140,538,11584
1493,3,15,25,0,55728240,4836,6453300,558,11587
1494,11,13,25,0,55766280,4834,6636240,573,11598
1495,10,20,25,0,55783140,4834,6638940,573,11608
1496,9,17,25,0,55843800,4834,6651780,573,11617
1497,9,17,25,0,55882920,4834,6667680,574,11626
1498,14,24,25,0,55911480,4833,6672780,574,11640
1499,5,23,25,0,55950060,4834,6684720,575,11645
1500,15,32,25,0,55987080,4835,6696960,575,11660
1501,8,33,25,0,56026380,4835,6710760,576,11668
1502,12,37,25,0,56073540,4836,6727260,577,11680
1503,16,40,25,0,56114880,4837,6739740,577,11696
1504,8,39,25,0,56141880,4836,6754020,578,11704
1505,7,37,25,0,56203920,4838,6781260,580,11711
1506,10,38,25,0,56229780,4838,6810840,583,11721
1507,4,35,25,0,56271900,4839,6836880,584,11725
1508,10,36,25,0,56309700,4838,6918000,591,11735
1509,6,34,25,0,56361840,4840,6931680,592,11741
1510,6,37,25,0,56379780,4840,6933960,592,11747
1511,6,34,25,0,56432580,4841,7021980,599,11753
1512,4,31,25,0,56469180,4841,7028040,599,11757
1513,5,30,25,0,56503080,4841,7176540,612,11762
1514,8,25,25,0,56559300,4841,7543440,642,11770
1515,6,21,25,0,56593080,4839,7742040,659,11776
1516,7,18,25,0,56635080,4839,7906320,673,11783
1517,1,0,20,5,56691660,4834,9722040,827,11784
1518,8,0,20,5,56706120,4832,9722040,827,11792
1519,9,0,21,4,56733960,4831,9722040,826,11801
1520,10,2,25,0,56749920,4831,9723420,825,11811
1521,10,5,25,0,56784480,4831,9727800,825,11821
1522,11,6,25,0,56836140,4831,9736620,825,11832
1523,3,5,25,0,56859660,4831,9745320,826,11835
1524,13,6,25,0,56906700,4830,9784920,828,11848
1525,9,7,25,0,56948220,4831,9790380,828,11857
1526,15,16,25,0,56986620,4831,9806520,828,11872
1527,5,16,25,0,57021600,4832,9818580,829,11877
1528,13,23,25,0,57062880,4833,9824520,829,11890
1529,10,25,25,0,57109260,4834,9844680,829,11900
1530,7,28,25,0,57138540,4835,9877260,832,11907
1531,4,24,25,0,57187980,4836,9925380,835,11911
1532,5,24,25,0,57215820,4836,9998700,841,11916
1533,6,23,25,0,57257940,4837,10052820,846,11922
1534,6,20,25,0,57310680,4837,10062300,846,11928
1535,2,14,25,0,57354600,4838,10247460,861,11930
1536,2,3,25,0,57402180,4837,10536840,885,11932
1537,5,0,18,7,57435060,4833,10598100,890,11937
1538,7,0,22,3,57445860,4833,10598100,890,11944
1539,7,0,23,2,57479100,4833,10598100,889,11951
1540,8,3,25,0,57495660,4834,10598760,889,11959
1541,6,0,23,2,57549120,4834,10601940,888,11965
1542,7,0,25,0,57572640,4833,10604880,888,11972
1543,6,0,22,3,57607500,4833,10604880,888,11978
1544,5,0,22,3,57640560,4833,10604880,887,11983
1545,7,0,24,1,57666540,4834,10604880,887,11990
1546,9,0,24,1,57706140,4833,10606620,886,11999
1547,14,7,25,0,57740100,4834,10612380,886,12013
1548,9,10,25,0,57767460,4834,10615680,885,12022
1549,6,9,25,0,57812400,4835,10622520,885,12028
1550,8,5,25,0,57869100,4834,10664640,888,12036
1551,10,8,25,0,57896160,4834,10670520,888,12046
1552,9,12,25,0,57925920,4834,10673700,888,12055
1553,11,13,25,0,57977220,4835,10692540,889,12066
1554,7,11,25,0,58012860,4834,10711140,889,12073
1555,8,13,25,0,58047240,4834,10715880,889,12081
1556,8,11,25,0,58102020,4835,10765860,893,12089
1557,5,1,25,0,58149120,4833,10932360,906,12094
1558,6,0,24,1,58172040,4831,10940820,906,12100
1559,1,0,18,7,58204920,4831,10940820,906,12101
1560,7,0,21,4,58236660,4832,10940820,906,12108
1561,8,0,24,1,58254540,4832,10941180,905,12116
1562,5,0,21,4,58292280,4832,10941840,905,12121
1563,5,0,20,5,58323300,4832,10941840,905,12126
1564,9,0,24,1,58344420,4832,10941840,904,12135
1565,4,0,21,4,58369620,4831,10941840,904,12139
1566,6,0,20,5,58408680,4831,10941840,903,12145
1567,12,2,25,0,58426920,4831,10941840,902,12157
1568,5,0,24,1,58454220,4830,10944360,902,12162
1569,12,2,25,0,58497780,4830,10945800,901,12174
1570,12,8,25,0,58532220,4830,10952040,901,12186
1571,11,12,25,0,58570320,4831,10961580,901,12197
1572,8,14,25,0,58610280,4832,10977480,902,12205
1573,15,22,25,0,58643880,4832,10993920,902,12220
1574,11,26,25,0,58689780,4833,11002020,902,12231
1575,9,25,25,0,58736760,4833,11041500,905,12240
1576,11,30,25,0,58767300,4833,11052480,904,12251
1577,5,26,25,0,58816320,4833,11100780,908,12256
1578,8,30,25,0,58840140,4834,11148720,911,12264
1579,6,29,25,0,58885380,4834,11200200,915,12270
1580,10,33,25,0,58922040,4835,11206620,915,12280
1581,6,33,25,0,58963740,4836,11219640,916,12286
1582,4,29,25,0,59012160,4837,11281800,920,12290
1583,2,25,25,0,59044680,4837,11420580,931,12292
1584,4,23,25,0,59083140,4838,11507640,938,12296
1585,4,19,25,0,59128560,4839,11681160,952,12300
1586,5,13,25,0,59168340,4837,11889480,969,12305
1587,3,3,25,0,59212020,4836,12300120,1002,12308
1588,7,0,21,4,59259360,4834,12402480,1010,12315
1589,6,0,23,2,59271960,4834,12402480,1009,12321
1590,8,0,25,0,59301060,4834,12404760,1009,12329
1591,8,2,25,0,59333760,4834,12405960,1008,12337
1592,5,0,22,3,59378460,4834,12407700,1008,12342
1593,15,5,25,0,59407440,4833,12408900,1007,12357
1594,7,5,25,0,59445720,4834,12418080,1007,12364
1595,12,8,25,0,59479140,4833,12439200,1008,12376
1596,12,12,25,0,59530860,4834,12447240,1007,12388
1597,9,16,25,0,59559600,4834,12457740,1007,12397
1598,11,24,25,0,59579280,4835,12470940,1008,12408
1599,11,26,25,0,59637840,4836,12499740,1009,12419
1600,10,28,25,0,59686080,4837,12513300,1009,12429
1601,5,27,25,0,59719560,4837,12560280,1013,12434
1602,7,27,25,0,59757840,4837,12618720,1017,12441
1603,7,23,25,0,59812500,4838,12725220,1025,12448
1604,11,26,25,0,59842980,4837,12743880,1026,12459
1605,5,22,25,0,59886060,4837,12806820,1030,12464
1606,10,22,25,0,59931480,4837,12885180,1036,12474
1607,5,21,25,0,59965800,4837,12922140,1038,12479
1608,3,12,25,0,60015480,4836,13149240,1056,12482
1609,3,0,17,8,60066060,4831,13488780,1083,12485
1610,5,0,21,4,60067140,4831,13488780,1083,12490
1611,4,0,20,5,60088260,4831,13488780,1082,12494
1612,8,0,20,5,60115980,4830,13488780,1082,12502
1613,6,0,20,5,60142560,4830,13488780,1081,12508
1614,8,0,24,1,60161700,4830,13488780,1080,12516
1615,7,0,24,1,60196680,4830,13489800,1080,12523
1616,16,8,25,0,60225600,4830,13494300,1079,12539
1617,10,11,25,0,60262980,4830,13505340,1079,12549
1618,11,16,25,0,60297120,4830,13520040,1079,12560
1619,15,24,25,0,60335820,4831,13539540,1080,12575
1620,15,30,25,0,60387240,4831,13557960,1080,12590
1621,11,35,25,0,60423480,4832,13589340,1081,12601
1622,11,40,25,0,60456900,4832,13607220,1082,12612
1623,5,37,25,0,60497940,4833,13632360,1083,12617
1624,9,40,25,0,60534660,4833,13642800,1084,12626
1625,5,39,25,0,60575460,4834,13682340,1086,12631
1626,11,40,25,0,60620580,4835,13691340,1086,12642
1627,4,34,25,0,60654180,4835,13784220,1093,12646
1628,9,37,25,0,60687660,4836,13826520,1096,12655
1629,8,37,25,0,60740100,4837,13936560,1104,12663
1630,8,37,25,0,60776640,4836,14063460,1114,12671
1631,4,31,25,0,60826020,4837,14159280,1121,12675
1632,4,31,25,0,60849000,4837,14254200,1128,12679
1633,5,27,25,0,60901620,4838,14470680,1144,12684
1634,3,20,25,0,60942600,4837,14662500,1159,12687
1635,3,11,25,0,60990060,4836,15049080,1190,12690
1636,5,4,25,0,61026000,4834,15451140,1221,12695
1637,7,0,22,3,61063980,4832,15574620,1230,12702
1638,9,1,25,0,61086840,4832,15576960,1229,12711
1639,12,6,25,0,61128300,4833,15582360,1228,12723
1640,4,3,25,0,61167480,4833,15606840,1230,12727
1641,11,4,25,0,61206120,4832,15618600,1230,12738
1642,9,5,25,0,61248900,4833,15624420,1230,12747
1643,13,13,25,0,61279620,4833,15631740,1229,12760
1644,8,13,25,0,61331460,4834,15640860,1229,12768
1645,14,21,25,0,61363500,4834,15658800,1229,12782
1646,14,28,25,0,61402080,4835,15668040,1228,12796
1647,9,29,25,0,61449000,4835,15716640,1231,12805
1648,12,35,25,0,61481760,4836,15729900,1231,12817
1649,9,39,25,0,61512360,4836,15740820,1231,12826
1650,9,36,25,0,61561500,4837,15764340,1232,12835
1651,10,39,25,0,61607100,4838,15813780,1235,12845
1652,11,39,25,0,61654800,4838,15833760,1236,12856
1653,8,39,25,0,61683360,4838,15867660,1238,12864
1654,6,35,25,0,61735260,4838,16018980,1249,12870
1655,6,36,25,0,61762680,4838,16024380,1249,12876
1656,4,33,25,0,61803060,4839,16098120,1254,12880
1657,3,27,25,0,61842780,4839,16315740,1271,12883
1658,9,24,25,0,61890180,4838,16455480,1281,12892
1659,7,24,25,0,61913280,4837,16524480,1286,12899
1660,1,17,25,0,61961820,4838,16782300,1306,12900
1661,5,13,25,0,62006760,4838,16949160,1318,12905
1662,7,7,25,0,62051340,4836,17331000,1347,12912
1663,11,4,25,0,62071860,4833,17614260,1368,12923
1664,9,3,25,0,62126580,4833,17623620,1368,12932
1665,8,5,25,0,62145660,4832,17629080,1367,12940
1666,15,13,25,0,62193420,4833,17640120,1367,12955
1667,9,18,25,0,62224860,4834,17649780,1366,12964
1668,7,16,25,0,62274480,4835,17659740,1366,12971
1669,10,22,25,0,62293980,4835,17661600,1366,12981
1670,16,31,25,0,62350800,4837,17674980,1366,12997
1671,3,26,25,0,62397600,4837,17705160,1367,13000
1672,6,26,25,0,62429880,4838,17740320,1369,13006
1673,5,22,25,0,62481000,4838,17813880,1374,13011
1674,7,20,25,0,62519880,4838,17908560,1381,13018
1675,11,22,25,0,62560080,4837,17933460,1381,13029
1676,4,18,25,0,62598960,4838,17970480,1384,13033
1677,9,16,25,0,62639580,4837,18064200,1390,13042
1678,4,11,25,0,62677440,4836,18180720,1399,13046
1679,6,1,25,0,62726700,4834,18547800,1426,13052
1680,8,0,21,4,62760900,4832,18597300,1429,13060
1681,9,0,24,1,62779860,4831,18597300,1428,13069
1682,8,0,25,0,62813700,4831,18597300,1427,13077
1683,10,3,25,0,62852520,4831,18600360,1426,13087
1684,8,4,25,0,62891760,4832,18607140,1426,13095
1685,5,2,25,0,62932800,4832,18623460,1427,13100
1686,4,0,22,3,62975160,4832,18637020,1427,13104
1687,8,0,22,3,63007020,4832,18637020,1426,13112
1688,4,0,19,6,63040620,4832,18637020,1426,13116
1689,7,0,19,6,63067980,4831,18637020,1425,13123
1690,11,2,25,0,63081120,4831,18637080,1424,13134
1691,6,3,25,0,63104100,4831,18649380,1424,13140
1692,14,9,25,0,63150840,4832,18656820,1423,13154
1693,7,6,25,0,63203160,4832,18676380,1424,13161
1694,10,13,25,0,63215100,4832,18685800,1424,13171
1695,15,19,25,0,63269100,4833,18692940,1423,13186
1696,5,19,25,0,63294180,4833,18703200,1423,13191
1697,9,18,25,0,63350700,4833,18723420,1423,13200
1698,7,19,25,0,63378720,4833,18751500,1425,13207
1699,12,21,25,0,63423960,4833,18756780,1424,13219
1700,3,18,25,0,63457260,4833,18770520,1425,13222
1701,10,21,25,0,63500820,4834,18772440,1424,13232
1702,1,15,25,0,63540060,4834,18814020,1427,13233
1703,4,12,25,0,63582480,4835,18993900,1440,13237
1704,3,4,25,0,63626220,4834,19174440,1453,13240
1705,6,0,24,1,63654540,4832,19342920,1465,13246
1706,6,0,23,2,63692220,4833,19342920,1465,13252
1707,7,0,22,3,63734880,4833,19342920,1464,13259
1708,5,0,20,5,63758940,4832,19342920,1463,13264
1709,3,0,19,6,63782400,4833,19342920,1463,13267
1710,1,0,17,8,63799740,4833,19342920,1463,13268
1711,3,0,17,8,63821940,4833,19342920,1463,13271
1712,6,0,20,5,63827700,4833,19342920,1462,13277
1713,8,1,25,0,63831420,4832,19342920,1461,13285
1714,15,7,25,0,63879540,4833,19347360,1460,13300
1715,5,7,25,0,63906780,4833,19354920,1460,13305
1716,7,3,25,0,63964440,4833,19393860,1462,13312
1717,18,12,25,0,63983760,4831,19401180,1461,13330
1718,15,19,25,0,64027800,4832,19414320,1460,13345
1719,8,18,25,0,64075800,4832,19437480,1461,13353
1720,13,24,25,0,64108800,4832,19465860,1462,13366
1721,6,23,25,0,64150080,4833,19480020,1462,13372
1722,5,22,25,0,64184280,4833,19502700,1463,13377
1723,11,26,25,0,64227180,4834,19546920,1465,13388
1724,5,26,25,0,64254180,4834,19558920,1466,13393
1725,5,22,25,0,64308600,4835,19639980,1471,13398
1726,5,16,25,0,64352460,4834,19786200,1481,13403
1727,4,7,25,0,64401240,4833,19954320,1494,13407
1728,6,0,23,2,64434600,4830,20151840,1508,13413
1729,6,0,22,3,64465920,4830,20151840,1507,13419
1730,4,0,21,4,64490220,4830,20151840,1507,13423
1731,6,0,24,1,64507380,4830,20151840,1506,13429
1732,9,0,25,0,64548000,4830,20162640,1506,13438
1733,7,0,23,2,64587780,4830,20164020,1505,13445
1734,7,0,22,3,64614660,4829,20164020,1504,13452
1735,7,0,20,5,64646100,4828,20164020,1503,13459
1736,10,3,25,0,64657320,4828,20165700,1502,13469
1737,10,6,25,0,64704960,4829,20172660,1502,13479
1738,8,7,25,0,64745160,4830,20187960,1502,13487
1739,7,7,25,0,64785840,4830,20204640,1503,13494
1740,8,9,25,0,64817880,4831,20210640,1502,13502
1741,12,12,25,0,64864800,4831,20233980,1503,13514
1742,11,15,25,0,64906800,4831,20245980,1502,13525
1743,15,25,25,0,64936560,4831,20252400,1501,13540
1744,11,29,25,0,64984260,4832,20265780,1501,13551
1745,16,39,25,0,65014860,4833,20269740,1500,13567
1746,12,40,25,0,65067480,4833,20292600,1500,13579
1747,2,38,25,0,65085420,4833,20306940,1501,13581
1748,6,34,25,0,65146200,4834,20369880,1505,13587
1749,7,34,25,0,65181180,4834,20487060,1513,13594
1750,7,36,25,0,65209620,4834,20532180,1515,13601
1751,3,29,25,0,65267880,4835,20719140,1529,13604
1752,3,25,25,0,65294100,4835,20782260,1533,13607
1753,11,25,25,0,65351640,4835,20802300,1533,13618
1754,4,24,25,0,65376360,4835,20846400,1536,13622
1755,8,23,25,0,65424180,4835,20917560,1540,13630
1756,3,19,25,0,65458740,4835,21065580,1551,13633
1757,10,19,25,0,65505300,4835,21271680,1565,13643
1758,14,22,25,0,65549640,4835,21278760,1564,13657
1759,8,23,25,0,65585640,4835,21291480,1564,13665
1760,4,22,25,0,65615640,4835,21305520,1564,13669
1761,13,28,25,0,65656200,4836,21313020,1563,13682
1762,15,36,25,0,65696880,4836,21322440,1562,13697
1763,9,37,25,0,65738820,4836,21338340,1563,13706
1764,6,39,25,0,65758200,4836,21351060,1563,13712
1765,15,40,25,0,65809920,4838,21367740,1563,13727
1766,10,39,25,0,65852580,4838,21423960,1567,13737
1767,7,37,25,0,65893020,4839,21447600,1567,13744
1768,10,38,25,0,65935200,4838,21527940,1572,13754
1769,11,39,25,0,65977860,4838,21536400,1572,13765
1770,7,36,25,0,66013380,4838,21587280,1575,13772
1771,14,38,25,0,66064260,4838,21654720,1578,13786
1772,10,38,25,0,66091560,4837,21660240,1578,13796
1773,12,39,25,0,66135360,4837,21735360,1582,13808
1774,4,32,25,0,66181680,4838,21845760,1590,13812
1775,5,28,25,0,66214200,4837,22340880,1626,13817
1776,7,24,25,0,66258060,4836,22606920,1644,13824
1777,3,9,25,0,66296940,4833,23525940,1710,13827
1778,6,0,20,5,66337860,4829,24264120,1763,13833
1779,4,0,19,6,66358020,4828,24264120,1763,13837
1780,4,0,20,5,66371700,4828,24264120,1762,13841
1781,8,0,25,0,66389640,4829,24264780,1761,13849
1782,4,0,19,6,66431040,4828,24264780,1761,13853
1783,7,0,23,2,66445680,4828,24264780,1760,13860
1784,9,2,25,0,66458400,4827,24264780,1759,13869
1785,13,7,25,0,66500220,4827,24270360,1758,13882
1786,15,15,25,0,66539220,4828,24276960,1757,13897
1787,9,17,25,0,66579840,4828,24290160,1756,13906
1788,8,19,25,0,66617580,4829,24300120,1756,13914
1789,20,31,25,0,66659460,4829,24307740,1755,13934
1790,12,38,25,0,66689100,4830,24332160,1754,13946
1791,9,39,25,0,66727140,4831,24346920,1754,13955
1792,8,38,25,0,66781320,4832,24364740,1755,13963
1793,8,36,25,0,66829980,4832,24430620,1758,13971
1794,4,33,25,0,66863340,4832,24525240,1765,13975
1795,10,38,25,0,66891360,4832,24552600,1766,13985
1796,11,39,25,0,66944160,4833,24590100,1767,13996
1797,5,37,25,0,66975540,4833,24603600,1767,14001
1798,4,34,25,0,67018200,4833,24778620,1779,14005
1799,7,35,25,0,67054440,4834,24818880,1781,14012
1800,2,28,25,0,67104120,4834,25114140,1802,14014
1801,6,19,25,0,67157700,4833,25449180,1826,14020
1802,5,15,25,0,67181700,4832,25603200,1836,14025
1803,3,5,25,0,67223160,4830,25993020,1863,14028
1804,6,0,21,4,67261920,4828,26157540,1874,14034
1805,5,0,19,6,67288980,4827,26157540,1874,14039
1806,9,0,22,3,67314660,4827,26157540,1872,14048
1807,7,0,23,2,67339080,4827,26157540,1872,14055
1808,10,1,25,0,67369260,4826,26160060,1870,14065
1809,7,1,25,0,67407540,4827,26163840,1870,14072
1810,11,5,25,0,67436100,4826,26164740,1869,14083
1811,14,11,25,0,67477560,4827,26170800,1867,14097
1812,16,21,25,0,67510680,4827,26180940,1866,14113
1813,13,26,25,0,67555080,4827,26198820,1866,14126
1814,9,29,25,0,67589940,4828,26211900,1865,14135
1815,12,33,25,0,67636680,4828,26227080,1864,14147
1816,12,39,25,0,67672740,4829,26236500,1863,14159
1817,9,39,25,0,67719780,4829,26262960,1864,14168
1818,11,40,25,0,67752120,4830,26277000,1864,14179
1819,7,38,25,0,67803900,4830,26402220,1872,14186
1820,12,37,25,0,67838760,4830,26463240,1876,14198
1821,6,38,25,0,67868340,4831,26575500,1883,14204
1822,5,33,25,0,67925880,4831,26643420,1887,14209
1823,1,29,25,0,67954860,4832,26800860,1898,14210
1824,13,31,25,0,68006400,4832,26845080,1899,14223
1825,7,33,25,0,68030520,4832,26888700,1902,14230
1826,6,28,25,0,68088540,4832,27005760,1909,14236
1827,5,25,25,0,68116680,4831,27146940,1918,14241
1828,9,25,25,0,68160660,4831,27201300,1921,14250
1829,6,21,25,0,68197500,4830,27412980,1935,14256
1830,9,23,25,0,68232480,4830,27491640,1939,14265
1831,9,25,25,0,68268660,4831,27497160,1939,14274
1832,15,31,25,0,68315340,4831,27588000,1943,14289
1833,9,34,25,0,68351100,4831,27598980,1943,14298
1834,7,34,25,0,68391720,4832,27610260,1942,14305
1835,9,37,25,0,68429760,4832,27638220,1943,14314
1836,13,40,25,0,68457780,4833,27648420,1943,14327
1837,11,38,25,0,68505540,4834,27678660,1944,14338
1838,11,39,25,0,68550180,4834,27705060,1945,14349
1839,8,38,25,0,68596020,4835,27721800,1945,14357
1840,11,39,25,0,68622720,4835,27731340,1945,14368
1841,8,37,25,0,68674620,4836,27760440,1946,14376
1842,9,32,25,0,68729220,4835,28011060,1962,14385
1843,6,32,25,0,68749380,4834,28088940,1967,14391
1844,9,32,25,0,68789340,4834,28188960,1973,14400
1845,4,27,25,0,68831160,4834,28486980,1993,14404
1846,7,22,25,0,68873640,4833,28662720,2004,14411
1847,6,21,25,0,68904900,4833,28903980,2020,14417
1848,9,16,25,0,68958300,4832,29176860,2038,14426
1849,1,0,23,2,68991000,4827,30402120,2124,14427
1850,4,0,19,6,69021300,4827,30402120,2123,14431
1851,4,0,19,6,69046020,4827,30402120,2122,14435
1852,10,1,25,0,69054960,4827,30402120,2121,14445
1853,4,0,24,1,69084300,4827,30407400,2121,14449
1854,5,0,20,5,69128520,4827,30407400,2120,14454
1855,9,0,24,1,69150120,4827,30407400,2119,14463
1856,8,0,25,0,69177600,4826,30408360,2118,14471
1857,16,7,25,0,69221280,4826,30411240,2116,14487
1858,7,8,25,0,69253200,4827,30418980,2115,14494
1859,10,11,25,0,69295440,4827,30444120,2115,14504
1860,9,14,25,0,69331920,4828,30466140,2116,14513
1861,10,17,25,0,69379500,4829,30478800,2115,14523
1862,9,21,25,0,69410340,4829,30489060,2114,14532
1863,7,20,25,0,69458940,4830,30518580,2116,14539
1864,11,24,25,0,69497220,4830,30544860,2116,14550
1865,5,22,25,0,69537000,4830,30572820,2117,14555
1866,8,21,25,0,69580980,4831,30608340,2118,14563
1867,7,20,25,0,69615240,4830,30647220,2120,14570
1868,12,21,25,0,69652620,4829,30706740,2122,14582
1869,9,22,25,0,69695160,4829,30718440,2122,14591
1870,8,25,25,0,69721800,4830,30722940,2121,14599
1871,2,17,25,0,69780780,4830,30819840,2127,14601
1872,2,12,25,0,69811440,4830,31020540,2140,14603
1873,6,0,23,2,69870660,4827,31408920,2166,14609
1874,6,0,20,5,69894540,4826,31408920,2165,14615
1875,5,0,21,4,69908580,4826,31408920,2165,14620
1876,7,0,20,5,69938760,4825,31408920,2164,14627
1877,6,0,22,3,69957540,4825,31408920,2163,14633
1878,6,0,22,3,69983820,4825,31408920,2162,14639
1879,9,0,24,1,70008300,4824,31408920,2161,14648
1880,9,1,25,0,70040040,4824,31410780,2159,14657
1881,5,0,23,2,70080660,4824,31414200,2159,14662
1882,5,0,22,3,70112340,4825,31414200,2158,14667
1883,9,1,25,0,70132740,4824,31414200,2157,14676
1884,15,10,25,0,70168680,4825,31418760,2155,14691
1885,11,13,25,0,70218360,4826,31431600,2154,14702
1886,14,21,25,0,70253340,4826,31437480,2153,14716
1887,6,20,25,0,70294740,4826,31444680,2152,14722
1888,9,23,25,0,70329480,4827,31455240,2152,14731
1889,11,25,25,0,70381560,4827,31461900,2150,14742
1890,5,24,25,0,70408920,4827,31504440,2153,14747
1891,3,15,25,0,70466160,4827,31678140,2164,14750
1892,9,13,25,0,70502100,4826,31792920,2171,14759
1893,3,8,25,0,70533840,4826,31888560,2176,14762
1894,9,7,25,0,70573500,4825,31995000,2183,14771
1895,8,8,25,0,70596720,4824,32031960,2184,14779
1896,5,3,25,0,70650360,4825,32061780,2185,14784
1897,5,0,21,4,70697820,4824,32106840,2187,14789
1898,4,0,21,4,70719480,4824,32106840,2187,14793
1899,2,0,17,8,70749060,4824,32106840,2186,14795
1900,6,0,19,6,70769040,4824,32106840,2186,14801
1901,9,1,25,0,70778640,4824,32107680,2184,14810
1902,5,0,24,1,70815720,4824,32110680,2184,14815
1903,5,0,20,5,70854840,4824,32110680,2183,14820
1904,11,0,24,1,70883040,4824,32110680,2181,14831
1905,13,4,25,0,70911720,4823,32112420,2180,14844
1906,16,13,25,0,70946640,4823,32120880,2179,14860
1907,15,21,25,0,70988460,4824,32126580,2176,14875
1908,9,22,25,0,71034480,4824,32147880,2176,14884
1909,13,30,25,0,71060160,4824,32158200,2175,14897
1910,13,37,25,0,71102520,4825,32162160,2173,14910
1911,13,39,25,0,71132460,4826,32193480,2175,14923
1912,9,39,25,0,71161980,4826,32200740,2174,14932
1913,12,40,25,0,71221980,4828,32250960,2176,14944
1914,5,33,25,0,71271840,4829,32343780,2182,14949
1915,3,29,25,0,71307180,4829,32483760,2191,14952
1916,5,26,25,0,71353920,4829,32612640,2199,14957
1917,12,33,25,0,71377980,4829,32658180,2201,14969
1918,6,31,25,0,71422320,4830,32678940,2202,14975
1919,7,28,25,0,71472480,4830,32699160,2202,14982
1920,2,22,25,0,71504160,4829,32823900,2210,14984
1921,4,14,25,0,71552280,4829,33211500,2235,14988
1922,5,7,25,0,71590140,4827,33533880,2256,14993
1923,7,5,25,0,71624460,4827,33591960,2259,15000
1924,3,0,20,5,71668740,4825,33815940,2273,15003
1925,8,0,23,2,71697900,4826,33815940,2272,15011
1926,9,3,25,0,71713140,4825,33817440,2271,15020
1927,8,3,25,0,71756340,4826,33827100,2271,15028
1928,13,9,25,0,71797440,4826,33833820,2269,15041
1929,9,12,25,0,71831520,4827,33837600,2268,15050
1930,14,19,25,0,71874240,4827,33845400,2266,15064
1931,10,22,25,0,71917380,4828,33861000,2266,15074
1932,16,32,25,0,71947920,4828,33868620,2264,15090
1933,8,33,25,0,71989140,4828,33891180,2265,15098
1934,12,38,25,0,72029460,4829,33910980,2264,15110
1935,7,40,25,0,72057180,4829,33918720,2264,15117
1936,13,40,25,0,72107100,4830,33967260,2266,15130
1937,13,37,25,0,72151260,4831,34005960,2267,15143
1938,11,39,25,0,72183840,4831,34065600,2270,15154
1939,10,39,25,0,72239580,4831,34225500,2279,15164
1940,6,37,25,0,72267000,4831,34281960,2283,15170
1941,7,36,25,0,72312180,4832,34342260,2285,15177
1942,2,29,25,0,72356880,4832,34450740,2292,15179
1943,7,27,25,0,72387660,4831,34635180,2304,15186
1944,6,19,25,0,72444180,4830,34866360,2318,15192
1945,2,11,25,0,72475920,4829,35208480,2340,15194
1946,7,7,25,0,72505560,4828,35503320,2359,15201
1947,6,0,23,2,72550260,4826,35664000,2368,15207
1948,3,0,19,6,72583800,4826,35664000,2368,15210
1949,8,0,23,2,72600420,4826,35664000,2367,15218
1950,5,0,24,1,72630120,4826,35664000,2366,15223
1951,11,0,23,2,72677340,4826,35664060,2364,15234
1952,16,8,25,0,72699420,4825,35666160,2362,15250
1953,15,15,25,0,72744540,4826,35676540,2360,15265
1954,11,20,25,0,72779580,4826,35684220,2359,15276
1955,11,27,25,0,72807300,4827,35688420,2358,15287
1956,11,31,25,0,72854160,4827,35706360,2357,15298
1957,15,39,25,0,72891780,4828,35711700,2355,15313
1958,9,40,25,0,72931200,4829,35731980,2356,15322
1959,7,39,25,0,72980040,4830,35766480,2357,15329
1960,6,38,25,0,73021200,4830,35840640,2361,15335
1961,8,37,25,0,73062840,4830,35880840,2362,15343
1962,11,37,25,0,73092480,4831,35889660,2362,15354
1963,8,38,25,0,73132260,4831,36031320,2370,15362
1964,3,31,25,0,73195320,4832,36129660,2376,15365
1965,2,27,25,0,73217880,4832,36213060,2381,15367
1966,6,21,25,0,73274520,4832,36505620,2400,15373
1967,6,19,25,0,73302240,4831,36698460,2411,15379
1968,4,13,25,0,73340340,4830,36914760,2425,15383
1969,6,4,25,0,73383480,4828,37294020,2449,15389
1970,3,0,24,1,73405740,4827,37394340,2455,15392
1971,4,0,20,5,73454520,4828,37394340,2454,15396
1972,7,0,20,5,73480740,4827,37394340,2453,15403
1973,4,0,19,6,73500900,4827,37394340,2453,15407
1974,6,0,19,6,73522020,4827,37394340,2452,15413
1975,6,0,23,2,73531680,4827,37394340,2451,15419
1976,10,1,25,0,73559160,4826,37397520,2449,15429
1977,12,9,25,0,73584540,4827,37399380,2448,15441
1978,8,9,25,0,73637400,4828,37414860,2448,15449
1979,13,11,25,0,73687620,4827,37433580,2447,15462
1980,11,14,25,0,73717980,4827,37440600,2445,15473
1981,5,12,25,0,73747920,4827,37457880,2445,15478
1982,17,22,25,0,73788300,4827,37464840,2444,15495
1983,16,31,25,0,73830000,4828,37470540,2441,15511
1984,6,30,25,0,73870380,4828,37488060,2441,15517
1985,10,35,25,0,73903140,4829,37508760,2441,15527
1986,5,32,25,0,73953120,4829,37560540,2444,15532
1987,7,33,25,0,73985940,4830,37609560,2446,15539
1988,9,33,25,0,74036640,4830,37655160,2447,15548
1989,2,29,25,0,74065500,4830,37706640,2450,15550
1990,2,19,25,0,74126160,4830,37945200,2465,15552
1991,7,16,25,0,74157000,4829,38124420,2476,15559
1992,6,13,25,0,74188740,4828,38210760,2481,15565
1993,4,8,25,0,74224680,4828,38347380,2489,15569
1994,6,3,25,0,74278620,4828,38526600,2499,15575
1995,5,0,22,3,74314920,4827,38655900,2507,15580
1996,7,0,23,2,74337960,4826,38655900,2506,15587
1997,8,0,24,1,74368500,4826,38656740,2504,15595
1998,3,0,19,6,74410680,4826,38656740,2504,15598
1999,8,0,22,3,74431920,4826,38656740,2503,15606
2000,10,2,25,0,74453100,4826,38658840,2501,15616
2001,7,2,25,0,74489400,4826,38664000,2501,15623
2002,10,3,25,0,74534100,4826,38672940,2499,15633
2003,12,10,25,0,74564820,4827,38678220,2499,15645
2004,13,15,25,0,74612220,4827,38686260,2496,15658
2005,11,21,25,0,74643540,4828,38704440,2496,15669
2006,7,21,25,0,74683800,4828,38716500,2495,15676
2007,4,16,25,0,74736300,4829,38758200,2497,15680
2008,9,17,25,0,74779080,4829,38787780,2498,15689
2009,5,18,25,0,74803620,4829,38799120,2498,15694
2010,13,25,25,0,74840580,4830,38823540,2499,15707
2011,5,20,25,0,74899140,4830,38842020,2498,15712
2012,9,26,25,0,74916060,4831,38849340,2497,15721
2013,7,23,25,0,74968140,4831,38869080,2497,15728
2014,8,25,25,0,75006480,4831,38877240,2496,15736
2015,7,27,25,0,75039900,4832,38898480,2497,15743
2016,5,23,25,0,75092280,4833,39049920,2505,15748
2017,4,27,25,0,75092280,4833,39049920,2505,15752
2018,6,33,25,0,75092280,4833,39049920,2505,15758
2019,4,37,25,0,75092280,4833,39049920,2505,15762
2020,6,40,25,0,75092280,4833,39049920,2505,15768
2021,6,40,25,0,75092280,4833,39049920,2505,15774
2022,10,40,25,0,75092280,4833,39049920,2505,15784
2023,11,40,25,0,75092280,4833,39049920,2505,15795
2025,8,40,25,0,75092280,4833,39049920,2505,15803
2024,0,40,25,0,75092280,4833,39049920,2505,15803
2026,10,40,25,0,75092280,4833,39049920,2505,15813
2027,8,40,25,0,75092280,4833,39049920,2505,15821
2028,14,40,25,0,75092280,4833,39049920,2505,15835
2029,7,40,25,0,75092280,4833,39049920,2505,15842
2030,9,40,25,0,75092280,4833,39049920,2505,15851
2031,7,40,25,0,75092280,4833,39049920,2505,15858
2032,6,40,25,0,75092280,4833,39049920,2505,15864
2033,7,40,25,0,75092280,4833,39049920,2505,15871
2034,12,40,25,0,75092280,4833,39049920,2505,15883
2035,8,40,25,0,75092280,4833,39049920,2505,15891
2036,7,40,25,0,75092280,4833,39049920,2505,15898
2037,7,40,25,0,75092280,4833,39049920,2505,15905
2038,8,40,25,0,75092280,4833,39049920,2505,15913
2039,9,40,25,0,75092280,4833,39049920,2505,15922
2040,3,40,25,0,75092280,4833,39049920,2505,15925
2041,6,40,25,0,75092280,4833,39049920,2505,15931
2042,8,40,25,0,75092280,4833,39049920,2505,15939
2043,3,40,25,0,75092280,4833,39049920,2505,15942
2044,11,40,25,0,75092280,4833,39049920,2505,15953
2045,8,40,25,0,75092280,4833,39049920,2505,15961
2046,8,40,25,0,75092280,4833,39049920,2505,15969
2047,8,40,25,0,75092280,4833,39049920,2505,15977
2048,12,40,25,0,75092280,4833,39049920,2505,15989
2049,8,40,25,0,75092280,4833,39049920,2505,15997
2050,12,40,25,0,75092280,4833,39049920,2505,16009
2051,6,40,25,0,75092280,4833,39049920,2505,16015
2052,12,40,25,0,75092280,4833,39049920,2505,16027
2053,12,40,25,0,75092280,4833,39049920,2505,16039
2054,11,40,25,0,75092280,4833,39049920,2505,16050
2055,9,40,25,0,75092280,4833,39049920,2505,16059
2056,11,40,25,0,75092280,4833,39049920,2505,16070
2057,7,40,25,0,75092280,4833,39049920,2505,16077
2058,10,40,25,0,75092280,4833,39049920,2505,16087
2059,11,40,25,0,75092280,4833,39049920,2505,16098
2060,8,40,25,0,75092280,4833,39049920,2505,16106
2061,7,40,25,0,75092280,4833,39049920,2505,16113
2062,5,40,25,0,75092280,4833,39049920,2505,16118
2063,3,40,25,0,75092280,4833,39049920,2505,16121
2064,8,40,25,0,75092280,4833,39049920,2505,16129
2065,4,40,25,0,75092280,4833,39049920,2505,16133
2066,4,40,25,0,75092280,4833,39049920,2505,16137
2067,4,40,25,0,75092280,4833,39049920,2505,16141
2068,4,40,25,0,75092280,4833,39049920,2505,16145
2069,7,40,25,0,75092280,4833,39049920,2505,16152
2070,8,40,25,0,75092280,4833,39049920,2505,16160
2071,11,40,25,0,75092280,4833,39049920,2505,16171
2072,5,40,25,0,75092280,4833,39049920,2505,16176
2073,11,40,25,0,75092280,4833,39049920,2505,16187
2074,9,40,25,0,75092280,4833,39049920,2505,16196
2075,7,40,25,0,75092280,4833,39049920,2505,16203
2076,7,40,25,0,75092280,4833,39049920,2505,16210
2077,12,40,25,0,75092280,4833,39049920,2505,16222
2078,7,40,25,0,75092280,4833,39049920,2505,16229
2079,7,40,25,0,75092280,4833,39049920,2505,16236
2080,5,40,25,0,75092280,4833,39049920,2505,16241
2081,12,40,25,0,75092280,4833,39049920,2505,16253
2082,11,40,25,0,75092280,4833,39049920,2505,16264
2083,8,40,25,0,75092280,4833,39049920,2505,16272
2084,3,40,25,0,75092280,4833,39049920,2505,16275
2085,3,40,25,0,75092280,4833,39049920,2505,16278
2086,3,40,25,0,75092280,4833,39049920,2505,16281
2087,4,40,25,0,75092280,4833,39049920,2505,16285
2088,8,40,25,0,75092280,4833,39049920,2505,16293
2089,6,40,25,0,75092280,4833,39049920,2505,16299
2090,3,40,25,0,75092280,4833,39049920,2505,16302
2091,1,40,25,0,75092280,4833,39049920,2505,16303
2092,10,40,25,0,75092280,4833,39049920,2505,16313
2093,7,40,25,0,75092280,4833,39049920,2505,16320
2094,5,40,25,0,75092280,4833,39049920,2505,16325
2095,8,40,25,0,75092280,4833,39049920,2505,16333
2096,7,40,25,0,75092280,4833,39049920,2505,16340
2097,11,40,25,0,75092280,4833,39049920,2505,16351
2098,7,40,25,0,75092280,4833,39049920,2505,16358
2099,14,40,25,0,75092280,4833,39049920,2505,16372
2100,10,40,25,0,75092280,4833,39049920,2505,16382
2101,12,40,25,0,75092280,4833,39049920,2505,16394
2102,19,40,25,0,75092280,4833,39049920,2505,16413
2103,8,40,25,0,75092280,4833,39049920,2505,16421
2104,14,40,25,0,75092280,4833,39049920,2505,16435
2105,11,40,25,0,75092280,4833,39049920,2505,16446
2106,10,40,25,0,75092280,4833,39049920,2505,16456
2107,8,40,25,0,75092280,4833,39049920,2505,16464
2108,12,40,25,0,75092280,4833,39049920,2505,16476
2109,10,40,25,0,75092280,4833,39049920,2505,16486
2110,10,40,25,0,75092280,4833,39049920,2505,16496
2111,10,40,25,0,75092280,4833,39049920,2505,16506
2112,4,40,25,0,75092280,4833,39049920,2505,16510
2113,2,40,25,0,75092280,4833,39049920,2505,16512
2114,3,40,25,0,75092280,4833,39049920,2505,16515
2115,4,40,25,0,75092280,4833,39049920,2505,16519
2116,3,40,25,0,75092280,4833,39049920,2505,16522
2117,4,40,25,0,75092280,4833,39049920,2505,16526
2118,10,40,25,0,75092280,4833,39049920,2505,16536
2119,8,40,25,0,75092280,4833,39049920,2505,16544
2120,12,40,25,0,75092280,4833,39049920,2505,16556
2121,10,40,25,0,75092280,4833,39049920,2505,16566
2122,16,40,25,0,75092280,4833,39049920,2505,16582
2123,11,40,25,0,75092280,4833,39049920,2505,16593
2124,16,40,25,0,75092280,4833,39049920,2505,16609
2125,17,40,25,0,75092280,4833,39049920,2505,16626
2126,10,40,25,0,75092280,4833,39049920,2505,16636
2127,13,40,25,0,75092280,4833,39049920,2505,16649
2128,16,40,25,0,75092280,4833,39049920,2505,16665
2129,15,40,25,0,75092280,4833,39049920,2505,16680
2130,10,40,25,0,75092280,4833,39049920,2505,16690
2131,8,40,25,0,75092280,4833,39049920,2505,16698
2132,7,40,25,0,75092280,4833,39049920,2505,16705
2133,8,40,25,0,75092280,4833,39049920,2505,16713
2134,6,40,25,0,75092280,4833,39049920,2505,16719
2135,8,40,25,0,75092280,4833,39049920,2505,16727
2136,6,40,25,0,75092280,4833,39049920,2505,16733
2137,5,40,25,0,75092280,4833,39049920,2505,16738
2138,9,40,25,0,75092280,4833,39049920,2505,16747
2139,8,40,25,0,75092280,4833,39049920,2505,16755
2140,6,40,25,0,75092280,4833,39049920,2505,16761
2141,2,40,25,0,75092280,4833,39049920,2505,16763
2142,5,40,25,0,75092280,4833,39049920,2505,16768
2143,11,40,25,0,75092280,4833,39049920,2505,16779
2144,9,40,25,0,75092280,4833,39049920,2505,16788
2145,9,40,25,0,75092280,4833,39049920,2505,16797
2146,13,40,25,0,75092280,4833,39049920,2505,16810
2147,11,40,25,0,75092280,4833,39049920,2505,16821
2148,12,40,25,0,75092280,4833,39049920,2505,16833
2149,12,40,25,0,75092280,4833,39049920,2505,16845
2150,8,40,25,0,75092280,4833,39049920,2505,16853
2151,15,40,25,0,75092280,4833,39049920,2505,16868
2152,14,40,25,0,75092280,4833,39049920,2505,16882
2153,8,40,25,0,75092280,4833,39049920,2505,16890
2154,5,40,25,0,75092280,4833,39049920,2505,16895
2155,7,40,25,0,75092280,4833,39049920,2505,16902
2156,1,40,25,0,75092280,4833,39049920,2505,16903
2157,5,40,25,0,75092280,4833,39049920,2505,16908
2158,11,40,25,0,75092280,4833,39049920,2505,16919
2159,4,40,25,0,75092280,4833,39049920,2505,16923
2160,5,40,25,0,75092280,4833,39049920,2505,16928
2161,6,40,25,0,75092280,4833,39049920,2505,16934
2162,4,40,25,0,75092280,4833,39049920,2505,16938
2163,4,40,25,0,75092280,4833,39049920,2505,16942
2164,9,40,25,0,75092280,4833,39049920,2505,16951
2165,7,40,25,0,75092280,4833,39049920,2505,16958
2166,8,40,25,0,75092280,4833,39049920,2505,16966
2167,4,40,25,0,75092280,4833,39049920,2505,16970
2168,6,40,25,0,75092280,4833,39049920,2505,16976
2169,4,40,25,0,75092280,4833,39049920,2505,16980
2170,6,40,25,0,75092280,4833,39049920,2505,16986
2171,12,40,25,0,75092280,4833,39049920,2505,16998
2172,5,40,25,0,75092280,4833,39049920,2505,17003
2173,8,40,25,0,75092280,4833,39049920,2505,17011
2174,10,40,25,0,75092280,4833,39049920,2505,17021
2175,9,40,25,0,75092280,4833,39049920,2505,17030
2176,13,40,25,0,75092280,4833,39049920,2505,17043
2177,9,40,25,0,75092280,4833,39049920,2505,17052
2178,10,40,25,0,75092280,4833,39049920,2505,17062
2179,7,40,25,0,75092280,4833,39049920,2505,17069
2180,6,40,25,0,75092280,4833,39049920,2505,17075
2181,8,40,25,0,75092280,4833,39049920,2505,17083
2182,7,40,25,0,75092280,4833,39049920,2505,17090
2183,7,40,25,0,75092280,4833,39049920,2505,17097
2184,4,40,25,0,75092280,4833,39049920,2505,17101
2185,4,40,25,0,75092280,4833,39049920,2505,17105
2186,4,40,25,0,75092280,4833,39049920,2505,17109
2187,7,40,25,0,75092280,4833,39049920,2505,17116
2188,2,40,25,0,75092280,4833,39049920,2505,17118
2189,8,40,25,0,75092280,4833,39049920,2505,17126
2190,4,40,25,0,75092280,4833,39049920,2505,17130
2191,9,40,25,0,75092280,4833,39049920,2505,17139
2192,9,40,25,0,75092280,4833,39049920,2505,17148
2193,11,40,25,0,75092280,4833,39049920,2505,17159
2194,14,40,25,0,75092280,4833,39049920,2505,17173
2195,9,40,25,0,75092280,4833,39049920,2505,17182
2196,8,40,25,0,75092280,4833,39049920,2505,17190
2197,5,40,25,0,75092280,4833,39049920,2505,17195
2198,14,40,25,0,75092280,4833,39049920,2505,17209
2199,13,40,25,0,75092280,4833,39049920,2505,17222
2200,7,40,25,0,75092280,4833,39049920,2505,17229
2201,14,40,25,0,75092280,4833,39049920,2505,17243
2202,5,40,25,0,75092280,4833,39049920,2505,17248
2203,7,40,25,0,75092280,4833,39049920,2505,17255
2204,5,40,25,0,75092280,4833,39049920,2505,17260
2205,5,40,25,0,75092280,4833,39049920,2505,17265
2206,3,40,25,0,75092280,4833,39049920,2505,17268
2207,1,40,25,0,75092280,4833,39049920,2505,17269
2208,5,40,25,0,75092280,4833,39049920,2505,17274
2209,7,40,25,0,75092280,4833,39049920,2505,17281
2210,3,40,25,0,75092280,4833,39049920,2505,17284
2211,6,40,25,0,75092280,4833,39049920,2505,17290
2212,4,40,25,0,75092280,4833,39049920,2505,17294
2213,6,40,25,0,75092280,4833,39049920,2505,17300
2214,6,40,25,0,75092280,4833,39049920,2505,17306
2215,9,40,25,0,75092280,4833,39049920,2505,17315
2216,8,40,25,0,75092280,4833,39049920,2505,17323
2217,7,40,25,0,75092280,4833,39049920,2505,17330
2218,12,40,25,0,75092280,4833,39049920,2505,17342
2219,8,40,25,0,75092280,4833,39049920,2505,17350
2220,6,40,25,0,75092280,4833,39049920,2505,17356
2221,13,40,25,0,75092280,4833,39049920,2505,17369
2222,15,40,25,0,75092280,4833,39049920,2505,17384
2223,14,40,25,0,75092280,4833,39049920,2505,17398
2224,10,40,25,0,75092280,4833,39049920,2505,17408
2225,9,40,25,0,75092280,4833,39049920,2505,17417
2226,9,40,25,0,75092280,4833,39049920,2505,17426
2227,11,40,25,0,75092280,4833,39049920,2505,17437
2228,9,40,25,0,75092280,4833,39049920,2505,17446
2229,5,40,25,0,75092280,4833,39049920,2505,17451
2230,10,40,25,0,75092280,4833,39049920,2505,17461
2231,4,40,25,0,75092280,4833,39049920,2505,17465
2232,4,40,25,0,75092280,4833,39049920,2505,17469
2233,3,40,25,0,75092280,4833,39049920,2505,17472
2234,8,40,25,0,75092280,4833,39049920,2505,17480
2235,5,40,25,0,75092280,4833,39049920,2505,17485
2236,7,40,25,0,75092280,4833,39049920,2505,17492
2237,5,40,25,0,75092280,4833,39049920,2505,17497
2238,2,40,25,0,75092280,4833,39049920,2505,17499
2239,15,40,25,0,75092280,4833,39049920,2505,17514
2240,10,40,25,0,75092280,4833,39049920,2505,17524
2241,10,40,25,0,75092280,4833,39049920,2505,17534
2242,4,40,25,0,75092280,4833,39049920,2505,17538
2243,9,40,25,0,75092280,4833,39049920,2505,17547
2244,13,40,25,0,75092280,4833,39049920,2505,17560
2245,6,40,25,0,75092280,4833,39049920,2505,17566
2246,12,40,25,0,75092280,4833,39049920,2505,17578
2247,12,40,25,0,75092280,4833,39049920,2505,17590
2248,10,40,25,0,75092280,4833,39049920,2505,17600
2249,6,40,25,0,75092280,4833,39049920,2505,17606
2250,8,40,25,0,75092280,4833,39049920,2505,17614
2251,6,40,25,0,75092280,4833,39049920,2505,17620
2252,5,40,25,0,75092280,4833,39049920,2505,17625
2253,4,40,25,0,75092280,4833,39049920,2505,17629
2254,7,40,25,0,75092280,4833,39049920,2505,17636
2255,2,40,25,0,75092280,4833,39049920,2505,17638
2256,4,40,25,0,75092280,4833,39049920,2505,17642
2257,5,40,25,0,75092280,4833,39049920,2505,17647
2258,7,40,25,0,75092280,4833,39049920,2505,17654
2259,8,40,25,0,75092280,4833,39049920,2505,17662
2260,2,40,25,0,75092280,4833,39049920,2505,17664
2261,5,40,25,0,75092280,4833,39049920,2505,17669
2262,10,40,25,0,75092280,4833,39049920,2505,17679
2263,6,40,25,0,75092280,4833,39049920,2505,17685
2264,8,40,25,0,75092280,4833,39049920,2505,17693
2265,6,40,25,0,75092280,4833,39049920,2505,17699
2266,11,40,25,0,75092280,4833,39049920,2505,17710
2267,16,40,25,0,75092280,4833,39049920,2505,17726
2268,14,40,25,0,75092280,4833,39049920,2505,17740
2269,7,40,25,0,75092280,4833,39049920,2505,17747
2270,7,40,25,0,75092280,4833,39049920,2505,17754
2271,8,40,25,0,75092280,4833,39049920,2505,17762
2272,9,40,25,0,75092280,4833,39049920,2505,17771
2273,10,40,25,0,75092280,4833,39049920,2505,17781
2274,5,40,25,0,75092280,4833,39049920,2505,17786
2275,8,40,25,0,75092280,4833,39049920,2505,17794
2276,7,40,25,0,75092280,4833,39049920,2505,17801
2277,5,40,25,0,75092280,4833,39049920,2505,17806
2278,5,40,25,0,75092280,4833,39049920,2505,17811
2279,6,40,25,0,75092280,4833,39049920,2505,17817
2280,2,40,25,0,75092280,4833,39049920,2505,17819
2281,2,40,25,0,75092280,4833,39049920,2505,17821
2282,2,40,25,0,75092280,4833,39049920,2505,17823
2283,6,40,25,0,75092280,4833,39049920,2505,17829
2284,8,40,25,0,75092280,4833,39049920,2505,17837
2285,7,40,25,0,75092280,4833,39049920,2505,17844
2286,10,40,25,0,75092280,4833,39049920,2505,17854
2287,7,40,25,0,75092280,4833,39049920,2505,17861
2288,6,40,25,0,75092280,4833,39049920,2505,17867
2289,7,40,25,0,75092280,4833,39049920,2505,17874
2290,11,40,25,0,75092280,4833,39049920,2505,17885
2291,5,40,25,0,75092280,4833,39049920,2505,17890
2292,8,40,25,0,75092280,4833,39049920,2505,17898
2293,9,40,25,0,75092280,4833,39049920,2505,17907
2294,7,40,25,0,75092280,4833,39049920,2505,17914
2295,10,40,25,0,75092280,4833,39049920,2505,17924
2296,7,40,25,0,75092280,4833,39049920,2505,17931
2297,10,40,25,0,75092280,4833,39049920,2505,17941
2298,15,40,25,0,75092280,4833,39049920,2505,17956
2299,8,40,25,0,75092280,4833,39049920,2505,17964
2300,10,40,25,0,75092280,4833,39049920,2505,17974
2301,8,40,25,0,75092280,4833,39049920,2505,17982
2302,4,40,25,0,75092280,4833,39049920,2505,17986
2303,8,40,25,0,75092280,4833,39049920,2505,17994
2304,6,40,25,0,75092280,4833,39049920,2505,18000
2305,12,40,25,0,75092280,4833,39049920,2505,18012
2306,6,40,25,0,75092280,4833,39049920,2505,18018
2307,6,40,25,0,75092280,4833,39049920,2505,18024
2308,6,40,25,0,75092280,4833,39049920,2505,18030
2309,4,40,25,0,75092280,4833,39049920,2505,18034
2310,13,40,25,0,75092280,4833,39049920,2505,18047
2311,5,40,25,0,75092280,4833,39049920,2505,18052
2312,14,40,25,0,75092280,4833,39049920,2505,18066
2313,11,40,25,0,75092280,4833,39049920,2505,18077
2314,7,40,25,0,75092280,4833,39049920,2505,18084
2315,12,40,25,0,75092280,4833,39049920,2505,18096
2316,6,40,25,0,75092280,4833,39049920,2505,18102
2317,14,40,25,0,75092280,4833,39049920,2505,18116
2318,8,40,25,0,75092280,4833,39049920,2505,18124
2319,13,40,25,0,75092280,4833,39049920,2505,18137
2320,11,40,25,0,75092280,4833,39049920,2505,18148
2321,10,40,25,0,75092280,4833,39049920,2505,18158
2322,10,40,25,0,75092280,4833,39049920,2505,18168
2323,9,40,25,0,75092280,4833,39049920,2505,18177
2324,10,40,25,0,75092280,4833,39049920,2505,18187
2325,7,40,25,0,75092280,4833,39049920,2505,18194
2326,8,40,25,0,75092280,4833,39049920,2505,18202
2327,2,40,25,0,75092280,4833,39049920,2505,18204
2328,7,40,25,0,75092280,4833,39049920,2505,18211
2329,8,40,25,0,75092280,4833,39049920,2505,18219
2330,3,40,25,0,75092280,4833,39049920,2505,18222
2331,4,40,25,0,75092280,4833,39049920,2505,18226
2332,6,40,25,0,75092280,4833,39049920,2505,18232
2333,4,40,25,0,75092280,4833,39049920,2505,18236
2334,5,40,25,0,75092280,4833,39049920,2505,18241
2335,3,40,25,0,75092280,4833,39049920,2505,18244
2336,14,40,25,0,75092280,4833,39049920,2505,18258
2337,12,40,25,0,75092280,4833,39049920,2505,18270
2338,9,40,25,0,75092280,4833,39049920,2505,18279
2339,13,40,25,0,75092280,4833,39049920,2505,18292
2340,12,40,25,0,75092280,4833,39049920,2505,18304
2341,10,40,25,0,75092280,4833,39049920,2505,18314
2342,12,40,25,0,75092280,4833,39049920,2505,18326
2343,9,40,25,0,75092280,4833,39049920,2505,18335
2344,11,40,25,0,75092280,4833,39049920,2505,18346
2345,13,40,25,0,75092280,4833,39049920,2505,18359
2346,10,40,25,0,75092280,4833,39049920,2505,18369
2347,9,40,25,0,75092280,4833,39049920,2505,18378
2348,7,40,25,0,75092280,4833,39049920,2505,18385
2349,10,40,25,0,75092280,4833,39049920,2505,18395
2350,10,40,25,0,75092280,4833,39049920,2505,18405
2351,4,40,25,0,75092280,4833,39049920,2505,18409
2352,4,40,25,0,75092280,4833,39049920,2505,18413
2353,7,40,25,0,75092280,4833,39049920,2505,18420
2354,5,40,25,0,75092280,4833,39049920,2505,18425
2355,2,40,25,0,75092280,4833,39049920,2505,18427
2356,5,40,25,0,75092280,4833,39049920,2505,18432
2357,4,40,25,0,75092280,4833,39049920,2505,18436
2358,3,40,25,0,75092280,4833,39049920,2505,18439
2359,4,40,25,0,75092280,4833,39049920,2505,18443
2360,10,40,25,0,75092280,4833,39049920,2505,18453
2361,8,40,25,0,75092280,4833,39049920,2505,18461
2362,9,40,25,0,75092280,4833,39049920,2505,18470
2363,11,40,25,0,75092280,4833,39049920,2505,18481
2364,12,40,25,0,75092280,4833,39049920,2505,18493
2365,11,40,25,0,75092280,4833,39049920,2505,18504
2366,10,40,25,0,75092280,4833,39049920,2505,18514
2367,14,40,25,0,75092280,4833,39049920,2505,18528
2368,3,40,25,0,75092280,4833,39049920,2505,18531
2369,12,40,25,0,75092280,4833,39049920,2505,18543
2370,7,40,25,0,75092280,4833,39049920,2505,18550
2371,10,40,25,0,75092280,4833,39049920,2505,18560
2372,5,40,25,0,75092280,4833,39049920,2505,18565
2373,7,40,25,0,75092280,4833,39049920,2505,18572
2374,15,40,25,0,75092280,4833,39049920,2505,18587
2375,5,40,25,0,75092280,4833,39049920,2505,18592
2376,5,40,25,0,75092280,4833,39049920,2505,18597
2377,7,40,25,0,75092280,4833,39049920,2505,18604
2378,9,40,25,0,75092280,4833,39049920,2505,18613
2379,2,40,25,0,75092280,4833,39049920,2505,18615
2380,4,40,25,0,75092280,4833,39049920,2505,18619
2381,5,40,25,0,75092280,4833,39049920,2505,18624
2382,7,40,25,0,75092280,4833,39049920,2505,18631
2383,7,40,25,0,75092280,4833,39049920,2505,18638
2384,8,40,25,0,75092280,4833,39049920,2505,18646
2385,10,40,25,0,75092280,4833,39049920,2505,18656
2386,6,40,25,0,75092280,4833,39049920,2505,18662
2387,7,40,25,0,75092280,4833,39049920,2505,18669
2388,11,40,25,0,75092280,4833,39049920,2505,18680
2389,1,40,25,0,75092280,4833,39049920,2505,18681
2390,14,40,25,0,75092280,4833,39049920,2505,18695
2391,12,40,25,0,75092280,4833,39049920,2505,18707
2392,11,40,25,0,75092280,4833,39049920,2505,18718
2393,9,40,25,0,75092280,4833,39049920,2505,18727
2394,10,40,25,0,75092280,4833,39049920,2505,18737
2395,8,40,25,0,75092280,4833,39049920,2505,18745
2396,10,40,25,0,75092280,4833,39049920,2505,18755
2397,9,40,25,0,75092280,4833,39049920,2505,18764
2398,9,40,25,0,75092280,4833,39049920,2505,18773
2399,7,40,25,0,75092280,4833,39049920,2505,18780

