Hour,Arrivals,Waiting,Treating,Available Rooms,Total Treatment Time,Average Treatment Time,Total Wait Time,Average Wait Time,Total Arrivals
1,2,0,0,25,1320,660,0,0,2
2,7,0,4,21,3780,756,0,0,9
3,6,0,6,19,14820,1646,0,0,15
4,3,0,7,18,24600,2236,0,0,18
5,6,0,6,19,52620,2923,0,0,24
6,9,0,5,20,85500,3053,0,0,33
7,5,0,7,18,100320,3236,0,0,38
8,11,0,13,12,119520,3320,0,0,49
9,12,0,10,15,162660,3189,0,0,61
10,5,0,10,15,183420,3275,0,0,66
11,11,0,11,14,226320,3429,0,0,77
12,18,0,15,10,272760,3409,0,0,95
13,12,0,11,14,328800,3425,0,0,107
14,6,0,11,14,354720,3477,0,0,113
15,13,0,13,12,393600,3483,0,0,126
16,12,0,14,11,440580,3553,0,0,138
17,9,0,7,18,495660,3540,0,0,147
18,9,0,10,15,521940,3574,0,0,156
19,13,0,13,12,549360,3521,0,0,169
20,6,0,9,16,586860,3535,0,0,175
21,6,0,9,16,622320,3618,0,0,181
22,4,0,5,20,654900,3638,0,0,185
23,5,0,7,18,672300,3673,0,0,190
24,5,0,3,22,711900,3707,0,0,195
25,4,0,5,20,718380,3702,0,0,199
26,7,0,4,21,736860,3647,0,0,206
27,3,0,3,22,747000,3626,0,0,209
28,5,0,3,22,762120,3611,0,0,214
29,2,0,3,22,776580,3645,0,0,216
30,8,0,9,16,786540,3658,0,0,224
31,13,0,15,10,805800,3629,0,0,237
32,6,0,6,19,863820,3644,0,0,243
33,7,0,7,18,891960,3670,0,0,250
34,10,0,11,14,905640,3637,0,0,260
35,8,0,8,17,956700,3679,0,0,268
36,7,0,6,19,987780,3672,0,0,275
37,9,0,6,19,1015800,3653,0,0,284
38,11,0,12,13,1035180,3657,0,0,295
39,10,0,10,15,1070220,3627,0,0,305
40,11,0,11,14,1114260,3653,0,0,316
41,7,0,8,17,1153260,3661,0,0,323
42,16,0,13,12,1185360,3636,0,0,339
43,7,0,10,15,1228680,3656,0,0,346
44,9,0,7,18,1269120,3646,0,0,355
45,6,0,6,19,1295100,3648,0,0,361
46,4,0,4,21,1324800,3669,0,0,365
47,2,0,4,21,1337520,3684,0,0,367
48,7,0,5,20,1357800,3679,0,0,374
49,3,0,1,24,1384020,3680,0,0,377
50,5,0,6,19,1384020,3680,0,0,382
51,0,0,1,24,1404480,3686,0,0,382
52,6,0,5,20,1406400,3672,0,0,388
53,11,0,5,20,1436220,3645,0,0,399
54,6,0,3,22,1456620,3623,0,0,405
55,6,0,4,21,1471080,3614,0,0,411
56,4,0,4,21,1477920,3595,0,0,415
57,11,0,8,17,1493940,3574,0,0,426
58,11,0,12,13,1514100,3562,0,0,437
59,5,0,9,16,1550700,3581,0,0,442
60,11,0,11,14,1592400,3602,0,0,453
61,14,0,10,15,1636740,3581,0,0,467
62,9,0,10,15,1668420,3580,0,0,476
63,12,0,12,13,1709760,3591,0,0,488
64,12,0,11,14,1757940,3594,0,0,500
65,9,0,10,15,1803240,3613,0,0,509
66,8,0,10,15,1830780,3611,0,0,517
67,6,0,7,18,1867800,3619,0,0,523
68,5,0,4,21,1900020,3625,0,0,528
69,6,0,8,17,1905780,3623,0,0,534
70,6,0,7,18,1927620,3616,0,0,540
71,8,0,4,21,1963920,3610,0,0,548
72,5,0,4,21,1979040,3604,0,0,553
73,4,0,3,22,1994940,3600,0,0,557
74,6,0,6,19,2001900,3594,0,0,563
75,3,0,5,20,2015280,3592,0,0,566
76,8,0,8,17,2041680,3607,0,0,574
77,4,0,9,16,2049480,3601,0,0,578
78,15,0,9,16,2107020,3607,0,0,593
79,9,0,9,16,2133660,3598,0,0,602
80,11,0,10,15,2167980,3595,0,0,613
81,14,0,9,16,2212560,3580,0,0,627
82,11,0,13,12,2240460,3584,0,0,638
83,13,0,10,15,2297220,3583,0,0,651
84,12,0,11,14,2325120,3566,0,0,663
85,16,0,14,11,2352480,3537,0,0,679
86,8,0,9,16,2409000,3553,0,0,687
87,11,0,11,14,2442000,3554,0,0,698
88,6,0,7,18,2477760,3554,0,0,704
89,8,0,7,18,2510160,3560,0,0,712
90,12,0,10,15,2537100,3553,0,0,724
91,8,0,11,14,2552460,3540,0,0,732
92,11,0,13,12,2601180,3563,0,0,743
93,5,0,8,17,2649060,3579,0,0,748
94,4,0,5,20,2682360,3590,0,0,752
95,2,0,3,22,2706240,3603,0,0,754
96,7,0,6,19,2718840,3601,0,0,761
97,5,0,4,21,2745480,3602,0,0,766
98,5,0,6,19,2756340,3603,0,0,771
99,6,0,6,19,2780100,3605,0,0,777
100,6,0,5,20,2801220,3600,0,0,783
101,7,0,6,19,2821980,3599,0,0,790
102,5,0,5,20,2847480,3604,0,0,795
103,11,0,8,17,2868300,3594,0,0,806
104,9,0,5,20,2904360,3585,0,0,815
105,6,0,7,18,2915040,3581,0,0,821
106,6,0,4,21,2939100,3571,0,0,827
107,7,0,7,18,2948340,3565,0,0,834
108,13,0,13,12,2973660,3565,0,0,847
109,9,0,12,13,3007500,3563,0,0,856
110,8,0,15,10,3032700,3572,0,0,864
111,10,0,14,11,3085500,3587,0,0,874
112,14,0,16,9,3135360,3595,0,0,888
113,6,0,9,16,3190980,3605,0,0,894
114,8,0,7,18,3234420,3613,0,0,902
115,5,0,6,19,3256200,3613,0,0,907
116,7,0,9,16,3277980,3622,0,0,914
117,9,0,10,15,3308160,3623,0,0,923
118,4,0,6,19,3337680,3623,0,0,927
119,2,0,2,23,3362100,3626,0,0,929
120,5,0,2,23,3383160,3630,0,0,934
121,4,0,6,19,3383160,3630,0,0,938
122,8,0,7,18,3396960,3617,0,0,946
123,5,0,3,22,3431520,3619,0,0,951
124,6,0,6,19,3448020,3625,0,0,957
125,6,0,6,19,3474780,3630,0,0,963
126,7,0,7,18,3488520,3622,0,0,970
127,9,0,6,19,3523440,3621,0,0,979
128,8,0,5,20,3549180,3614,0,0,987
129,11,0,10,15,3574320,3617,0,0,998
130,7,0,8,17,3600600,3611,0,0,1005
131,9,0,7,18,3638100,3612,0,0,1014
132,10,0,8,17,3662160,3604,0,0,1024
133,12,0,13,12,3688500,3605,0,0,1036
134,13,0,17,8,3731700,3615,0,0,1049
135,13,0,11,14,3797820,3613,0,0,1062
136,11,0,12,13,3839160,3618,0,0,1073
137,5,0,8,17,3882780,3628,0,0,1078
138,12,0,8,17,3917580,3620,0,0,1090
139,5,0,4,21,3949740,3620,0,0,1095
140,10,0,6,19,3966660,3609,0,0,1105
141,5,0,6,19,3984600,3609,0,0,1110
142,5,0,4,21,3999180,3599,0,0,1115
143,6,0,7,18,4012440,3601,0,0,1121
144,5,0,7,18,4034640,3605,0,0,1126
145,2,0,4,21,4048920,3602,0,0,1128
146,4,0,3,22,4079880,3613,0,0,1132
147,4,0,2,23,4092120,3608,0,0,1136
148,3,0,4,21,4097040,3609,0,0,1139
149,11,0,12,13,4101720,3604,0,0,1150
150,5,0,4,21,4144080,3600,0,0,1155
151,10,0,10,15,4161060,3602,0,0,1165
152,15,0,12,13,4195920,3592,0,0,1180
153,5,0,11,14,4216020,3591,0,0,1185
154,16,0,15,10,4252080,3585,0,0,1201
155,14,0,13,12,4321620,3595,0,0,1215
156,14,0,14,11,4367460,3594,0,0,1229
157,10,0,13,12,4403880,3592,0,0,1239
158,12,0,10,15,4469460,3601,0,0,1251
159,10,0,13,12,4489740,3597,0,0,1261
160,12,0,13,12,4541160,3604,0,0,1273
161,14,0,12,13,4590600,3600,0,0,1287
162,13,0,15,10,4632540,3605,0,0,1300
163,9,0,8,17,4689900,3604,0,0,1309
164,9,0,4,21,4729260,3599,0,0,1318
165,12,0,12,13,4740420,3596,0,0,1330
166,6,0,10,15,4773120,3599,0,0,1336
167,5,0,7,18,4805400,3602,0,0,1341
168,4,0,6,19,4834680,3610,0,0,1345
169,6,0,5,20,4869300,3617,0,0,1351
170,4,0,7,18,4880220,3620,0,0,1355
171,3,0,6,19,4896480,3621,0,0,1358
172,6,0,7,18,4917960,3624,0,0,1364
173,4,0,2,23,4943760,3619,0,0,1368
174,3,0,3,22,4953420,3620,0,0,1371
175,9,0,6,19,4962840,3611,0,0,1380
176,7,0,7,18,4977240,3606,0,0,1387
177,17,0,14,11,5006280,3601,0,0,1404
178,10,0,9,16,5050620,3594,0,0,1414
179,12,0,15,10,5073000,3595,0,0,1426
180,9,0,16,9,5120040,3608,0,0,1435
181,5,0,5,20,5196480,3621,0,0,1440
182,16,0,12,13,5215680,3611,0,0,1456
183,13,0,11,14,5260200,3607,0,0,1469
184,16,0,17,8,5290800,3604,0,0,1485
185,5,0,10,15,5344380,3611,0,0,1490
186,4,0,4,21,5396340,3621,0,0,1494
187,7,0,9,16,5400540,3619,0,0,1501
188,11,0,8,17,5433000,3612,0,0,1512
189,4,0,5,20,5459700,3613,0,0,1516
190,6,0,3,22,5489820,3614,0,0,1522
191,4,0,5,20,5497020,3614,0,0,1526
192,4,0,4,21,5505360,3607,0,0,1530
193,6,0,4,21,5524080,3605,0,0,1536
194,6,0,8,17,5527920,3603,0,0,1542
195,4,0,8,17,5539620,3601,0,0,1546
196,6,0,7,18,5577240,3609,0,0,1552
197,7,0,8,17,5588760,3603,0,0,1559
198,6,0,5,20,5627340,3607,0,0,1565
199,6,0,6,19,5643840,3606,0,0,1571
200,10,0,4,21,5686800,3606,0,0,1581
201,3,0,3,22,5707200,3609,0,0,1584
202,9,0,5,20,5717760,3600,0,0,1593
203,8,0,9,16,5726700,3597,0,0,1601
204,16,0,14,11,5761620,3594,0,0,1617
205,14,0,13,12,5815140,3594,0,0,1631
206,6,0,8,17,5845020,3588,0,0,1637
207,15,0,11,14,5887560,3587,0,0,1652
208,12,0,12,13,5931600,3590,0,0,1664
209,7,0,6,19,5979480,3591,0,0,1671
210,5,0,2,23,6012540,3591,0,0,1676
211,9,0,9,16,6016320,3589,0,0,1685
212,7,0,11,14,6035400,3590,0,0,1692
213,7,0,8,17,6069000,3589,0,0,1699
214,4,0,5,20,6103200,3594,0,0,1703
215,5,0,4,21,6142380,3604,0,0,1708
216,10,0,10,15,6153360,3602,0,0,1718
217,6,0,8,17,6181320,3602,0,0,1724
218,4,0,7,18,6200520,3602,0,0,1728
219,7,0,8,17,6229320,3607,0,0,1735
220,10,0,7,18,6265140,3604,0,0,1745
221,6,0,6,19,6281700,3599,0,0,1751
222,8,0,9,16,6307620,3604,0,0,1759
223,11,0,10,15,6337320,3600,0,0,1770
224,5,0,8,17,6364440,3601,0,0,1775
225,8,0,8,17,6398160,3604,0,0,1783
226,7,0,9,16,6412560,3600,0,0,1790
227,9,0,12,13,6442440,3605,0,0,1799
228,13,0,16,9,6474540,3604,0,0,1812
229,12,0,17,8,6532800,3615,0,0,1824
230,10,0,10,15,6596940,3616,0,0,1834
231,8,0,9,16,6630060,3617,0,0,1842
232,12,0,12,13,6664500,3618,0,0,1854
233,14,0,11,14,6717720,3617,0,0,1868
234,7,0,6,19,6771120,3622,0,0,1875
235,8,0,10,15,6793680,3627,0,0,1883
236,6,0,7,18,6836520,3632,0,0,1889
237,3,0,5,20,6863460,3637,0,0,1892
238,8,0,10,15,6875880,3638,0,0,1900
239,4,0,8,17,6905580,3642,0,0,1904
240,6,0,9,16,6926820,3643,0,0,1910
241,6,0,5,20,6975120,3649,0,0,1916
242,1,0,3,22,6990600,3652,0,0,1917
243,6,0,7,18,7000860,3653,0,0,1923
244,10,0,11,14,7018980,3651,0,0,1933
245,12,0,12,13,7051380,3647,0,0,1945
246,7,0,12,13,7080540,3649,0,0,1952
247,6,0,3,22,7134660,3649,0,0,1958
248,15,0,10,15,7154580,3644,0,0,1973
249,16,0,12,13,7182240,3632,0,0,1989
250,13,0,15,10,7209240,3628,0,0,2002
251,23,0,18,7,7282320,3628,0,0,2025
252,11,0,9,16,7344420,3623,0,0,2036
253,10,0,9,16,7370580,3618,0,0,2046
254,13,0,11,14,7405440,3615,0,0,2059
255,9,0,10,15,7434660,3612,0,0,2068
256,14,0,12,13,7476840,3612,0,0,2082
257,6,0,5,20,7521120,3610,0,0,2088
258,6,0,8,17,7530120,3609,0,0,2094
259,5,0,7,18,7556760,3612,0,0,2099
260,5,0,4,21,7578420,3608,0,0,2104
261,7,0,5,20,7605660,3611,0,0,2111
262,4,0,6,19,7617840,3612,0,0,2115
263,8,0,8,17,7632360,3608,0,0,2123
264,4,0,8,17,7652160,3611,0,0,2127
265,4,0,3,22,7687860,3612,0,0,2131
266,6,0,4,21,7704120,3611,0,0,2137
267,8,0,6,19,7719660,3609,0,0,2145
268,7,0,8,17,7731900,3606,0,0,2152
269,4,0,6,19,7757340,3608,0,0,2156
270,3,0,5,20,7774200,3609,0,0,2159
271,10,0,9,16,7794540,3608,0,0,2169
272,10,0,9,16,7832940,3609,0,0,2179
273,11,0,14,11,7849920,3607,0,0,2190
274,8,0,11,14,7907280,3615,0,0,2198
275,10,0,11,14,7956300,3621,0,0,2208
276,12,0,10,15,7999260,3619,0,0,2220
277,9,0,7,18,8034780,3616,0,0,2229
278,6,0,8,17,8059200,3618,0,0,2235
279,7,0,11,14,8079180,3621,0,0,2242
280,9,0,11,14,8117520,3623,0,0,2251
281,9,0,10,15,8160360,3626,0,0,2260
282,14,0,11,14,8213880,3629,0,0,2274
283,8,0,10,15,8245260,3629,0,0,2282
284,9,0,9,16,8295120,3635,0,0,2291
285,8,0,9,16,8325600,3635,0,0,2299
286,10,0,13,12,8354700,3638,0,0,2309
287,3,0,6,19,8390460,3638,0,0,2312
288,5,0,4,21,8426160,3642,0,0,2317
289,8,0,7,18,8443500,3642,0,0,2325
290,6,0,6,19,8462700,3639,0,0,2331
291,4,0,6,19,8487480,3644,0,0,2335
292,6,0,8,17,8506080,3645,0,0,2341
293,7,0,5,20,8541300,3645,0,0,2348
294,6,0,7,18,8554560,3644,0,0,2354
295,13,0,15,10,8575020,3645,0,0,2367
296,13,0,11,14,8629140,3642,0,0,2380
297,6,0,7,18,8668980,3643,0,0,2386
298,11,0,8,17,8705400,3643,0,0,2397
299,6,0,7,18,8724840,3641,0,0,2403
300,6,0,5,20,8758920,3643,0,0,2409
301,16,0,18,7,8762640,3640,0,0,2425
302,13,0,20,5,8816280,3646,0,0,2438
303,7,0,12,13,8885040,3651,0,0,2445
304,17,0,13,12,8948340,3653,0,0,2462
305,5,0,7,18,8991240,3654,0,0,2467
306,7,0,4,21,9032280,3656,0,0,2474
307,7,0,6,19,9041820,3653,0,0,2481
308,9,0,7,18,9061860,3649,0,0,2490
309,11,0,13,12,9071640,3646,0,0,2501
310,4,0,8,17,9120180,3652,0,0,2505
311,3,0,8,17,9127920,3651,0,0,2508
312,5,0,6,19,9175860,3660,0,0,2513
313,3,0,5,20,9200820,3664,0,0,2516
314,6,0,4,21,9222960,3662,0,0,2522
315,6,0,7,18,9232320,3662,0,0,2528
316,9,0,6,19,9262380,3659,0,0,2537
317,8,0,11,14,9270240,3658,0,0,2545
318,7,0,9,16,9311940,3661,0,0,2552
319,8,0,10,15,9345840,3665,0,0,2560
320,13,0,16,9,9362280,3661,0,0,2573
321,14,0,16,9,9416160,3662,0,0,2587
322,13,0,10,15,9493260,3665,0,0,2600
323,11,0,8,17,9535740,3663,0,0,2611
324,10,0,10,15,9562500,3662,0,0,2621
325,21,0,13,12,9615900,3657,0,0,2642
326,13,0,14,11,9648420,3653,0,0,2655
327,11,0,14,11,9694980,3655,0,0,2666
328,11,0,12,13,9745560,3656,0,0,2677
329,14,0,14,11,9777780,3652,0,0,2691
330,6,0,4,21,9833160,3651,0,0,2697
331,11,0,9,16,9851880,3650,0,0,2708
332,8,0,4,21,9900600,3650,0,0,2716
333,8,0,7,18,9914940,3649,0,0,2724
334,7,0,6,19,9949980,3651,0,0,2731
335,5,0,5,20,9967860,3649,0,0,2736
336,5,0,6,19,9981600,3649,0,0,2741
337,6,0,7,18,9999600,3649,0,0,2747
338,11,0,11,14,10029000,3650,0,0,2758
339,30,5,25,0,10059720,3647,420,0,2788
340,36,24,25,0,10135800,3652,9180,3,2824
341,26,35,25,0,10215180,3661,38220,13,2850
342,28,37,25,0,10311900,3673,75000,26,2878
343,38,40,25,0,10419000,3680,101340,35,2916
344,37,39,25,0,10477500,3682,124260,42,2953
345,31,36,25,0,10585980,3691,249540,85,2984
346,34,40,25,0,10681920,3687,308280,104,3018
347,35,40,25,0,10780200,3690,377640,126,3053
348,29,35,25,0,10858800,3683,470040,156,3082
349,24,21,25,0,10963320,3671,923160,304,3106
350,35,28,25,0,11037720,3662,1048800,342,3141
351,25,39,25,0,11106660,3667,1060080,343,3166
352,34,40,25,0,11205480,3682,1075320,346,3200
353,31,35,25,0,11305920,3691,1136400,363,3231
354,15,29,25,0,11413020,3700,1283220,409,3246
355,28,18,25,0,11519820,3688,1655640,523,3274
356,21,8,25,0,11586240,3673,1820940,571,3295
357,31,11,25,0,11657700,3663,1933440,601,3326
358,32,24,25,0,11751060,3671,1940460,597,3358
359,24,31,25,0,11846460,3681,1956540,597,3382
360,31,39,25,0,11928060,3686,1969440,596,3413
361,36,40,25,0,12032460,3693,2008860,604,3449
362,28,33,25,0,12129360,3688,2137380,638,3477
363,27,22,25,0,12229680,3676,2352900,697,3504
364,35,32,25,0,12295440,3669,2434080,714,3539
365,29,39,25,0,12382080,3676,2449140,714,3568
366,31,37,25,0,12482880,3680,2478900,717,3599
367,31,33,25,0,12593040,3677,2659380,763,3630
368,39,40,25,0,12667140,3670,2720820,774,3669
369,42,40,25,0,12735600,3674,2739300,776,3711
370,26,29,25,0,12838260,3675,2948040,831,3737
371,36,40,25,0,12922320,3674,2990400,835,3773
372,29,36,25,0,13004340,3678,3014220,838,3802
373,34,36,25,0,13118280,3676,3159720,870,3836
374,30,40,25,0,13206780,3678,3167100,866,3866
375,31,38,25,0,13291680,3677,3234060,880,3897
376,28,35,25,0,13379880,3677,3306300,894,3925
377,41,40,25,0,13480860,3678,3354060,899,3966
378,35,37,25,0,13570980,3674,3424140,912,4001
379,34,38,25,0,13642320,3677,3459600,916,4035
380,34,40,25,0,13729920,3679,3472740,915,4069
381,34,40,25,0,13820640,3676,3547080,927,4103
382,27,40,25,0,13902600,3679,3579300,931,4130
383,27,27,25,0,14016540,3675,4137960,1070,4157
384,29,15,25,0,14111220,3661,4884600,1254,4186
385,37,35,25,0,14188080,3665,4892160,1245,4223
386,31,40,25,0,14265840,3673,4903620,1242,4254
387,34,38,25,0,14387400,3681,4972020,1252,4288
388,30,39,25,0,14477520,3682,4981800,1247,4318
389,38,40,25,0,14539680,3682,5033220,1254,4356
390,25,24,25,0,14665080,3680,5573880,1382,4381
391,27,35,25,0,14720640,3680,5580660,1374,4408
392,33,39,25,0,14813040,3690,5599260,1373,4441
393,17,32,25,0,14916360,3696,5721780,1398,4458
394,36,40,25,0,15008040,3693,5796480,1404,4494
395,31,37,25,0,15093540,3700,5815320,1404,4525
396,31,34,25,0,15204600,3702,5930460,1423,4556
397,42,39,25,0,15261120,3700,5941740,1419,4598
398,31,39,25,0,15360660,3696,6077820,1441,4629
399,33,40,25,0,15436680,3701,6095220,1439,4662
400,37,31,25,0,15572340,3706,6265560,1471,4699
401,24,17,25,0,15643140,3690,6945480,1624,4723
402,34,28,25,0,15734820,3691,6961920,1614,4757
403,32,40,25,0,15809880,3693,6968160,1603,4789
404,31,37,25,0,15893100,3695,6984600,1601,4820
405,26,32,25,0,16007040,3697,7113660,1622,4846
406,38,40,25,0,16077120,3694,7117020,1611,4884
407,31,40,25,0,16146120,3693,7249680,1634,4915
408,29,39,25,0,16256820,3696,7348860,1646,4944
409,38,39,25,0,16356660,3695,7394040,1647,4982
410,35,40,25,0,16447260,3692,7442400,1647,5017
411,32,34,25,0,16542360,3683,7673940,1688,5049
412,31,40,25,0,16624920,3683,7683780,1678,5080
413,29,39,25,0,16711260,3688,7707360,1677,5109
414,27,34,25,0,16811520,3687,7776360,1683,5136
415,29,35,25,0,16901940,3687,7817700,1683,5165
416,36,40,25,0,16990020,3687,7886640,1688,5201
417,29,30,25,0,17078040,3678,8427000,1794,5230
418,37,37,25,0,17160780,3672,8541360,1804,5267
419,28,40,25,0,17242620,3672,8556000,1798,5295
420,31,40,25,0,17340600,3678,8563620,1792,5326
421,32,37,25,0,17419020,3681,8632500,1800,5358
422,34,36,25,0,17493960,3679,8707440,1808,5392
423,38,39,25,0,17615640,3682,8892420,1834,5430
424,33,38,25,0,17690820,3686,8906160,1832,5463
425,33,39,25,0,17795400,3688,8971680,1835,5496
426,36,40,25,0,17885400,3684,9006300,1831,5532
427,31,35,25,0,17967840,3681,9142860,1851,5563
428,33,38,25,0,18077760,3681,9180000,1845,5596
429,29,39,25,0,18159300,3681,9207780,1843,5625
430,31,38,25,0,18240960,3678,9246180,1841,5656
431,31,36,25,0,18325620,3676,9300840,1843,5687
432,38,39,25,0,18418800,3677,9435960,1860,5725
433,37,40,25,0,18504420,3680,9450300,1855,5762
434,37,35,25,0,18622620,3677,9543360,1862,5799
435,27,26,25,0,18693060,3665,10546620,2047,5826
436,31,38,25,0,18770040,3666,10799160,2085,5857
437,36,40,25,0,18835260,3670,10809300,2080,5893
438,39,40,25,0,18959220,3679,10845000,2078,5932
439,31,40,25,0,19049520,3679,10867860,2073,5963
440,38,37,25,0,19126620,3680,10941240,2080,6001
441,29,27,25,0,19243440,3675,11349720,2146,6030
442,26,23,25,0,19319340,3668,11848260,2230,6056
443,36,40,25,0,19408920,3674,11861280,2220,6092
444,24,40,25,0,19478880,3675,11881500,2215,6116
445,44,40,25,0,19587540,3681,11921700,2214,6160
446,34,40,25,0,19688520,3682,11976060,2213,6194
447,23,38,25,0,19754220,3680,12118200,2232,6217
448,26,33,25,0,19867200,3681,12366960,2267,6243
449,39,40,25,0,19930440,3681,12436500,2270,6282
450,23,21,25,0,20065680,3679,12991200,2363,6305
451,26,15,25,0,20140740,3671,13425060,2430,6331
452,37,34,25,0,20219820,3674,13441620,2417,6368
453,28,40,25,0,20285760,3677,13454100,2411,6396
454,26,36,25,0,20394780,3684,13494240,2410,6422
455,31,36,25,0,20512020,3684,13541940,2406,6453
456,27,38,25,0,20572620,3682,13564620,2402,6480
457,27,39,25,0,20659440,3685,13600620,2399,6507
458,36,38,25,0,20756460,3688,13643580,2398,6543
459,37,40,25,0,20849940,3690,13663620,2391,6580
460,31,31,25,0,20958600,3688,13896000,2422,6611
461,32,37,25,0,21051060,3687,13993440,2425,6643
462,28,40,25,0,21090480,3689,14006340,2423,6671
463,26,25,25,0,21221100,3689,14437020,2488,6697
464,36,37,25,0,21296880,3690,14445420,2476,6733
465,32,40,25,0,21374640,3694,14463660,2474,6765
466,20,37,25,0,21458100,3697,14502180,2472,6785
467,38,36,25,0,21578880,3703,14533680,2468,6823
468,25,20,25,0,21660720,3691,15549480,2630,6848
469,27,17,25,0,21757500,3688,15812580,2662,6875
470,35,38,25,0,21828060,3692,15819000,2648,6910
471,19,33,25,0,21940020,3696,15850500,2644,6929
472,29,39,25,0,22031640,3699,15873240,2638,6958
473,33,36,25,0,22115160,3700,15946140,2641,6991
474,35,38,25,0,22216740,3702,16022280,2643,7026
475,31,38,25,0,22303560,3699,16058040,2636,7057
476,28,38,25,0,22391220,3698,16104060,2633,7085
477,23,36,25,0,22485720,3699,16179360,2635,7108
478,40,38,25,0,22562160,3699,16208340,2630,7148
479,37,38,25,0,22658220,3701,16275780,2631,7185
480,31,39,25,0,22746060,3700,16308480,2626,7216
481,32,37,25,0,22850220,3699,16387680,2627,7248
482,31,26,25,0,22948980,3690,17139480,2734,7279
483,33,39,25,0,23005740,3690,17145720,2722,7312
484,23,33,25,0,23110860,3693,17292120,2738,7335
485,34,30,25,0,23197140,3685,17594100,2772,7369
486,34,39,25,0,23283540,3687,17604300,2760,7403
487,24,36,25,0,23361900,3690,17628660,2757,7427
488,38,35,25,0,23491440,3687,17782080,2765,7465
489,34,40,25,0,23536560,3686,17812620,2762,7499
490,29,35,25,0,23640540,3690,17898180,2769,7528
491,34,36,25,0,23733240,3692,17918640,2761,7562
492,32,36,25,0,23829420,3693,17981520,2761,7594
493,33,34,25,0,23921880,3689,18063660,2761,7627
494,31,38,25,0,23999340,3685,18427740,2803,7658
495,33,40,25,0,24088260,3687,18447300,2796,7691
496,40,39,25,0,24196260,3687,18471720,2788,7731
497,26,40,25,0,24264540,3687,18504900,2784,7757
498,34,37,25,0,24369840,3688,18578520,2786,7791
499,31,39,25,0,24448680,3688,18609660,2781,7822
500,35,40,25,0,24526680,3690,18625200,2775,7857
501,37,37,25,0,24638100,3687,18790680,2786,7894
502,20,29,25,0,24737580,3688,19021320,2813,7914
503,26,15,25,0,24816120,3678,19875840,2929,7940
504,19,0,20,5,24912120,3671,20595360,3026,7959
505,6,0,14,11,24966180,3672,20595360,3023,7965
506,5,0,7,18,25031400,3675,20595360,3021,7970
507,2,0,3,22,25061160,3676,20595360,3020,7972
508,6,0,4,21,25083480,3677,20595360,3017,7978
509,7,0,5,20,25096260,3676,20595360,3014,7985
510,5,0,5,20,25115700,3676,20595360,3012,7990
511,6,0,8,17,25126680,3676,20595360,3009,7996
512,0,0,5,20,25143000,3676,20595360,3009,7996
513,12,0,8,17,25184220,3678,20595360,3004,8008
514,13,0,14,11,25198140,3676,20595360,2998,8021
515,10,0,14,11,25240440,3677,20595360,2994,8031
516,8,0,10,15,25288320,3677,20595360,2990,8039
517,13,0,10,15,25349940,3679,20595360,2985,8052
518,10,0,9,16,25380720,3678,20595360,2980,8062
519,9,0,9,16,25413480,3678,20595360,2977,8071
520,7,0,9,16,25423320,3676,20595360,2974,8078
521,5,0,6,19,25469460,3678,20595360,2971,8083
522,7,0,6,19,25498680,3678,20595360,2968,8090
523,11,0,8,17,25511940,3676,20595360,2964,8101
524,3,0,7,18,25530120,3676,20595360,2962,8104
525,7,0,6,19,25561080,3676,20595360,2959,8111
526,5,0,7,18,25588260,3678,20595360,2957,8116
527,6,0,5,20,25613580,3677,20595360,2955,8122
528,5,0,4,21,25640760,3678,20595360,2953,8127
529,3,0,5,20,25644240,3678,20595360,2951,8130
530,8,0,7,18,25672320,3679,20595360,2948,8138
531,8,0,8,17,25690440,3677,20595360,2945,8146
532,2,0,2,23,25725360,3678,20595360,2944,8148
533,4,0,4,21,25739580,3679,20595360,2942,8152
534,6,0,6,19,25749180,3678,20595360,2940,8158
535,9,0,8,17,25771740,3678,20595360,2936,8167
536,6,0,8,17,25786800,3677,20595360,2933,8173
537,9,0,7,18,25822560,3677,20595360,2930,8182
538,7,0,7,18,25842660,3676,20595360,2927,8189
539,8,0,9,16,25867260,3676,20595360,2923,8197
540,11,0,13,12,25901220,3678,20595360,2919,8208
541,10,0,11,14,25934760,3676,20595360,2915,8218
542,8,0,14,11,25957320,3677,20595360,2911,8226
543,15,0,12,13,26030880,3678,20595360,2905,8241
544,12,0,16,9,26052300,3677,20595360,2900,8253
545,8,0,8,17,26114100,3678,20595360,2897,8261
546,10,0,10,15,26153460,3679,20595360,2893,8271
547,2,0,5,20,26197800,3682,20595360,2892,8273
548,4,0,4,21,26224200,3683,20595360,2890,8277
549,11,0,8,17,26247300,3682,20595360,2886,8288
550,8,0,6,19,26275980,3681,20595360,2883,8296
551,4,0,5,20,26303100,3682,20595360,2881,8300
552,3,0,5,20,26318700,3683,20595360,2880,8303
553,1,0,2,23,26343840,3684,20595360,2880,8304
554,4,0,4,21,26353740,3685,20595360,2878,8308
555,0,0,3,22,26357760,3685,20595360,2878,8308
556,8,0,6,19,26383080,3686,20595360,2875,8316
557,2,0,2,23,26394600,3684,20595360,2874,8318
558,8,0,6,19,26404320,3684,20595360,2871,8326
559,5,0,6,19,26421780,3684,20595360,2869,8331
560,8,0,9,16,26440500,3684,20595360,2866,8339
561,11,0,10,15,26481900,3684,20595360,2861,8350
562,12,0,9,16,26514300,3682,20595360,2856,8362
563,10,0,10,15,26549880,3682,20595360,2852,8372
564,5,0,7,18,26576940,3682,20595360,2850,8377
565,7,0,9,16,26610180,3684,20595360,2848,8384
566,9,0,11,14,26632620,3684,20595360,2844,8393
567,9,0,10,15,26674620,3684,20595360,2841,8402
568,13,0,14,11,26710980,3685,20595360,2836,8415
569,16,0,11,14,26764920,3683,20595360,2829,8431
570,10,0,10,15,26803980,3682,20595360,2825,8441
571,15,0,14,11,26849340,3683,20595360,2820,8456
572,9,0,12,13,26889900,3683,20595360,2816,8465
573,5,0,9,16,26926080,3684,20595360,2814,8470
574,7,0,6,19,26976780,3686,20595360,2812,8477
575,5,0,5,20,26997660,3686,20595360,2810,8482
576,6,0,6,19,27012900,3685,20595360,2807,8488
577,6,0,7,18,27034980,3686,20595360,2805,8494
578,5,0,7,18,27056220,3686,20595360,2803,8499
579,3,0,3,22,27087300,3687,20595360,2802,8502
580,4,0,4,21,27092520,3686,20595360,2800,8506
581,7,0,5,20,27107940,3685,20595360,2798,8513
582,3,0,3,22,27123060,3685,20595360,2797,8516
583,8,0,4,21,27134640,3683,20595360,2794,8524
584,12,0,12,13,27149220,3683,20595360,2789,8536
585,9,0,7,18,27185760,3681,20595360,2786,8545
586,9,0,6,19,27211380,3679,20595360,2782,8554
587,13,0,12,13,27230220,3678,20595360,2777,8567
588,12,0,11,14,27268500,3677,20595360,2773,8579
589,18,0,16,9,27311820,3676,20595360,2766,8597
590,5,0,9,16,27363900,3677,20595360,2764,8602
591,11,0,11,14,27406560,3679,20595360,2760,8613
592,10,0,15,10,27427500,3679,20595360,2757,8623
593,14,0,17,8,27467460,3678,20595360,2751,8637
594,10,0,14,11,27526440,3680,20595360,2748,8647
595,8,0,10,15,27576720,3680,20595360,2745,8655
596,7,0,7,18,27623040,3682,20595360,2742,8662
597,4,0,7,18,27643560,3682,20595360,2741,8666
598,2,0,4,21,27678780,3685,20595360,2740,8668
599,6,0,6,19,27701280,3686,20595360,2738,8674
600,5,0,6,19,27723000,3686,20595360,2736,8679
601,3,0,4,21,27740160,3686,20595360,2735,8682
602,5,0,6,19,27754380,3686,20595360,2733,8687
603,8,0,8,17,27781620,3687,20595360,2730,8695
604,2,0,5,20,27801840,3687,20595360,2730,8697
605,9,0,7,18,27827400,3687,20595360,2726,8706
606,10,0,9,16,27844440,3686,20595360,2723,8716
607,7,0,6,19,27876480,3685,20595360,2720,8723
608,4,0,5,20,27894360,3685,20595360,2719,8727
609,9,0,9,16,27927120,3687,20595360,2715,8736
610,14,0,12,13,27956580,3685,20595360,2710,8750
611,13,0,12,13,27991860,3684,20595360,2706,8763
612,9,0,12,13,28031220,3684,20595360,2703,8772
613,10,0,11,14,28085640,3686,20595360,2699,8782
614,12,0,16,9,28110960,3686,20595360,2695,8794
615,8,0,11,14,28157880,3686,20595360,2692,8802
616,7,0,8,17,28222560,3690,20595360,2690,8809
617,9,0,9,16,28243380,3689,20595360,2686,8818
618,11,0,8,17,28275300,3687,20595360,2683,8829
619,8,0,8,17,28297140,3686,20595360,2680,8837
620,10,0,7,18,28338300,3686,20595360,2676,8847
621,4,0,6,19,28362600,3687,20595360,2675,8851
622,10,0,12,13,28389240,3688,20595360,2671,8861
623,5,0,5,20,28432200,3688,20595360,2670,8866
624,0,0,0,25,28450740,3688,20595360,2670,8866
625,4,0,2,23,28452780,3687,20595360,2668,8870
626,10,0,9,16,28458240,3687,20595360,2665,8880
627,6,0,10,15,28481460,3687,20595360,2663,8886
628,6,0,9,16,28517280,3689,20595360,2661,8892
629,8,0,2,23,28573620,3689,20595360,2658,8900
630,9,0,9,16,28575300,3688,20595360,2655,8909
631,9,0,7,18,28605000,3687,20595360,2652,8918
632,7,0,8,17,28623180,3686,20595360,2649,8925
633,13,0,11,14,28665360,3687,20595360,2645,8938
634,7,0,9,16,28690020,3686,20595360,2643,8945
635,16,0,11,14,28731600,3684,20595360,2637,8961
636,7,0,5,20,28766100,3683,20595360,2635,8968
637,4,0,4,21,28779960,3682,20595360,2634,8972
638,16,0,15,10,28793580,3682,20595360,2628,8988
639,11,0,16,9,28828620,3681,20595360,2624,8999
640,8,0,9,16,28884180,3681,20595360,2622,9007
641,6,0,6,19,28929960,3683,20595360,2620,9013
642,8,0,6,19,28962240,3683,20595360,2617,9021
643,6,0,7,18,28985100,3684,20595360,2615,9027
644,8,0,10,15,29005680,3684,20595360,2612,9035
645,5,0,3,22,29045340,3684,20595360,2611,9040
646,4,0,4,21,29054640,3683,20595360,2609,9044
647,7,0,7,18,29064060,3683,20595360,2607,9051
648,8,0,10,15,29086200,3683,20595360,2605,9059
649,6,0,9,16,29118360,3684,20595360,2603,9065
650,4,0,5,20,29149260,3684,20595360,2601,9069
651,6,0,6,19,29172660,3685,20595360,2599,9075
652,1,0,3,22,29190480,3685,20595360,2599,9076
653,10,0,4,21,29216940,3684,20595360,2596,9086
654,6,0,4,21,29235780,3684,20595360,2594,9092
655,4,0,5,20,29246160,3684,20595360,2592,9096
656,5,0,8,17,29253600,3684,20595360,2591,9101
657,5,0,5,20,29286240,3684,20595360,2589,9106
658,9,0,9,16,29299080,3684,20595360,2586,9115
659,12,0,11,14,29326020,3682,20595360,2582,9127
660,5,0,6,19,29366820,3683,20595360,2581,9132
661,12,0,11,14,29389920,3682,20595360,2577,9144
662,9,0,10,15,29431920,3683,20595360,2574,9153
663,11,0,11,14,29468280,3683,20595360,2570,9164
664,16,0,19,6,29499240,3683,20595360,2565,9180
665,9,0,12,13,29574840,3685,20595360,2562,9189
666,5,0,7,18,29616960,3686,20595360,2561,9194
667,10,0,7,18,29656260,3686,20595360,2558,9204
668,3,0,6,19,29667120,3686,20595360,2557,9207
669,4,0,2,23,29704380,3687,20595360,2555,9211
670,2,0,2,23,29713980,3687,20595360,2555,9213
671,4,0,3,22,29720820,3686,20595360,2553,9217
672,3,0,5,20,29725740,3687,20595360,2553,9220
673,6,0,7,18,29733240,3686,20595360,2551,9226
674,2,0,8,17,29737860,3686,20595360,2550,9228
675,4,0,8,17,29754000,3686,20595360,2549,9232
676,5,0,8,17,29769480,3686,20595360,2547,9237
677,10,0,13,12,29781240,3685,20595360,2544,9247
678,11,0,16,9,29801580,3684,20595360,2541,9258
679,11,0,19,6,29825940,3683,20595360,2537,9269
680,9,0,12,13,29887440,3683,20595360,2534,9278
681,9,0,12,13,29928840,3684,20595360,2532,9287
682,6,0,9,16,29956260,3684,20595360,2530,9293
683,13,0,15,10,29972940,3683,20595360,2526,9306
684,15,0,17,8,30012180,3682,20595360,2521,9321
685,13,0,14,11,30061500,3680,20595360,2517,9334
686,5,0,11,14,30093180,3681,20595360,2515,9339
687,10,0,11,14,30127440,3680,20595360,2512,9349
688,8,0,8,17,30163860,3680,20595360,2510,9357
689,12,0,14,11,30176580,3679,20595360,2506,9369
690,12,0,16,9,30215280,3679,20595360,2503,9381
691,12,0,14,11,30255060,3677,20595360,2499,9393
692,15,0,16,9,30298500,3677,20595360,2494,9408
693,8,0,13,12,30324360,3675,20595360,2492,9416
694,7,0,9,16,30370320,3676,20595360,2490,9423
695,3,0,10,15,30380640,3676,20595360,2489,9426
696,3,0,7,18,30404940,3676,20595360,2488,9429
697,6,0,8,17,30420240,3676,20595360,2486,9435
698,7,0,11,14,30437580,3676,20595360,2484,9442
699,4,0,10,15,30462060,3677,20595360,2483,9446
700,6,0,8,17,30489180,3677,20595360,2481,9452
701,6,0,10,15,30499800,3676,20595360,2479,9458
702,8,0,15,10,30508320,3676,20595360,2477,9466
703,9,0,16,9,30540420,3676,20595360,2474,9475
704,9,0,13,12,30589620,3677,20595360,2472,9484
705,6,0,8,17,30621420,3676,20595360,2470,9490
706,14,0,15,10,30641100,3675,20595360,2466,9504
707,8,0,14,11,30668820,3675,20595360,2463,9512
708,13,0,19,6,30691740,3674,20595360,2460,9525
709,9,0,12,13,30759540,3675,20595360,2457,9534
710,18,0,16,9,30786960,3672,20595360,2452,9552
711,12,0,19,6,30812880,3671,20595360,2448,9564
712,10,0,14,11,30870000,3671,20595360,2445,9574
713,15,0,16,9,30929940,3673,20595360,2441,9589
714,5,0,10,15,30971040,3673,20595360,2439,9594
715,12,0,14,11,31000260,3673,20595360,2436,9606
716,3,0,10,15,31026420,3673,20595360,2435,9609
717,7,0,12,13,31036260,3672,20595360,2433,9616
718,6,0,8,17,31084800,3673,20595360,2431,9622
719,6,0,7,18,31108080,3673,20595360,2430,9628
720,6,0,8,17,31119480,3672,20595360,2428,9634
721,7,0,12,13,31125540,3672,20595360,2426,9641
722,8,0,13,12,31149060,3671,20595360,2424,9649
723,7,0,12,13,31177920,3671,20595360,2422,9656
724,10,0,15,10,31196340,3671,20595360,2419,9666
725,8,0,9,16,31252260,3671,20595360,2417,9674
726,8,0,11,14,31268760,3670,20595360,2414,9682
727,11,0,13,12,31287180,3669,20595360,2411,9693
728,7,0,13,12,31318560,3669,20595360,2409,9700
729,9,0,14,11,31352340,3670,20595360,2407,9709
730,6,0,10,15,31385460,3669,20595360,2405,9715
731,11,0,11,14,31416420,3669,20595360,2402,9726
732,7,0,15,10,31423500,3668,20595360,2400,9733
733,13,0,13,12,31469820,3667,20595360,2396,9746
734,1,0,7,18,31500960,3668,20595360,2396,9747
735,9,0,12,13,31514040,3668,20595360,2393,9756
736,7,0,12,13,31540740,3668,20595360,2392,9763
737,7,0,10,15,31564260,3667,20595360,2390,9770
738,10,0,11,14,31587120,3666,20595360,2387,9780
739,16,0,22,3,31608300,3666,20595360,2382,9796
740,17,0,18,7,31675440,3665,20595360,2378,9813
741,6,0,14,11,31716960,3665,20595360,2376,9819
742,8,0,14,11,31748160,3666,20595360,2374,9827
743,2,0,9,16,31788360,3667,20595360,2373,9829
744,6,0,8,17,31818180,3668,20595360,2372,9835
745,4,0,7,18,31833360,3667,20595360,2371,9839
746,0,0,6,19,31838940,3668,20595360,2371,9839
747,5,0,10,15,31844400,3668,20595360,2369,9844
748,6,0,14,11,31849620,3668,20595360,2368,9850
749,5,0,8,17,31896720,3668,20595360,2366,9855
750,5,0,9,16,31909980,3668,20595360,2365,9860
751,12,0,18,7,31923780,3668,20595360,2362,9872
752,9,0,17,8,31946580,3667,20595360,2359,9881
753,9,0,16,9,31998360,3669,20595360,2357,9890
754,12,0,15,10,32060220,3670,20595360,2354,9902
755,8,0,11,14,32103660,3670,20595360,2351,9910
756,6,0,11,14,32128200,3670,20595360,2350,9916
757,9,0,9,16,32166660,3670,20595360,2347,9925
758,9,0,15,10,32181840,3671,20595360,2345,9934
759,11,0,14,11,32224860,3671,20595360,2342,9945
760,7,0,12,13,32254560,3670,20595360,2340,9952
761,7,0,9,16,32285760,3670,20595360,2338,9959
762,10,0,12,13,32303220,3669,20595360,2336,9969
763,12,0,17,8,32315940,3667,20595360,2332,9981
764,10,0,17,8,32354460,3667,20595360,2330,9991
765,11,0,15,10,32403840,3668,20595360,2327,10002
766,7,0,9,16,32458260,3668,20595360,2325,10009
767,7,0,12,13,32471520,3668,20595360,2323,10016
768,4,0,8,17,32502060,3668,20595360,2322,10020
769,8,0,12,13,32519580,3669,20595360,2320,10028
770,2,0,11,14,32531220,3669,20595360,2320,10030
771,3,0,10,15,32554500,3670,20595360,2319,10033
772,7,0,11,14,32582280,3670,20595360,2317,10040
773,3,0,12,13,32586480,3670,20595360,2316,10043
774,5,0,11,14,32619600,3671,20595360,2315,10048
775,4,0,10,15,32639160,3671,20595360,2314,10052
776,6,0,9,16,32665560,3671,20595360,2312,10058
777,7,0,11,14,32683920,3671,20595360,2310,10065
778,10,0,11,14,32708220,3670,20595360,2308,10075
779,10,0,13,12,32736720,3670,20595360,2305,10085
780,6,0,15,10,32749980,3670,20595360,2304,10091
781,10,0,17,8,32786400,3671,20595360,2301,10101
782,10,0,16,9,32836560,3672,20595360,2299,10111
783,13,0,16,9,32878680,3671,20595360,2295,10124
784,5,0,12,13,32917860,3672,20595360,2294,10129
785,14,0,17,8,32949720,3672,20595360,2290,10143
786,6,0,13,12,32986860,3672,20595360,2289,10149
787,9,0,15,10,33022560,3673,20595360,2287,10158
788,11,0,17,8,33058980,3673,20595360,2284,10169
789,7,0,12,13,33106560,3674,20595360,2282,10176
790,4,0,6,19,33158280,3675,20595360,2281,10180
791,13,0,14,11,33168360,3674,20595360,2278,10193
792,9,0,16,9,33183000,3673,20595360,2275,10202
793,4,0,9,16,33231420,3674,20595360,2274,10206
794,4,0,5,20,33253980,3673,20595360,2273,10210
795,3,0,6,19,33255180,3672,20595360,2273,10213
796,6,0,10,15,33256500,3672,20595360,2271,10219
797,7,0,9,16,33280980,3671,20595360,2269,10226
798,10,0,10,15,33304140,3670,20595360,2267,10236
799,9,0,11,14,33323220,3669,20595360,2265,10245
800,11,0,16,9,33348300,3669,20595360,2262,10256
801,12,0,14,11,33390420,3668,20595360,2259,10268
802,9,0,13,12,33416820,3667,20595360,2257,10277
803,11,0,14,11,33459420,3668,20595360,2254,10288
804,8,0,11,14,33498540,3668,20595360,2252,10296
805,11,0,14,11,33528120,3668,20595360,2249,10307
806,8,0,11,14,33562320,3667,20595360,2247,10315
807,10,0,13,12,33584460,3666,20595360,2245,10325
808,5,0,12,13,33604920,3666,20595360,2244,10330
809,16,0,19,6,33649560,3667,20595360,2240,10346
810,10,0,17,8,33688320,3667,20595360,2237,10356
811,11,0,14,11,33749340,3668,20595360,2235,10367
812,8,0,13,12,33780180,3668,20595360,2233,10375
813,7,0,13,12,33805860,3668,20595360,2231,10382
814,7,0,12,13,33841080,3668,20595360,2229,10389
815,6,0,12,13,33866760,3669,20595360,2228,10395
816,8,0,9,16,33910320,3669,20595360,2226,10403
817,3,0,10,15,33920760,3669,20595360,2225,10406
818,7,0,13,12,33930900,3669,20595360,2224,10413
819,7,0,13,12,33967980,3670,20595360,2222,10420
820,4,0,9,16,33999960,3670,20595360,2221,10424
821,8,0,11,14,34017780,3670,20595360,2219,10432
822,3,0,11,14,34032840,3670,20595360,2218,10435
823,7,0,12,13,34054080,3670,20595360,2217,10442
824,11,0,12,13,34095180,3670,20595360,2214,10453
825,10,0,11,14,34129560,3670,20595360,2212,10463
826,12,0,14,11,34138620,3667,20595360,2209,10475
827,6,0,11,14,34174320,3667,20595360,2207,10481
828,5,0,8,17,34205760,3668,20595360,2206,10486
829,14,0,18,7,34210920,3667,20595360,2203,10500
830,11,0,12,13,34270260,3666,20595360,2200,10511
831,10,0,14,11,34290060,3665,20595360,2198,10521
832,9,0,16,9,34318920,3666,20595360,2196,10530
833,3,0,11,14,34362660,3667,20595360,2195,10533
834,2,0,6,19,34399200,3668,20595360,2195,10535
835,4,0,8,17,34407900,3669,20595360,2194,10539
836,10,0,9,16,34430460,3667,20595360,2191,10549
837,9,0,14,11,34441020,3667,20595360,2189,10558
838,5,0,12,13,34473900,3668,20595360,2188,10563
839,5,0,7,18,34510320,3668,20595360,2187,10568
840,6,0,10,15,34519680,3668,20595360,2186,10574
841,3,0,8,17,34542240,3668,20595360,2185,10577
842,6,0,12,13,34553760,3668,20595360,2184,10583
843,3,0,9,16,34576800,3669,20595360,2183,10586
844,5,0,7,18,34610040,3669,20595360,2182,10591
845,5,0,9,16,34616820,3669,20595360,2181,10596
846,8,0,14,11,34626600,3669,20595360,2179,10604
847,7,0,13,12,34663080,3669,20595360,2177,10611
848,8,0,12,13,34689480,3669,20595360,2175,10619
849,5,0,10,15,34721520,3669,20595360,2174,10624
850,9,0,12,13,34745340,3669,20595360,2172,10633
851,8,0,13,12,34770000,3669,20595360,2170,10641
852,9,0,14,11,34801020,3669,20595360,2168,10650
853,6,0,13,12,34837500,3670,20595360,2167,10656
854,5,0,11,14,34874220,3672,20595360,2166,10661
855,9,0,13,12,34900860,3672,20595360,2164,10670
856,17,0,22,3,34928460,3672,20595360,2160,10687
857,11,0,19,6,34988040,3672,20595360,2157,10698
858,13,0,19,6,35040120,3673,20595360,2154,10711
859,6,0,10,15,35098920,3673,20595360,2153,10717
860,9,0,13,12,35123100,3673,20595360,2151,10726
861,8,0,13,12,35158680,3674,20595360,2149,10734
862,8,0,11,14,35199660,3675,20595360,2147,10742
863,4,0,9,16,35218620,3674,20595360,2146,10746
864,4,0,9,16,35236680,3675,20595360,2146,10750
865,6,0,10,15,35251380,3674,20595360,2144,10756
866,8,0,13,12,35269980,3674,20595360,2142,10764
867,5,0,8,17,35295180,3673,20595360,2141,10769
868,5,0,9,16,35315580,3674,20595360,2140,10774
869,6,0,11,14,35332260,3674,20595360,2139,10780
870,6,0,10,15,35364000,3674,20595360,2138,10786
871,3,0,11,14,35376780,3675,20595360,2137,10789
872,5,0,8,17,35415660,3676,20595360,2136,10794
873,8,0,11,14,35428080,3675,20595360,2134,10802
874,8,0,6,19,35455860,3673,20595360,2132,10810
875,14,0,15,10,35467500,3673,20595360,2129,10824
876,13,0,20,5,35494080,3672,20595360,2126,10837
877,7,0,21,4,35524260,3673,20595360,2125,10844
878,16,0,21,4,35599800,3675,20595540,2121,10860
879,9,0,11,14,35684100,3676,20595540,2119,10869
880,14,0,18,7,35710980,3676,20595540,2116,10883
881,10,0,17,8,35741820,3676,20595540,2114,10893
882,7,0,15,10,35782800,3676,20595540,2113,10900
883,10,0,14,11,35833320,3677,20595540,2110,10910
884,5,0,12,13,35855520,3677,20595540,2109,10915
885,3,0,9,16,35889420,3678,20595540,2109,10918
886,5,0,6,19,35907240,3677,20595540,2108,10923
887,5,0,7,18,35922480,3677,20595540,2106,10928
888,7,0,7,18,35933040,3676,20595540,2105,10935
889,4,0,9,16,35934480,3675,20595540,2104,10939
890,1,0,5,20,35957760,3675,20595540,2104,10940
891,2,0,6,19,35960940,3675,20595540,2103,10942
892,3,0,9,16,35960940,3675,20595540,2103,10945
893,13,0,13,12,35982000,3674,20595540,2100,10958
894,11,0,13,12,36015960,3673,20595540,2098,10969
895,8,0,16,9,36033840,3673,20595540,2096,10977
896,5,0,13,12,36077940,3675,20595540,2095,10982
897,9,0,12,13,36118500,3675,20595540,2093,10991
898,13,0,16,9,36152760,3675,20595540,2090,11004
899,12,0,19,6,36183480,3675,20595540,2088,11016
900,8,0,16,9,36233160,3676,20595540,2086,11024
901,15,0,17,8,36298320,3678,20595540,2083,11039
902,9,0,15,10,36334440,3677,20595540,2081,11048
903,8,0,12,13,36379620,3678,20595540,2079,11056
904,8,0,11,14,36406740,3677,20595540,2078,11064
905,8,0,12,13,36433260,3677,20595540,2076,11072
906,6,0,11,14,36452940,3676,20595540,2075,11078
907,12,0,11,14,36490260,3676,20595540,2072,11090
908,2,0,8,17,36518040,3677,20595540,2072,11092
909,4,0,9,16,36530460,3677,20595540,2071,11096
910,2,0,6,19,36549480,3677,20595540,2070,11098
911,6,0,10,15,36556380,3677,20595540,2069,11104
912,4,0,9,16,36572700,3677,20595540,2068,11108
913,3,0,5,20,36597480,3677,20595540,2068,11111
914,7,0,8,17,36600840,3675,20595540,2066,11118
915,5,0,8,17,36607440,3674,20595540,2065,11123
916,1,0,6,19,36626400,3675,20595540,2065,11124
917,12,0,14,11,36633000,3674,20595540,2063,11136
918,10,0,15,10,36655740,3673,20595540,2060,11146
919,11,0,18,7,36688020,3673,20595540,2058,11157
920,10,0,16,9,36731280,3673,20595540,2056,11167
921,12,0,14,11,36784440,3674,20595540,2054,11179
922,9,0,15,10,36813360,3673,20595540,2052,11188
923,11,0,16,9,36857400,3674,20595540,2050,11199
924,12,0,16,9,36900660,3674,20595540,2047,11211
925,11,0,16,9,36947220,3675,20595540,2045,11222
926,6,0,14,11,36976080,3675,20595540,2044,11228
927,10,0,17,8,37002300,3675,20595540,2042,11238
928,7,0,14,11,37050840,3676,20595540,2040,11245
929,11,0,11,14,37099440,3676,20595540,2038,11256
930,11,0,10,15,37128900,3674,20595540,2036,11267
931,5,0,9,16,37139460,3673,20595540,2035,11272
932,13,0,14,11,37164840,3673,20595540,2032,11285
933,7,0,11,14,37199700,3672,20595540,2031,11292
934,3,0,10,15,37215900,3673,20595540,2030,11295
935,3,0,9,16,37235880,3673,20595540,2030,11298
936,4,0,6,19,37269000,3674,20595540,2029,11302
937,5,0,10,15,37272360,3674,20595540,2028,11307
938,7,0,12,13,37291440,3674,20595540,2026,11314
939,8,0,15,10,37318260,3675,20595540,2025,11322
940,2,0,8,17,37360620,3676,20595540,2024,11324
941,7,0,8,17,37381920,3675,20595540,2023,11331
942,6,0,10,15,37396320,3675,20595540,2022,11337
943,3,0,8,17,37415340,3675,20595540,2021,11340
944,9,0,10,15,37441380,3675,20595540,2019,11349
945,7,0,11,14,37453860,3674,20595540,2018,11356
946,13,0,13,12,37487280,3674,20595540,2016,11369
947,11,0,17,8,37511400,3673,20595540,2013,11380
948,16,0,23,2,37551180,3674,20595540,2010,11396
949,14,0,22,3,37600800,3673,20595540,2007,11410
950,12,0,19,6,37671420,3675,20595540,2005,11422
951,9,0,16,9,37725780,3676,20595540,2003,11431
952,7,0,16,9,37756620,3676,20595540,2002,11438
953,7,0,7,18,37837320,3678,20595540,2001,11445
954,9,0,11,14,37848180,3678,20595540,1999,11454
955,6,0,10,15,37868820,3677,20595540,1998,11460
956,9,0,10,15,37895820,3677,20595540,1996,11469
957,8,0,13,12,37922520,3677,20595540,1994,11477
958,5,0,10,15,37948320,3677,20595540,1993,11482
959,6,0,9,16,37972440,3677,20595540,1992,11488
960,7,0,11,14,37991400,3677,20595540,1991,11495
961,6,0,11,14,38012940,3677,20595540,1990,11501
962,8,0,10,15,38049420,3677,20595540,1988,11509
963,11,0,14,11,38078940,3678,20595540,1986,11520
964,4,0,7,18,38109240,3677,20595540,1985,11524
965,6,0,8,17,38125920,3676,20595540,1984,11530
966,10,0,10,15,38140200,3675,20595540,1982,11540
967,4,0,7,18,38166120,3675,20595540,1982,11544
968,6,0,10,15,38168700,3674,20595540,1980,11550
969,10,0,12,13,38193180,3674,20595540,1979,11560
970,7,0,10,15,38224200,3673,20595540,1977,11567
971,12,0,15,10,38244420,3673,20595540,1975,11579
972,5,0,11,14,38283420,3674,20595540,1974,11584
973,10,0,12,13,38309520,3673,20595540,1972,11594
974,9,0,14,11,38325840,3672,20595540,1970,11603
975,9,0,12,13,38373300,3673,20595540,1969,11612
976,11,0,18,7,38393220,3673,20595540,1967,11623
977,16,0,16,9,38452740,3672,20595540,1964,11639
978,10,0,19,6,38474520,3672,20595540,1962,11649
979,4,0,10,15,38536620,3673,20595540,1961,11653
980,3,0,12,13,38542740,3673,20595540,1960,11656
981,5,0,10,15,38579460,3674,20595540,1959,11661
982,6,0,8,17,38620680,3676,20595540,1958,11667
983,8,0,13,12,38629620,3675,20595540,1957,11675
984,2,0,7,18,38653860,3675,20595540,1957,11677
985,4,0,7,18,38674620,3675,20595540,1956,11681
986,3,0,6,19,38685960,3675,20595540,1955,11684
987,9,0,9,16,38695860,3674,20595540,1954,11693
988,7,0,9,16,38718060,3674,20595540,1952,11700
989,6,0,9,16,38736660,3673,20595540,1951,11706
990,6,0,10,15,38750160,3673,20595540,1950,11712
991,10,0,13,12,38763780,3672,20595540,1948,11722
992,14,0,17,8,38800680,3672,20595540,1946,11736
993,7,0,17,8,38834220,3672,20595540,1944,11743
994,12,0,12,13,38902260,3673,20595540,1942,11755
995,14,0,13,12,38945580,3673,20595540,1940,11769
996,7,0,16,9,38953440,3672,20595540,1938,11776
997,15,0,20,5,38997240,3672,20595540,1936,11791
998,4,0,14,11,39043980,3673,20595540,1935,11795
999,7,0,12,13,39090720,3674,20595540,1934,11802
1000,13,0,17,8,39122520,3675,20595540,1931,11815
1001,6,0,14,11,39153720,3675,20595540,1930,11821
1002,8,0,13,12,39211140,3677,20595540,1929,11829
1003,12,0,16,9,39244680,3677,20595540,1926,11841
1004,8,0,17,8,39275940,3677,20595540,1925,11849
1005,4,0,8,17,39330960,3678,20595540,1924,11853
1006,6,0,11,14,39349200,3679,20595540,1923,11859
1007,9,0,8,17,39383760,3678,20595540,1922,11868
1008,5,0,10,15,39397080,3678,20595540,1921,11873
1009,4,0,7,18,39412020,3677,20595540,1920,11877
1010,19,0,13,12,39437400,3675,20595540,1917,11896
1011,25,0,24,1,39475380,3674,20595540,1912,11921
1012,32,16,25,0,39515700,3672,20600700,1907,11953
1013,32,34,25,0,39591060,3675,20611200,1903,11985
1014,24,39,25,0,39652560,3676,20631840,1901,12009
1015,28,39,25,0,39736260,3679,20694000,1905,12037
1016,25,34,25,0,39837180,3682,20769180,1909,12062
1017,31,37,25,0,39907680,3682,20817120,1910,12093
1018,26,34,25,0,39979140,3682,20896140,1914,12119
1019,36,39,25,0,40053540,3681,20958360,1915,12155
1020,32,40,25,0,40125840,3679,21018000,1916,12187
1021,42,37,25,0,40221840,3678,21086820,1918,12229
1022,27,30,25,0,40285620,3675,21257340,1929,12256
1023,34,39,25,0,40357560,3674,21288720,1927,12290
1024,36,40,25,0,40434540,3675,21297720,1924,12326
1025,34,39,25,0,40496760,3674,21354720,1926,12360
1026,23,40,25,0,40574940,3674,21375180,1924,12383
1027,33,40,25,0,40645980,3673,21427920,1926,12416
1028,27,35,25,0,40734600,3673,21506820,1929,12443
1029,37,38,25,0,40804140,3670,21670320,1938,12480
1030,36,36,25,0,40896780,3670,21727260,1939,12516
1031,32,40,25,0,40935480,3671,21732900,1937,12548
1032,32,37,25,0,41035440,3674,21755400,1937,12580
1033,25,37,25,0,41104740,3673,21836400,1940,12605
1034,29,40,25,0,41189880,3673,21858300,1938,12634
1035,33,39,25,0,41243400,3672,21918000,1940,12667
1036,40,40,25,0,41314680,3671,21949260,1939,12707
1037,34,40,25,0,41416080,3671,22006620,1939,12741
1038,33,40,25,0,41476140,3671,22036560,1939,12774
1039,32,40,25,0,41558220,3672,22097700,1941,12806
1040,34,35,25,0,41653020,3671,22276500,1953,12840
1041,23,35,25,0,41706240,3671,22344000,1956,12863
1042,32,38,25,0,41796720,3671,22374780,1954,12895
1043,24,38,25,0,41873700,3673,22392900,1953,12919
1044,27,40,25,0,41943180,3671,22467780,1955,12946
1045,27,40,25,0,41985660,3671,22489080,1955,12973
1046,34,39,25,0,42094740,3674,22611960,1962,13007
1047,27,34,25,0,42160560,3673,22691040,1966,13034
1048,25,13,25,0,42265680,3667,24754560,2141,13059
1049,34,31,25,0,42320400,3667,24761580,2135,13093
1050,18,32,25,0,42398940,3668,24782400,2134,13111
1051,34,39,25,0,42465960,3669,24798960,2131,13145
1052,34,40,25,0,42541860,3670,24839640,2131,13179
1053,31,36,25,0,42623700,3671,24903600,2134,13210
1054,37,40,25,0,42692820,3670,24912660,2130,13247
1055,28,36,25,0,42771240,3670,24977220,2132,13275
1056,26,33,25,0,42852840,3668,25202340,2146,13301
1057,30,36,25,0,42931320,3669,25213440,2144,13331
1058,30,40,25,0,42993120,3669,25225320,2141,13361
1059,32,40,25,0,43071360,3670,25262100,2140,13393
1060,38,40,25,0,43139400,3670,25293660,2140,13431
1061,37,40,25,0,43196760,3668,25357080,2142,13468
1062,25,38,25,0,43298520,3670,25432920,2144,13493
1063,30,40,25,0,43367940,3672,25447800,2143,13523
1064,24,30,25,0,43467900,3672,25685880,2160,13547
1065,33,40,25,0,43517400,3671,25724400,2158,13580
1066,38,40,25,0,43608900,3673,25745160,2157,13618
1067,29,35,25,0,43707420,3674,26019660,2176,13647
1068,27,39,25,0,43750020,3671,26137680,2182,13674
1069,35,38,25,0,43829400,3672,26145300,2179,13709
1070,37,40,25,0,43905120,3672,26192460,2179,13746
1071,25,35,25,0,43979340,3672,26281320,2183,13771
1072,38,39,25,0,44062920,3673,26290560,2180,13809
1073,25,37,25,0,44150760,3673,26357460,2181,13834
1074,26,28,25,0,44225940,3668,26967420,2227,13860
1075,25,26,25,0,44301180,3667,27550260,2270,13885
1076,30,28,25,0,44367960,3664,27707220,2278,13915
1077,31,39,25,0,44426880,3664,27719520,2274,13946
1078,32,39,25,0,44526720,3667,27765060,2274,13978
1079,37,39,25,0,44593440,3666,27805800,2274,14015
1080,25,23,25,0,44679480,3664,28387320,2319,14040
1081,30,30,25,0,44738280,3661,28437900,2317,14070
1082,32,40,25,0,44828400,3663,28475460,2315,14102
1083,30,39,25,0,44877720,3663,28486800,2313,14132
1084,34,40,25,0,44966040,3663,28836000,2337,14166
1085,29,37,25,0,45051540,3663,28885320,2337,14195
1086,34,40,25,0,45125940,3662,29055480,2346,14229
1087,38,40,25,0,45208860,3661,29087100,2344,14267
1088,36,40,25,0,45277680,3660,29132100,2343,14303
1089,32,30,25,0,45355500,3657,29395800,2360,14335
1090,29,34,25,0,45426360,3656,29506680,2363,14364
1091,31,39,25,0,45492600,3657,29520840,2361,14395
1092,32,39,25,0,45579420,3658,29557920,2360,14427
1093,36,40,25,0,45624060,3658,29588040,2360,14463
1094,25,38,25,0,45706320,3656,29664000,2361,14488
1095,25,40,25,0,45787800,3657,29708100,2360,14513
1096,33,40,25,0,45843960,3657,29730480,2360,14546
1097,30,38,25,0,45940560,3658,29781540,2360,14576
1098,28,40,25,0,46022820,3658,29938440,2367,14604
1099,23,27,25,0,46106400,3657,30327240,2395,14627
1100,35,34,25,0,46177020,3654,30840420,2429,14662
1101,40,40,25,0,46239180,3656,30852960,2427,14702
1102,26,39,25,0,46310340,3658,30873420,2426,14728
1103,34,40,25,0,46397220,3659,30901680,2425,14762
1104,38,40,25,0,46485420,3659,30969720,2426,14800
1105,35,40,25,0,46538400,3659,30974940,2423,14835
1106,28,35,25,0,46652040,3659,31221300,2438,14863
1107,30,38,25,0,46711260,3658,31251720,2435,14893
1108,26,36,25,0,46786080,3656,31474380,2448,14919
1109,39,40,25,0,46862400,3655,31489860,2444,14958
1110,37,38,25,0,46936860,3653,31518300,2441,14995
1111,35,40,25,0,46991640,3654,31530420,2439,15030
1112,27,38,25,0,47062560,3655,31564260,2439,15057
1113,29,40,25,0,47160660,3656,31649280,2441,15086
1114,21,35,25,0,47221080,3657,31676040,2442,15107
1115,27,37,25,0,47313900,3658,31931340,2457,15134
1116,27,40,25,0,47373000,3658,31941300,2454,15161
1117,28,30,25,0,47472780,3655,32457900,2489,15189
1118,40,40,25,0,47538900,3655,32465160,2484,15229
1119,26,40,25,0,47599260,3656,32492760,2483,15255
1120,37,40,25,0,47679000,3657,32524740,2482,15292
1121,37,37,25,0,47769900,3657,32567100,2481,15329
1122,33,38,25,0,47847120,3655,32681220,2485,15362
1123,27,35,25,0,47912760,3655,32748840,2487,15389
1124,29,40,25,0,47988480,3655,32812860,2487,15418
1125,32,40,25,0,48048000,3654,32838960,2486,15450
1126,37,37,25,0,48143760,3655,32927280,2488,15487
1127,33,40,25,0,48227940,3653,32975940,2486,15520
1128,36,40,25,0,48279720,3653,32988540,2484,15556
1129,34,39,25,0,48367560,3654,33016680,2482,15590
1130,26,39,25,0,48444600,3654,33052920,2481,15616
1131,41,40,25,0,48504900,3655,33057660,2479,15657
1132,30,40,25,0,48581400,3655,33122820,2480,15687
1133,32,40,25,0,48644520,3656,33163380,2480,15719
1134,40,40,25,0,48727020,3657,33174600,2478,15759
1135,32,38,25,0,48823860,3659,33248640,2480,15791
1136,29,40,25,0,48901980,3658,33344280,2483,15820
1137,31,40,25,0,48954480,3659,33369660,2482,15851
1138,34,40,25,0,49047000,3660,33516000,2489,15885
1139,26,37,25,0,49117680,3660,33636060,2495,15911
1140,31,40,25,0,49205880,3659,33815340,2503,15942
1141,33,40,25,0,49283340,3659,33830040,2500,15975
1142,37,37,25,0,49363560,3658,33885300,2500,16012
1143,31,40,25,0,49411080,3659,33891780,2498,16043
1144,28,32,25,0,49510740,3660,34357260,2529,16071
1145,34,39,25,0,49581840,3659,34456860,2531,16105
1146,30,36,25,0,49645980,3659,34530120,2533,16135
1147,30,40,25,0,49720980,3659,34561740,2531,16165
1148,35,39,25,0,49803720,3660,34638120,2534,16200
1149,32,39,25,0,49885980,3659,34685820,2533,16232
1150,41,40,25,0,49945560,3659,34699140,2530,16273
1151,30,40,25,0,50003880,3659,34726320,2529,16303
1152,27,30,25,0,50133600,3659,35103300,2552,16330
1153,37,40,25,0,50174040,3658,35119440,2548,16367
1154,28,40,25,0,50249160,3660,35141460,2547,16395
1155,37,39,25,0,50333460,3660,35308740,2556,16432
1156,32,37,25,0,50419020,3659,35367660,2556,16464
1157,29,40,25,0,50462400,3658,35408040,2554,16493
1158,33,32,25,0,50567220,3656,35564040,2561,16526
1159,42,39,25,0,50637240,3656,35574660,2557,16568
1160,32,40,25,0,50698380,3656,35610180,2556,16600
1161,26,40,25,0,50781660,3655,35706420,2559,16626
1162,20,34,25,0,50861760,3656,35776560,2561,16646
1163,35,40,25,0,50936460,3656,35826360,2559,16681
1164,33,40,25,0,51014280,3655,35949480,2564,16714
1165,35,38,25,0,51084060,3655,35971620,2562,16749
1166,36,40,25,0,51163500,3656,35992140,2560,16785
1167,36,40,25,0,51239520,3655,36056940,2560,16821
1168,30,40,25,0,51292800,3655,36083760,2559,16851
1169,30,40,25,0,51387540,3655,36133860,2559,16881
1170,36,39,25,0,51482640,3656,36180060,2558,16917
1171,34,35,25,0,51545160,3655,36301680,2563,16951
1172,23,28,25,0,51612720,3652,38796420,2735,16974
1173,29,35,25,0,51690180,3651,38998920,2743,17003
1174,26,39,25,0,51762840,3652,39012480,2740,17029
1175,23,33,25,0,51835440,3652,39495540,2772,17052
1176,20,24,25,0,51918840,3651,41145720,2884,17072
1177,6,0,24,1,51996300,3648,42602340,2984,17078
1178,8,0,13,12,52067160,3648,42602340,2982,17086
1179,3,0,9,16,52108140,3650,42602340,2982,17089
1180,2,0,8,17,52126980,3650,42602340,2981,17091
1181,5,0,7,18,52149600,3650,42602340,2980,17096
1182,6,0,10,15,52157520,3650,42602340,2979,17102
1183,8,0,12,13,52172460,3649,42602340,2977,17110
1184,10,0,19,6,52182420,3649,42602340,2975,17120
1185,7,0,9,16,52248900,3650,42602340,2974,17127
1186,5,0,8,17,52270980,3650,42602340,2973,17132
1187,8,0,11,14,52282680,3649,42602340,2971,17140
1188,5,0,11,14,52296840,3649,42602340,2970,17145
1189,8,0,10,15,52332180,3649,42602340,2969,17153
1190,12,0,15,10,52352520,3649,42602340,2966,17165
1191,15,0,20,5,52387020,3649,42602340,2963,17180
1192,8,0,16,9,52427580,3648,42602340,2961,17188
1193,8,0,17,8,52467540,3649,42602340,2960,17196
1194,9,0,11,14,52531800,3650,42602340,2958,17205
1195,7,0,9,16,52556160,3649,42602340,2956,17212
1196,9,0,15,10,52568100,3650,42602340,2955,17221
1197,8,0,15,10,52589100,3649,42602340,2953,17229
1198,4,0,10,15,52638780,3650,42602340,2952,17233
1199,5,0,11,14,52651020,3650,42602340,2951,17238
1200,8,0,10,15,52686060,3650,42602340,2949,17246
1201,3,0,8,17,52712280,3651,42602340,2949,17249
1202,2,0,7,18,52724280,3651,42602340,2948,17251
1203,5,0,9,16,52736520,3651,42602340,2947,17256
1204,6,0,8,17,52762500,3651,42602340,2946,17262
1205,7,0,8,17,52781340,3650,42602340,2945,17269
1206,7,0,13,12,52788120,3650,42602340,2943,17276
1207,6,0,12,13,52807260,3650,42602340,2942,17282
1208,10,0,14,11,52839240,3650,42602340,2940,17292
1209,6,0,11,14,52876740,3650,42602340,2939,17298
1210,9,0,13,12,52898580,3650,42602340,2937,17307
1211,9,0,14,11,52923900,3650,42602340,2935,17316
1212,15,0,18,7,52958460,3650,42602340,2932,17331
1213,10,0,11,14,53001960,3648,42602340,2930,17341
1214,12,0,9,16,53042280,3648,42602340,2928,17353
1215,7,0,10,15,53059500,3647,42602340,2926,17360
1216,7,0,13,12,53075160,3647,42602340,2925,17367
1217,12,0,15,10,53102280,3647,42602340,2922,17379
1218,12,0,16,9,53146980,3647,42602340,2920,17391
1219,8,0,13,12,53187420,3647,42602340,2918,17399
1220,6,0,11,14,53220360,3647,42602340,2917,17405
1221,5,0,14,11,53226900,3647,42602340,2916,17410
1222,2,0,7,18,53277060,3648,42602340,2916,17412
1223,4,0,7,18,53286480,3648,42602340,2915,17416
1224,6,0,11,14,53294220,3648,42602340,2914,17422
1225,10,0,13,12,53319720,3648,42602340,2912,17432
1226,1,0,7,18,53347980,3648,42602340,2912,17433
1227,4,0,8,17,53365140,3648,42602340,2911,17437
1228,11,0,14,11,53380440,3648,42602340,2909,17448
1229,5,0,11,14,53403480,3648,42602340,2908,17453
1230,4,0,7,18,53433240,3648,42602340,2907,17457
1231,12,0,15,10,53442600,3647,42602340,2905,17469
1232,11,0,15,10,53479560,3647,42602340,2902,17480
1233,3,0,11,14,53514480,3648,42602340,2902,17483
1234,4,0,9,16,53542620,3648,42602340,2901,17487
1235,9,0,11,14,53565900,3648,42602340,2899,17496
1236,15,0,19,6,53583060,3648,42602340,2896,17511
1237,14,0,22,3,53624520,3648,42602340,2893,17525
1238,9,0,19,6,53684700,3649,42602340,2892,17534
1239,15,0,19,6,53755860,3650,42602340,2889,17549
1240,5,0,15,10,53794140,3650,42602340,2888,17554
1241,12,0,15,10,53850120,3651,42602340,2885,17566
1242,15,0,19,6,53883360,3651,42602340,2883,17581
1243,14,0,18,7,53936520,3651,42602340,2880,17595
1244,4,0,12,13,53980140,3651,42602340,2879,17599
1245,11,0,14,11,54019260,3651,42602340,2877,17610
1246,9,0,14,11,54046680,3651,42602340,2875,17619
1247,7,0,11,14,54092940,3652,42602340,2874,17626
1248,3,0,8,17,54118260,3652,42602340,2873,17629
1249,3,0,6,19,54141120,3652,42602340,2873,17632
1250,7,0,8,17,54152760,3652,42602340,2871,17639
1251,6,0,9,16,54166860,3652,42602340,2870,17645
1252,5,0,11,14,54177240,3651,42602340,2869,17650
1253,7,0,12,13,54196740,3651,42602340,2868,17657
1254,5,0,12,13,54225420,3652,42602340,2867,17662
1255,8,0,9,16,54268560,3652,42602340,2865,17670
1256,9,0,8,17,54296520,3652,42602340,2864,17679
1257,13,0,14,11,54313620,3651,42602340,2861,17692
1258,20,0,17,8,54358800,3650,42602460,2857,17712
1259,8,0,12,13,54410820,3650,42602460,2856,17720
1260,12,0,16,9,54442740,3650,42602460,2853,17732
1261,17,0,24,1,54473220,3650,42602460,2850,17749
1262,8,0,15,10,54539340,3651,42602460,2849,17757
1263,12,0,13,12,54581700,3650,42602460,2846,17769
1264,5,0,13,12,54599940,3650,42602460,2845,17774
1265,14,0,11,14,54645780,3649,42602460,2843,17788
1266,6,0,8,17,54677760,3649,42602460,2842,17794
1267,7,0,14,11,54684000,3649,42602460,2840,17801
1268,3,0,7,18,54715800,3649,42602460,2840,17804
1269,3,0,7,18,54724860,3649,42602460,2839,17807
1270,4,0,7,18,54736860,3649,42602460,2838,17811
1271,2,0,8,17,54743100,3649,42602460,2838,17813
1272,5,0,7,18,54761220,3649,42602460,2837,17818
1273,5,0,9,16,54775020,3649,42602460,2836,17823
1274,6,0,11,14,54781800,3648,42602460,2835,17829
1275,4,0,8,17,54806880,3648,42602460,2834,17833
1276,4,0,8,17,54816720,3648,42602460,2833,17837
1277,6,0,11,14,54832920,3648,42602460,2832,17843
1278,3,0,9,16,54852060,3648,42602460,2832,17846
1279,11,0,13,12,54875220,3648,42602460,2830,17857
1280,9,0,14,11,54909300,3648,42602460,2828,17866
1281,4,0,11,14,54942360,3649,42602460,2827,17870
1282,9,0,10,15,54985740,3649,42602460,2826,17879
1283,12,0,16,9,55009200,3650,42602460,2823,17891
1284,15,0,15,10,55051080,3648,42602460,2820,17906
1285,15,0,16,9,55090500,3648,42602460,2818,17921
1286,10,0,13,12,55130940,3647,42602460,2816,17931
1287,12,0,18,7,55159200,3647,42602460,2814,17943
1288,13,0,16,9,55206540,3647,42602460,2811,17956
1289,7,0,18,7,55235460,3648,42602460,2810,17963
1290,10,0,18,7,55284840,3648,42602460,2808,17973
1291,8,0,14,11,55337820,3649,42602460,2807,17981
1292,9,0,14,11,55376340,3649,42602460,2805,17990
1293,2,0,9,16,55408980,3650,42602460,2805,17992
1294,4,0,8,17,55428060,3650,42602460,2804,17996
1295,7,0,10,15,55449180,3650,42602460,2802,18003
1296,9,0,11,14,55466520,3649,42602460,2801,18012
1297,5,0,10,15,55479720,3649,42602460,2800,18017
1298,6,0,8,17,55514580,3649,42602460,2799,18023
1299,6,0,7,18,55527180,3648,42602460,2798,18029
1300,0,0,6,19,55535700,3649,42602460,2798,18029
1301,8,0,9,16,55550580,3648,42602460,2796,18037
1302,6,0,10,15,55564560,3648,42602460,2795,18043
1303,5,0,12,13,55573740,3648,42602460,2794,18048
1304,7,0,13,12,55599840,3648,42602460,2793,18055
1305,9,0,11,14,55636200,3648,42602460,2791,18064
1306,10,0,11,14,55661640,3647,42602460,2789,18074
1307,13,0,13,12,55680000,3646,42602460,2787,18087
1308,6,0,13,12,55693440,3645,42602460,2786,18093
1309,9,0,12,13,55738080,3646,42602460,2784,18102
1310,5,0,12,13,55753080,3646,42602460,2783,18107
1311,8,0,13,12,55782420,3646,42602460,2782,18115
1312,9,0,11,14,55816740,3646,42602460,2780,18124
1313,7,0,8,17,55851720,3645,42602460,2779,18131
1314,7,0,10,15,55869180,3645,42602460,2778,18138
1315,12,0,13,12,55897020,3645,42602460,2776,18150
1316,6,0,9,16,55934520,3645,42602460,2775,18156
1317,4,0,9,16,55954620,3645,42602460,2774,18160
1318,2,0,6,19,55970340,3645,42602460,2773,18162
1319,7,0,6,19,55987980,3645,42602460,2772,18169
1320,10,0,13,12,55990380,3644,42602460,2770,18179
1321,1,0,6,19,56028660,3645,42602460,2770,18180
1322,7,0,6,19,56046660,3644,42602460,2769,18187
1323,9,0,9,16,56053320,3643,42602460,2767,18196
1324,7,0,10,15,56068500,3643,42602460,2766,18203
1325,6,0,10,15,56088120,3643,42602460,2765,18209
1326,6,0,11,14,56103420,3643,42602460,2764,18215
1327,6,0,12,13,56125140,3643,42602460,2763,18221
1328,2,0,7,18,56155260,3643,42602460,2762,18223
1329,9,0,13,12,56157480,3643,42602460,2761,18232
1330,5,0,10,15,56200020,3643,42602460,2760,18237
1331,9,0,13,12,56224200,3644,42602460,2758,18246
1332,8,0,14,11,56252340,3644,42602460,2757,18254
1333,8,0,12,13,56290260,3644,42602460,2756,18262
1334,14,0,16,9,56321460,3643,42602460,2753,18276
1335,8,0,13,12,56355420,3643,42602460,2752,18284
1336,7,0,13,12,56388180,3644,42602460,2750,18291
1337,12,0,18,7,56413140,3644,42602460,2748,18303
1338,10,0,17,8,56463180,3644,42602460,2746,18313
1339,10,0,13,12,56526120,3645,42602460,2745,18323
1340,7,0,11,14,56548560,3644,42602460,2743,18330
1341,3,0,8,17,56576340,3645,42602460,2743,18333
1342,5,0,11,14,56594220,3645,42602460,2742,18338
1343,4,0,9,16,56607480,3645,42602460,2741,18342
1344,6,0,9,16,56634960,3645,42602460,2740,18348
1345,6,0,11,14,56639280,3644,42602460,2739,18354
1346,2,0,10,15,56645100,3644,42602460,2739,18356
1347,3,0,11,14,56654580,3644,42602460,2738,18359
1348,11,0,19,6,56657160,3644,42602460,2736,18370
1349,8,0,21,4,56685600,3644,42602460,2735,18378
1350,7,0,17,8,56739060,3645,42602460,2734,18385
1351,5,0,15,10,56763360,3645,42602460,2733,18390
1352,8,0,12,13,56805480,3645,42602460,2731,18398
1353,9,0,16,9,56823840,3645,42602460,2730,18407
1354,7,0,15,10,56846040,3645,42602460,2729,18414
1355,8,0,15,10,56872320,3644,42602460,2727,18422
1356,12,0,19,6,56893320,3644,42602460,2725,18434
1357,12,0,20,5,56931000,3644,42602460,2723,18446
1358,8,0,17,8,56971020,3644,42602460,2722,18454
1359,15,0,22,3,57006540,3644,42602460,2719,18469
1360,8,0,16,9,57048840,3643,42602460,2718,18477
1361,8,0,18,7,57074160,3643,42602460,2716,18485
1362,10,0,19,6,57091140,3642,42602460,2715,18495
1363,9,0,17,8,57159300,3644,42602460,2713,18504
1364,8,0,16,9,57185640,3644,42602460,2712,18512
1365,11,0,19,6,57213960,3644,42602460,2710,18523
1366,8,0,18,7,57250440,3644,42602460,2708,18531
1367,3,0,12,13,57286260,3644,42602460,2708,18534
1368,8,0,16,9,57309300,3645,42602460,2706,18542
1369,3,0,13,12,57331800,3645,42602460,2706,18545
1370,6,0,15,10,57349980,3645,42602460,2705,18551
1371,5,0,13,12,57371100,3645,42602460,2704,18556
1372,7,0,12,13,57400140,3645,42602460,2703,18563
1373,3,0,11,14,57414600,3645,42602460,2702,18566
1374,8,0,15,10,57427620,3645,42602460,2701,18574
1375,8,0,15,10,57446700,3644,42602460,2700,18582
1376,9,0,17,8,57482100,3645,42602460,2698,18591
1377,7,0,13,12,57514260,3644,42602460,2697,18598
1378,5,0,15,10,57526320,3644,42602460,2696,18603
1379,11,0,20,5,57542340,3644,42602460,2694,18614
1380,10,0,15,10,57599880,3644,42602460,2692,18624
1381,10,0,17,8,57627360,3644,42602460,2691,18634
1382,15,0,19,6,57672840,3644,42602460,2688,18649
1383,14,0,23,2,57708360,3644,42602460,2686,18663
1384,12,1,25,0,57735840,3643,42603000,2684,18675
1385,11,0,20,5,57812160,3644,42603180,2682,18686
1386,15,0,21,4,57865380,3644,42603180,2679,18701
1387,10,0,22,3,57893520,3644,42603180,2678,18711
1388,7,0,16,9,57955500,3645,42603180,2677,18718
1389,6,0,14,11,57986580,3645,42603180,2676,18724
1390,10,0,17,8,58014060,3645,42603180,2674,18734
1391,3,0,15,10,58032960,3645,42603180,2673,18737
1392,4,0,14,11,58056540,3646,42603180,2673,18741
1393,2,0,10,15,58089660,3646,42603180,2672,18743
1394,7,0,13,12,58104300,3646,42603180,2671,18750
1395,4,0,12,13,58115100,3646,42603180,2671,18754
1396,6,0,11,14,58135620,3646,42603180,2670,18760
1397,3,0,12,13,58143060,3646,42603180,2669,18763
1398,8,0,14,11,58164540,3645,42603180,2668,18771
1399,9,0,19,6,58177860,3645,42603180,2666,18780
1400,9,0,15,10,58227060,3646,42603180,2665,18789
1401,8,0,15,10,58252920,3645,42603180,2663,18797
1402,16,0,20,5,58282980,3645,42603180,2661,18813
1403,10,0,20,5,58313100,3644,42603180,2659,18823
1404,10,0,22,3,58345620,3645,42603180,2657,18833
1405,11,0,16,9,58411920,3645,42603180,2656,18844
1406,8,0,16,9,58436880,3645,42603180,2654,18852
1407,7,0,16,9,58458900,3644,42603180,2653,18859
1408,7,0,13,12,58493820,3644,42603180,2652,18866
1409,9,0,18,7,58508460,3644,42603180,2650,18875
1410,8,0,17,8,58549620,3645,42603180,2649,18883
1411,9,0,17,8,58578780,3644,42603180,2648,18892
1412,4,0,12,13,58611600,3645,42603180,2647,18896
1413,8,0,16,9,58626360,3645,42603180,2646,18904
1414,7,0,14,11,58653420,3644,42603180,2645,18911
1415,5,0,12,13,58669680,3644,42603180,2644,18916
1416,6,0,14,11,58683540,3644,42603180,2643,18922
1417,1,0,11,14,58702320,3644,42603180,2643,18923
1418,3,0,11,14,58715040,3644,42603180,2642,18926
1419,4,0,12,13,58733100,3644,42603180,2641,18930
1420,3,0,13,12,58734300,3644,42603180,2641,18933
1421,8,0,15,10,58753980,3644,42603180,2640,18941
1422,6,0,13,12,58777560,3643,42603180,2639,18947
1423,8,0,14,11,58795740,3643,42603180,2637,18955
1424,7,0,17,8,58802700,3643,42603180,2636,18962
1425,13,0,23,2,58828800,3643,42603180,2634,18975
1426,13,1,25,0,58862160,3642,42605280,2632,18988
1427,8,0,19,6,58938660,3644,42608220,2631,18996
1428,15,0,23,2,58976100,3644,42608220,2629,19011
1429,8,0,18,7,59029080,3644,42608220,2627,19019
1430,9,0,17,8,59061540,3644,42608220,2626,19028
1431,11,0,22,3,59097960,3645,42608220,2624,19039
1432,12,0,24,1,59123220,3644,42608220,2622,19051
1433,7,0,17,8,59193240,3645,42608220,2621,19058
1434,6,0,14,11,59223420,3645,42608220,2620,19064
1435,10,0,17,8,59255760,3645,42608220,2618,19074
1436,7,0,18,7,59275200,3645,42608220,2617,19081
1437,3,0,12,13,59303040,3645,42608220,2617,19084
1438,3,0,12,13,59316660,3645,42608220,2616,19087
1439,3,0,13,12,59329620,3645,42608220,2616,19090
1440,5,0,14,11,59346420,3646,42608220,2615,19095
1441,7,0,15,10,59364180,3645,42608220,2614,19102
1442,13,0,18,7,59389140,3645,42608220,2612,19115
1443,6,0,12,13,59428980,3644,42608220,2611,19121
1444,5,0,15,10,59439180,3645,42608220,2610,19126
1445,8,0,16,9,59464980,3645,42608220,2609,19134
1446,5,0,14,11,59489280,3644,42608220,2608,19139
1447,5,0,13,12,59517300,3645,42608220,2607,19144
1448,6,0,12,13,59539140,3645,42608220,2606,19150
1449,8,0,14,11,59560260,3645,42608220,2605,19158
1450,8,0,15,10,59580120,3644,42608220,2604,19166
1451,7,0,15,10,59600520,3644,42608220,2602,19173
1452,17,0,24,1,59619540,3643,42608220,2600,19190
1453,13,4,25,0,59647740,3643,42613440,2599,19203
1454,3,0,16,9,59722080,3644,42614580,2598,19206
1455,11,0,18,7,59759580,3644,42614580,2596,19217
1456,9,0,16,9,59796540,3644,42614580,2594,19226
1457,10,0,17,8,59820120,3644,42614580,2593,19236
1458,12,0,19,6,59851980,3643,42614580,2591,19248
1459,6,0,16,9,59883120,3643,42614580,2590,19254
1460,9,0,15,10,59923440,3644,42614580,2589,19263
1461,7,0,16,9,59950260,3644,42614580,2588,19270
1462,6,0,14,11,59974560,3644,42614580,2587,19276
1463,9,0,15,10,60000180,3643,42614580,2585,19285
1464,2,0,11,14,60026700,3644,42614580,2585,19287
1465,4,0,10,15,60047100,3644,42614580,2584,19291
1466,3,0,11,14,60055020,3644,42614580,2584,19294
1467,1,0,11,14,60060480,3644,42614580,2584,19295
1468,5,0,12,13,60077040,3644,42614580,2583,19300
1469,11,0,18,7,60087480,3644,42614580,2581,19311
1470,9,0,17,8,60104100,3642,42614580,2580,19320
1471,8,0,17,8,60134220,3642,42614580,2578,19328
1472,7,0,15,10,60180180,3643,42614580,2577,19335
1473,11,0,18,7,60201660,3643,42614580,2576,19346
1474,7,0,13,12,60224760,3642,42614580,2575,19353
1475,9,0,14,11,60263940,3642,42614580,2573,19362
1476,8,0,18,7,60272940,3642,42614580,2572,19370
1477,15,0,21,4,60310380,3641,42614580,2570,19385
1478,8,0,18,7,60347760,3641,42614580,2568,19393
1479,10,0,14,11,60408840,3642,42614580,2567,19403
1480,13,0,18,7,60428460,3641,42614580,2565,19416
1481,6,0,16,9,60458520,3641,42614580,2564,19422
1482,7,0,16,9,60493560,3642,42614580,2563,19429
1483,9,0,17,8,60522240,3642,42614580,2561,19438
1484,7,0,14,11,60560760,3642,42614580,2560,19445
1485,12,0,19,6,60583140,3642,42614580,2558,19457
1486,10,0,16,9,60620700,3641,42614580,2557,19467
1487,7,0,15,10,60648060,3641,42614580,2556,19474
1488,9,0,16,9,60661200,3640,42614580,2554,19483
1489,6,0,15,10,60693180,3640,42614580,2554,19489
1490,6,0,12,13,60724080,3640,42614580,2553,19495
1491,7,0,17,8,60732000,3640,42614580,2552,19502
1492,3,0,14,11,60752100,3640,42614580,2551,19505
1493,8,0,16,9,60790080,3641,42614580,2550,19513
1494,10,0,19,6,60804540,3640,42614580,2548,19523
1495,10,0,17,8,60836340,3640,42614580,2547,19533
1496,10,0,19,6,60868560,3640,42614580,2545,19543
1497,10,0,22,3,60899160,3640,42614580,2544,19553
1498,5,0,21,4,60928560,3641,42614580,2543,19558
1499,7,0,14,11,61004340,3642,42614580,2542,19565
1500,9,0,19,6,61019100,3642,42614580,2541,19574
1501,15,0,21,4,61061580,3642,42614580,2538,19589
1502,12,0,20,5,61094220,3641,42614580,2537,19601
1503,12,0,21,4,61134420,3641,42614580,2535,19613
1504,11,2,25,0,61156740,3641,42614580,2533,19624
1505,7,0,22,3,61225860,3643,42615120,2532,19631
1506,7,0,15,10,61283460,3643,42615120,2531,19638
1507,7,0,16,9,61304760,3643,42615120,2530,19645
1508,5,0,15,10,61330920,3643,42615120,2529,19650
1509,7,0,15,10,61367400,3644,42615120,2528,19657
1510,7,0,14,11,61396440,3644,42615120,2527,19664
1511,6,0,14,11,61412820,3644,42615120,2526,19670
1512,6,0,13,12,61441200,3644,42615120,2525,19676
1513,5,0,13,12,61457940,3644,42615120,2525,19681
1514,7,0,15,10,61477200,3644,42615120,2523,19688
1515,8,0,17,8,61492800,3644,42615120,2522,19696
1516,1,0,11,14,61514940,3643,42615120,2522,19697
1517,7,0,13,12,61537680,3644,42615120,2521,19704
1518,5,0,15,10,61553100,3644,42615120,2520,19709
1519,7,0,17,8,61572900,3644,42615120,2519,19716
1520,10,0,18,7,61604400,3644,42615120,2518,19726
1521,15,0,20,5,61646460,3644,42615120,2516,19741
1522,11,0,19,6,61681260,3643,42615120,2514,19752
1523,7,0,18,7,61711260,3643,42615120,2513,19759
1524,10,0,17,8,61747320,3643,42615120,2511,19769
1525,6,0,13,12,61780740,3643,42615120,2511,19775
1526,19,0,23,2,61807920,3642,42615120,2508,19794
1527,15,0,21,4,61842960,3641,42615360,2506,19809
1528,4,0,16,9,61881240,3641,42615360,2505,19813
1529,14,0,19,6,61931340,3642,42615360,2503,19827
1530,10,0,18,7,61963620,3641,42615360,2501,19837
1531,9,0,16,9,61999380,3641,42615360,2500,19846
1532,4,0,14,11,62022780,3641,42615360,2500,19850
1533,9,0,16,9,62053560,3641,42615360,2498,19859
1534,4,0,12,13,62080920,3641,42615360,2498,19863
1535,7,0,15,10,62099700,3641,42615360,2497,19870
1536,1,0,10,15,62124720,3642,42615360,2496,19871
1537,8,0,14,11,62135340,3641,42615360,2495,19879
1538,3,0,16,9,62141460,3642,42615360,2495,19882
1539,2,0,11,14,62183160,3643,42615360,2495,19884
1540,5,0,13,12,62188260,3642,42615360,2494,19889
1541,5,0,14,11,62194680,3642,42615360,2493,19894
1542,6,0,12,13,62216580,3641,42615360,2492,19900
1543,8,0,15,10,62237640,3641,42615360,2491,19908
1544,7,0,18,7,62248500,3641,42615360,2490,19915
1545,9,0,19,6,62287800,3642,42615360,2489,19924
1546,15,0,19,6,62329980,3641,42615360,2487,19939
1547,10,0,17,8,62371740,3641,42615360,2485,19949
1548,10,0,18,7,62404740,3641,42615360,2484,19959
1549,12,0,19,6,62437740,3641,42615360,2482,19971
1550,14,0,21,4,62490240,3641,42615360,2480,19985
1551,10,0,19,6,62523720,3641,42615360,2478,19995
1552,11,0,17,8,62561760,3640,42615360,2477,20006
1553,5,0,16,9,62586780,3640,42615360,2476,20011
1554,12,0,20,5,62626260,3641,42615360,2474,20023
1555,11,0,23,2,62664900,3641,42615360,2473,20034
1556,10,0,23,2,62710080,3642,42618060,2472,20044
1557,5,0,14,11,62779800,3643,42618060,2471,20049
1558,3,0,13,12,62794980,3643,42618060,2470,20052
1559,5,0,16,9,62807940,3643,42618060,2470,20057
1560,5,0,11,14,62855340,3644,42618060,2469,20062
1561,4,0,14,11,62860440,3644,42618060,2468,20066
1562,10,0,17,8,62882760,3644,42618060,2467,20076
1563,4,0,16,9,62908200,3644,42618060,2466,20080
1564,7,0,14,11,62947020,3645,42618060,2465,20087
1565,4,0,14,11,62969700,3645,42618060,2465,20091
1566,6,0,12,13,62994660,3645,42618060,2464,20097
1567,11,0,18,7,63011100,3645,42618060,2462,20108
1568,11,0,20,5,63032580,3644,42618060,2461,20119
1569,9,0,20,5,63064080,3644,42618060,2460,20128
1570,11,0,20,5,63114720,3645,42618060,2458,20139
1571,11,0,18,7,63169320,3645,42618060,2456,20150
1572,6,0,17,8,63185340,3644,42618060,2456,20156
1573,6,0,18,7,63220260,3645,42618060,2455,20162
1574,10,0,17,8,63266400,3646,42618060,2453,20172
1575,8,0,14,11,63301740,3645,42618060,2452,20180
1576,10,0,15,10,63333600,3645,42618060,2451,20190
1577,8,0,17,8,63351840,3645,42618060,2450,20198
1578,6,0,14,11,63381960,3645,42618060,2449,20204
1579,4,0,14,11,63412260,3646,42618060,2448,20208
1580,4,0,14,11,63426240,3646,42618060,2448,20212
1581,7,0,14,11,63456060,3646,42618060,2447,20219
1582,8,0,14,11,63481860,3646,42618060,2446,20227
1583,8,0,15,10,63496860,3645,42618060,2444,20235
1584,3,0,13,12,63518040,3646,42618060,2444,20238
1585,2,0,11,14,63537600,3646,42618060,2444,20240
1586,7,0,14,11,63545700,3645,42618060,2443,20247
1587,8,0,17,8,63558480,3645,42618060,2442,20255
1588,6,0,15,10,63593700,3646,42618060,2441,20261
1589,7,0,14,11,63635280,3646,42618060,2440,20268
1590,4,0,16,9,63646200,3646,42618060,2439,20272
1591,12,0,23,2,63661740,3646,42618060,2438,20284
1592,13,0,23,2,63720480,3647,42618060,2436,20297
1593,9,0,15,10,63772500,3646,42618060,2435,20306
1594,6,0,16,9,63794100,3647,42618060,2434,20312
1595,13,0,22,3,63808680,3646,42618060,2432,20325
1596,11,0,18,7,63871620,3646,42618060,2430,20336
1597,6,0,13,12,63906120,3646,42618060,2430,20342
1598,11,0,16,9,63925200,3645,42618060,2428,20353
1599,15,0,21,4,63953460,3645,42618060,2426,20368
1600,7,0,17,8,63987840,3645,42618060,2425,20375
1601,15,0,24,1,64022400,3645,42618060,2423,20390
1602,5,0,14,11,64071840,3645,42618060,2422,20395
1603,10,0,18,7,64101660,3645,42618060,2421,20405
1604,2,0,15,10,64129740,3646,42618060,2421,20407
1605,11,0,18,7,64170840,3646,42618060,2419,20418
1606,2,0,14,11,64191360,3646,42618060,2419,20420
1607,5,0,10,15,64228680,3647,42618060,2418,20425
1608,3,0,8,17,64236120,3646,42618060,2418,20428
1609,7,0,14,11,64237140,3646,42618060,2417,20435
1610,4,0,15,10,64245300,3646,42618060,2416,20439
1611,7,0,16,9,64263180,3645,42618060,2415,20446
1612,5,0,11,14,64295580,3645,42618060,2415,20451
1613,4,0,10,15,64312320,3645,42618060,2414,20455
1614,10,0,17,8,64318320,3645,42618060,2413,20465
1615,8,0,17,8,64340280,3644,42618060,2412,20473
1616,7,0,17,8,64364340,3644,42618060,2411,20480
1617,9,0,19,6,64395240,3645,42618060,2409,20489
1618,13,0,21,4,64434900,3645,42618060,2408,20502
1619,12,0,23,2,64471080,3645,42618780,2406,20514
1620,9,0,19,6,64530420,3645,42618780,2405,20523
1621,14,0,21,4,64566480,3645,42618780,2403,20537
1622,16,0,24,1,64627080,3646,42618780,2401,20553
1623,7,0,18,7,64668360,3645,42618780,2400,20560
1624,12,0,19,6,64721400,3646,42618780,2398,20572
1625,12,0,19,6,64754340,3645,42618780,2397,20584
1626,8,0,19,6,64782180,3645,42618780,2395,20592
1627,6,0,15,10,64830180,3646,42618780,2395,20598
1628,6,0,13,12,64862280,3646,42618780,2394,20604
1629,3,0,13,12,64875780,3646,42618780,2393,20607
1630,5,0,15,10,64891380,3647,42618780,2393,20612
1631,6,0,12,13,64925760,3647,42618780,2392,20618
1632,4,0,12,13,64939740,3647,42618780,2391,20622
1633,3,0,9,16,64958580,3646,42618780,2391,20625
1634,5,0,12,13,64962180,3646,42618780,2390,20630
1635,7,0,15,10,64971060,3646,42618780,2389,20637
1636,4,0,13,12,64998300,3646,42618780,2389,20641
1637,5,0,12,13,65011680,3646,42618780,2388,20646
1638,2,0,11,14,65028480,3646,42618780,2388,20648
1639,5,0,12,13,65038860,3646,42618780,2387,20653
1640,11,0,15,10,65049900,3645,42618780,2386,20664
1641,14,0,19,6,65070480,3644,42618780,2384,20678
1642,5,0,16,9,65102940,3644,42618780,2383,20683
1643,8,0,14,11,65143020,3644,42618780,2382,20691
1644,7,0,17,8,65152260,3644,42618780,2381,20698
1645,8,0,15,10,65180100,3643,42618780,2380,20706
1646,9,0,18,7,65210460,3644,42618780,2379,20715
1647,4,0,14,11,65241720,3644,42618780,2378,20719
1648,8,0,16,9,65275500,3645,42618780,2377,20727
1649,11,0,17,8,65299500,3644,42618780,2376,20738
1650,9,0,19,6,65325480,3644,42618780,2375,20747
1651,5,0,13,12,65369220,3644,42618780,2374,20752
1652,7,0,14,11,65380620,3644,42618780,2373,20759
1653,4,0,10,15,65419140,3644,42618780,2373,20763
1654,6,0,12,13,65433180,3644,42618780,2372,20769
1655,5,0,13,12,65451360,3644,42618780,2371,20774
1656,9,0,19,6,65459160,3644,42618780,2370,20783
1657,6,0,18,7,65491560,3645,42618780,2369,20789
1658,7,0,15,10,65537880,3645,42618780,2368,20796
1659,5,0,17,8,65558160,3646,42618780,2368,20801
1660,7,0,20,5,65569620,3645,42618780,2367,20808
1661,5,0,13,12,65644560,3647,42618780,2366,20813
1662,7,0,18,7,65653740,3647,42618780,2365,20820
1663,5,0,13,12,65684520,3647,42618780,2364,20825
1664,12,0,18,7,65710440,3647,42618780,2363,20837
1665,7,0,16,9,65736360,3647,42618780,2362,20844
1666,10,0,21,4,65751900,3647,42618780,2361,20854
1667,12,0,17,8,65818200,3647,42618780,2359,20866
1668,10,0,21,4,65839320,3647,42618780,2358,20876
1669,7,0,18,7,65883120,3647,42618780,2357,20883
1670,10,0,15,10,65923980,3647,42618780,2356,20893
1671,10,0,16,9,65952840,3647,42618780,2354,20903
1672,4,0,13,12,65981280,3647,42618780,2354,20907
1673,11,0,18,7,66001800,3647,42618780,2352,20918
1674,17,0,25,0,66022500,3646,42618780,2350,20935
1675,4,0,16,9,66083880,3647,42618780,2350,20939
1676,11,0,19,6,66120480,3647,42618780,2348,20950
1677,7,0,16,9,66155760,3647,42618780,2347,20957
1678,7,0,14,11,66188820,3647,42618780,2346,20964
1679,5,0,13,12,66209280,3647,42618780,2346,20969
1680,6,0,15,10,66222420,3647,42618780,2345,20975
1681,7,0,15,10,66249360,3647,42618780,2344,20982
1682,9,0,20,5,66255780,3647,42618780,2343,20991
1683,15,0,23,2,66311460,3647,42618780,2341,21006
1684,35,16,25,0,66372780,3647,42622020,2337,21041
1685,32,39,25,0,66417120,3648,42628440,2334,21073
1686,42,40,25,0,66480480,3649,42649200,2333,21115
1687,30,38,25,0,66555660,3650,42701040,2334,21145
1688,38,40,25,0,66617460,3651,42734340,2333,21183
1689,30,39,25,0,66660840,3651,42745860,2333,21213
1690,30,40,25,0,66752160,3652,42826620,2335,21243
1691,25,40,25,0,66790440,3652,42899280,2337,21268
1692,31,40,25,0,66853800,3653,42928140,2337,21299
1693,31,40,25,0,66911520,3653,42937620,2336,21330
1694,31,38,25,0,66987060,3653,42998940,2337,21361
1695,22,40,25,0,67040940,3653,43095120,2340,21383
1696,34,40,25,0,67096320,3653,43106100,2339,21417
1697,30,39,25,0,67170300,3654,43119120,2337,21447
1698,32,37,25,0,67231320,3654,43144500,2337,21479
1699,39,40,25,0,67288200,3653,43195200,2337,21518
1700,30,40,25,0,67350180,3652,43447260,2348,21548
1701,37,40,25,0,67388160,3653,43454580,2347,21585
1702,29,40,25,0,67445760,3654,43469760,2347,21614
1703,32,40,25,0,67508220,3655,43480440,2346,21646
1704,35,40,25,0,67572300,3655,43578180,2349,21681
1705,34,40,25,0,67653060,3656,43655460,2351,21715
1706,30,39,25,0,67726200,3656,43737900,2353,21745
1707,30,40,25,0,67772880,3655,43759860,2352,21775
1708,33,39,25,0,67813200,3656,43811700,2353,21808
1709,32,39,25,0,67903260,3656,43873320,2354,21840
1710,22,40,25,0,67952280,3656,43882560,2353,21862
1711,34,40,25,0,68024040,3657,43944540,2355,21896
1712,34,40,25,0,68088360,3656,43977480,2353,21930
1713,29,40,25,0,68147760,3656,43996320,2352,21959
1714,23,40,25,0,68193660,3656,44060640,2354,21982
1715,31,39,25,0,68271360,3657,44086320,2354,22013
1716,25,37,25,0,68334360,3656,44186460,2356,22038
1717,27,40,25,0,68383320,3656,44196120,2355,22065
1718,35,40,25,0,68444040,3657,44208660,2354,22100
1719,27,36,25,0,68515740,3655,44786460,2382,22127
1720,28,40,25,0,68551020,3656,44790540,2380,22155
1721,33,40,25,0,68614920,3657,44825820,2381,22188
1722,30,40,25,0,68673960,3657,44892000,2382,22218
1723,32,40,25,0,68737800,3658,44897760,2381,22250
1724,36,38,25,0,68817780,3658,44966580,2382,22286
1725,34,37,25,0,68889540,3658,45065760,2385,22320
1726,30,40,25,0,68938560,3656,45132840,2386,22350
1727,30,36,25,0,69006060,3656,45249360,2390,22380
1728,30,40,25,0,69062220,3656,45260460,2388,22410
1729,31,40,25,0,69128220,3656,45463020,2396,22441
1730,36,38,25,0,69174240,3656,45475200,2395,22477
1731,32,40,25,0,69255180,3655,45539580,2395,22509
1732,31,40,25,0,69303840,3655,45575040,2396,22540
1733,25,40,25,0,69361020,3655,45654960,2398,22565
1734,30,40,25,0,69420780,3654,45730560,2399,22595
1735,31,37,25,0,69486060,3654,45758760,2399,22626
1736,26,39,25,0,69551220,3655,45851160,2401,22652
1737,26,39,25,0,69609720,3655,45862200,2400,22678
1738,34,40,25,0,69643440,3656,45878100,2400,22712
1739,36,40,25,0,69726120,3658,45906900,2400,22748
1740,32,38,25,0,69786000,3658,45955560,2401,22780
1741,21,37,25,0,69864180,3658,46023480,2402,22801
1742,32,40,25,0,69918060,3659,46029180,2400,22833
1743,30,40,25,0,69953580,3659,46042920,2400,22863
1744,30,39,25,0,70038300,3659,46228920,2407,22893
1745,35,40,25,0,70105500,3659,46235880,2405,22928
1746,28,40,25,0,70147860,3659,46252800,2404,22956
1747,25,27,25,0,70243860,3657,47812200,2483,22981
1748,32,40,25,0,70269780,3657,47818380,2480,23013
1749,35,40,25,0,70328160,3658,47842320,2480,23048
1750,34,40,25,0,70404480,3659,47854500,2478,23082
1751,24,39,25,0,70469340,3659,47947020,2481,23106
1752,33,37,25,0,70547100,3659,47987100,2481,23139
1753,33,40,25,0,70600500,3658,48025860,2480,23172
1754,34,40,25,0,70647000,3657,48052620,2479,23206
1755,31,40,25,0,70703760,3657,48097140,2479,23237
1756,33,39,25,0,70769640,3657,48137880,2480,23270
1757,35,39,25,0,70845120,3657,48252240,2482,23305
1758,43,40,25,0,70883340,3656,48257580,2480,23348
1759,33,40,25,0,70961400,3656,48330120,2481,23381
1760,39,40,25,0,71026560,3654,48356760,2480,23420
1761,26,38,25,0,71078220,3655,48403500,2481,23446
1762,30,39,25,0,71159340,3655,48467520,2482,23476
1763,26,40,25,0,71208900,3654,48489660,2480,23502
1764,29,40,25,0,71253900,3654,48499500,2479,23531
1765,40,40,25,0,71332320,3655,48515520,2477,23571
1766,37,40,25,0,71365980,3654,48553740,2478,23608
1767,30,35,25,0,71472420,3654,48733980,2484,23638
1768,21,38,25,0,71508000,3653,48811920,2485,23659
1769,33,39,25,0,71567820,3653,48843600,2485,23692
1770,32,38,25,0,71655120,3653,49390500,2510,23724
1771,29,39,25,0,71685720,3653,49398000,2509,23753
1772,41,40,25,0,71765160,3653,49441440,2508,23794
1773,32,39,25,0,71815740,3652,49460700,2507,23826
1774,29,38,25,0,71855580,3652,49502280,2508,23855
1775,34,40,25,0,71934900,3653,49533000,2507,23889
1776,25,34,25,0,72011640,3653,49744800,2516,23914
1777,33,40,25,0,72051300,3652,49748640,2513,23947
1778,35,40,25,0,72120540,3653,49777560,2513,23982
1779,24,39,25,0,72176400,3653,49822920,2513,24006
1780,34,40,25,0,72254880,3653,49846140,2512,24040
1781,39,38,25,0,72316140,3651,49992000,2516,24079
1782,25,40,25,0,72370080,3651,50064300,2518,24104
1783,29,40,25,0,72414240,3651,50082180,2517,24133
1784,30,38,25,0,72490680,3652,50127720,2517,24163
1785,29,40,25,0,72550920,3652,50139420,2516,24192
1786,33,40,25,0,72608820,3652,50212440,2517,24225
1787,26,38,25,0,72682140,3651,50278440,2518,24251
1788,28,40,25,0,72735600,3651,50319300,2517,24279
1789,36,40,25,0,72799920,3650,50347440,2516,24315
1790,32,40,25,0,72854880,3649,50360760,2514,24347
1791,21,38,25,0,72903360,3649,50431320,2516,24368
1792,43,40,25,0,72970800,3650,50439780,2515,24411
1793,20,38,25,0,73029060,3650,50463840,2514,24431
1794,33,39,25,0,73086780,3650,50475900,2513,24464
1795,32,40,25,0,73165440,3651,50537580,2514,24496
1796,21,33,25,0,73224960,3650,50994720,2534,24517
1797,24,38,25,0,73269060,3650,51002340,2533,24541
1798,38,37,25,0,73354620,3651,51143520,2538,24579
1799,29,37,25,0,73414140,3650,51206340,2538,24608
1800,37,38,25,0,73476360,3650,51227580,2537,24645
1801,28,37,25,0,73524180,3649,51280380,2537,24673
1802,26,37,25,0,73597680,3649,51310140,2536,24699
1803,33,40,25,0,73649820,3649,51415980,2539,24732
1804,31,39,25,0,73710420,3650,51456300,2540,24763
1805,28,38,25,0,73776660,3650,51476220,2539,24791
1806,24,37,25,0,73839060,3648,52306920,2577,24815
1807,36,38,25,0,73883580,3649,52318680,2576,24851
1808,27,39,25,0,73963680,3650,52344660,2575,24878
1809,34,39,25,0,74013060,3649,52368000,2574,24912
1810,33,39,25,0,74094840,3649,52380660,2572,24945
1811,32,38,25,0,74143080,3649,52404480,2571,24977
1812,34,40,25,0,74193660,3649,52494540,2573,25011
1813,36,40,25,0,74258100,3649,52571100,2575,25047
1814,37,39,25,0,74333520,3649,52603200,2574,25084
1815,26,40,25,0,74372760,3648,52667340,2576,25110
1816,27,40,25,0,74433660,3649,52677600,2575,25137
1817,32,40,25,0,74508960,3650,52763940,2577,25169
1818,30,40,25,0,74567280,3650,52784940,2576,25199
1819,36,40,25,0,74642760,3650,52824120,2575,25235
1820,32,40,25,0,74687640,3649,52867500,2575,25267
1821,20,40,25,0,74748240,3649,52928400,2576,25287
1822,19,32,25,0,74819820,3648,53241840,2589,25306
1823,26,40,25,0,74880780,3648,53245020,2586,25332
1824,29,38,25,0,74918760,3649,53261580,2586,25361
1825,33,40,25,0,75006780,3649,53282520,2584,25394
1826,35,40,25,0,75054420,3648,53457660,2590,25429
1827,30,37,25,0,75121200,3648,53491800,2590,25459
1828,34,40,25,0,75192420,3649,53506800,2588,25493
1829,20,39,25,0,75220620,3647,53592180,2591,25513
1830,34,40,25,0,75296880,3648,53598840,2589,25547
1831,23,36,25,0,75361440,3649,53732100,2594,25570
1832,25,40,25,0,75425100,3649,53836920,2596,25595
1833,37,40,25,0,75478380,3649,53854200,2595,25632
1834,29,40,25,0,75531060,3649,53896200,2596,25661
1835,30,40,25,0,75610980,3649,53920740,2594,25691
1836,28,38,25,0,75680820,3649,53999760,2595,25719
1837,36,39,25,0,75733380,3648,54008940,2594,25755
1838,31,40,25,0,75783960,3648,54015240,2592,25786
1839,41,40,25,0,75861240,3649,54075420,2593,25827
1840,21,34,25,0,75909840,3648,54297540,2602,25848
1841,38,40,25,0,75957840,3648,54352380,2602,25886
1842,27,39,25,0,76033260,3649,54367260,2601,25913
1843,34,39,25,0,76110060,3650,54461460,2604,25947
1844,40,40,25,0,76151100,3649,54494820,2603,25987
1845,30,39,25,0,76226160,3649,54511440,2602,26017
1846,25,40,25,0,76285920,3649,54636120,2605,26042
1847,19,40,25,0,76334100,3649,54646260,2604,26061
1848,25,37,25,0,76409940,3650,54733800,2607,26086
1849,5,11,25,0,76480500,3648,62670000,2984,26091
1850,4,0,15,10,76522140,3645,65589420,3122,26095
1851,6,0,15,10,76559820,3646,65589420,3121,26101
1852,3,0,13,12,76581600,3646,65589420,3121,26104
1853,4,0,13,12,76607940,3647,65589420,3120,26108
1854,5,0,12,13,76629000,3647,65589420,3120,26113
1855,4,0,14,11,76637940,3647,65589420,3119,26117
1856,9,0,14,11,76666020,3647,65589420,3118,26126
1857,8,0,13,12,76695840,3647,65589420,3117,26134
1858,8,0,16,9,76706040,3646,65589420,3115,26142
1859,5,0,12,13,76734900,3646,65589420,3115,26147
1860,6,0,12,13,76761240,3646,65589420,3114,26153
1861,10,0,17,8,76775640,3646,65589420,3112,26163
1862,9,0,14,11,76808160,3646,65589420,3111,26172
1863,9,0,17,8,76826100,3645,65589420,3110,26181
1864,12,0,18,7,76859220,3645,65589420,3108,26193
1865,10,0,18,7,76890000,3645,65589420,3106,26203
1866,7,0,14,11,76926420,3645,65589420,3105,26210
1867,9,0,16,9,76949520,3644,65589420,3104,26219
1868,9,0,17,8,76981200,3645,65589420,3103,26228
1869,8,0,13,12,77011620,3644,65589420,3102,26236
1870,6,0,16,9,77021580,3644,65589420,3101,26242
1871,10,0,20,5,77039160,3644,65589420,3099,26252
1872,8,0,17,8,77079180,3644,65589420,3098,26260
1873,2,0,12,13,77115480,3644,65589420,3098,26262
1874,5,0,12,13,77134440,3644,65589420,3097,26267
1875,5,0,14,11,77142840,3644,65589420,3096,26272
1876,10,0,16,9,77168160,3644,65589420,3095,26282
1877,7,0,13,12,77193660,3643,65589420,3094,26289
1878,10,0,17,8,77206080,3643,65589420,3092,26299
1879,8,0,16,9,77232060,3643,65589420,3091,26307
1880,8,0,14,11,77284200,3643,65589420,3090,26315
1881,10,0,18,7,77300640,3643,65589420,3089,26325
1882,5,0,16,9,77310000,3642,65589420,3088,26330
1883,14,0,19,6,77361240,3643,65589420,3086,26344
1884,12,0,22,3,77393040,3643,65589420,3084,26356
1885,12,2,25,0,77417220,3643,65590980,3082,26368
1886,9,0,20,5,77491980,3644,65594520,3081,26377
1887,11,0,20,5,77543280,3644,65594520,3080,26388
1888,9,0,19,6,77580120,3644,65594520,3078,26397
1889,9,0,16,9,77636520,3645,65594520,3077,26406
1890,10,0,20,5,77662980,3645,65594520,3076,26416
1891,7,0,16,9,77699520,3645,65594520,3075,26423
1892,4,0,13,12,77728680,3645,65594520,3074,26427
1893,7,0,13,12,77746020,3645,65594520,3073,26434
1894,7,0,15,10,77757420,3644,65594520,3072,26441
1895,5,0,14,11,77783460,3644,65594520,3071,26446
1896,8,0,14,11,77811540,3644,65594520,3070,26454
1897,5,0,14,11,77832000,3645,65594520,3069,26459
1898,2,0,13,12,77841180,3644,65594520,3069,26461
1899,4,0,12,13,77859660,3644,65594520,3069,26465
1900,5,0,12,13,77885040,3645,65594520,3068,26470
1901,2,0,9,16,77900640,3645,65594520,3068,26472
1902,6,0,12,13,77908560,3645,65594520,3067,26478
1903,11,0,16,9,77923980,3644,65594520,3065,26489
1904,12,0,20,5,77954820,3644,65594520,3063,26501
1905,13,0,17,8,77996760,3643,65594520,3062,26514
1906,10,0,19,6,78017280,3643,65594520,3060,26524
1907,13,0,19,6,78059340,3643,65594520,3058,26537
1908,9,0,17,8,78103740,3643,65594520,3057,26546
1909,10,0,20,5,78125700,3643,65594520,3056,26556
1910,6,0,16,9,78176820,3643,65594520,3055,26562
1911,9,0,15,10,78206400,3643,65594520,3053,26571
1912,8,0,18,7,78237420,3644,65594520,3052,26579
1913,12,0,22,3,78268140,3644,65594520,3051,26591
1914,5,0,13,12,78318540,3644,65594520,3050,26596
1915,3,0,11,14,78335220,3644,65594520,3049,26599
1916,4,0,12,13,78346200,3644,65594520,3049,26603
1917,6,0,16,9,78351600,3644,65594520,3048,26609
1918,9,0,20,5,78371820,3644,65594520,3047,26618
1919,4,0,14,11,78419220,3644,65594520,3046,26622
1920,10,0,17,8,78443400,3644,65594520,3045,26632
1921,10,0,19,6,78467100,3644,65594520,3043,26642
1922,4,0,13,12,78504840,3644,65594520,3043,26646
1923,7,0,13,12,78525180,3644,65594520,3042,26653
1924,4,0,13,12,78543840,3644,65594520,3041,26657
1925,4,0,14,11,78551760,3644,65594520,3041,26661
1926,7,0,14,11,78576360,3644,65594520,3040,26668
1927,15,0,19,6,78605100,3643,65594520,3038,26683
1928,8,0,20,5,78635340,3644,65594520,3036,26691
1929,11,0,16,9,78688320,3643,65594520,3035,26702
1930,13,0,23,2,78702360,3643,65594520,3033,26715
1931,13,0,20,5,78759240,3643,65594520,3031,26728
1932,6,0,17,8,78789600,3643,65594520,3030,26734
1933,12,0,16,9,78833700,3643,65594520,3029,26746
1934,15,0,24,1,78854820,3643,65597040,3027,26761
1935,10,0,20,5,78913980,3643,65597040,3025,26771
1936,5,0,15,10,78955260,3643,65597040,3025,26776
1937,8,0,16,9,78995160,3644,65597040,3024,26784
1938,9,0,19,6,79011300,3644,65597040,3022,26793
1939,9,0,18,7,79050180,3644,65597040,3021,26802
1940,7,0,16,9,79094940,3644,65597040,3020,26809
1941,4,0,13,12,79121880,3644,65597040,3019,26813
1942,7,0,11,14,79148580,3644,65597040,3019,26820
1943,11,0,19,6,79156440,3644,65597040,3017,26831
1944,7,0,21,4,79167240,3644,65597040,3016,26838
1945,5,0,12,13,79227420,3644,65597040,3015,26843
1946,4,0,10,15,79243020,3644,65597040,3015,26847
1947,1,0,8,17,79255080,3644,65597040,3015,26848
1948,4,0,10,15,79257000,3644,65597040,3014,26852
1949,4,0,12,13,79263360,3643,65597040,3014,26856
1950,8,0,12,13,79283100,3643,65597040,3012,26864
1951,8,0,12,13,79303980,3643,65597040,3011,26872
1952,11,0,14,11,79318740,3642,65597040,3010,26883
1953,8,0,17,8,79331820,3642,65597040,3009,26891
1954,11,0,22,3,79355880,3642,65597040,3007,26902
1955,5,0,15,10,79413420,3642,65597040,3006,26907
1956,11,0,18,7,79442100,3642,65597040,3005,26918
1957,12,0,16,9,79478880,3642,65597040,3003,26930
1958,6,0,14,11,79497120,3641,65597040,3002,26936
1959,6,0,14,11,79526580,3641,65597040,3002,26942
1960,12,0,18,7,79543380,3641,65597040,3000,26954
1961,11,0,21,4,79578240,3641,65597040,2998,26965
1962,14,2,25,0,79597560,3641,65597580,2997,26979
1963,5,0,17,8,79670940,3642,65597820,2996,26984
1964,4,0,11,14,79718040,3642,65597820,2995,26988
1965,7,0,13,12,79733700,3642,65597820,2994,26995
1966,7,0,14,11,79760820,3642,65597820,2993,27002
1967,3,0,12,13,79778580,3642,65597820,2993,27005
1968,7,0,13,12,79795080,3642,65597820,2992,27012
1969,7,0,16,9,79809180,3642,65597820,2991,27019
1970,3,0,10,15,79834920,3642,65597820,2991,27022
1971,7,0,17,8,79834920,3642,65597820,2990,27029
1972,9,0,18,7,79859760,3641,65597820,2989,27038
1973,6,0,12,13,79905780,3642,65597820,2988,27044
1974,6,0,11,14,79934280,3642,65597820,2987,27050
1975,5,0,13,12,79947360,3642,65597820,2986,27055
1976,4,0,11,14,79961940,3641,65597820,2986,27059
1977,11,0,16,9,79975200,3641,65597820,2984,27070
1978,4,0,13,12,79997040,3641,65597820,2984,27074
1979,14,0,19,6,80016180,3640,65597820,2982,27088
1980,10,0,18,7,80051520,3640,65597820,2980,27098
1981,19,2,25,0,80096400,3641,65599380,2978,27117
1982,7,0,21,4,80151720,3641,65602080,2977,27124
1983,8,0,16,9,80203020,3641,65602080,2976,27132
1984,7,0,14,11,80240100,3641,65602080,2975,27139
1985,10,0,18,7,80255640,3641,65602080,2974,27149
1986,5,0,16,9,80292720,3642,65602080,2973,27154
1987,15,0,21,4,80320140,3641,65602080,2971,27169
1988,11,0,18,7,80376780,3641,65602080,2970,27180
1989,1,0,11,14,80405100,3641,65602080,2969,27181
1990,4,0,12,13,80418360,3641,65602080,2969,27185
1991,8,0,17,8,80430600,3642,65602080,2968,27193
1992,3,0,14,11,80454840,3642,65602080,2967,27196
1993,3,0,11,14,80484600,3642,65602080,2967,27199
1994,4,0,15,10,80484600,3642,65602080,2966,27203
1995,8,0,17,8,80506440,3642,65602080,2965,27211
1996,7,0,17,8,80537580,3642,65602080,2964,27218
1997,6,0,15,10,80576700,3643,65602080,2964,27224
1998,9,0,16,9,80596020,3642,65602080,2962,27233
1999,10,0,18,7,80640240,3643,65602080,2961,27243
2000,6,0,16,9,80670240,3643,65602080,2960,27249
2001,8,0,14,11,80708100,3643,65602080,2959,27257
2002,8,0,17,8,80718600,3643,65602080,2958,27265
2003,10,0,20,5,80750460,3643,65602080,2957,27275
2004,5,0,16,9,80784840,3643,65602080,2956,27280
2005,13,0,19,6,80825640,3643,65602080,2954,27293
2006,9,0,18,7,80850960,3643,65602080,2953,27302
2007,12,0,21,4,80880900,3643,65602080,2952,27314
2008,3,0,14,11,80929800,3643,65602080,2951,27317
2009,14,0,20,5,80968800,3644,65602080,2949,27331
2010,9,0,19,6,80992740,3643,65602080,2948,27340
2011,3,0,13,12,81040020,3644,65602080,2948,27343
2012,4,0,12,13,81071460,3644,65602080,2947,27347
2013,8,0,13,12,81087720,3644,65602080,2946,27355
2014,8,0,19,6,81093720,3644,65602080,2945,27363
2015,8,0,16,9,81135780,3644,65602080,2944,27371
2016,5,0,13,12,81157500,3644,65602080,2943,27376
2017,3,0,16,9,81157500,3644,65602080,2943,27379
2018,7,0,19,6,81163980,3643,65602080,2942,27386
2019,4,0,18,7,81176580,3643,65602080,2942,27390
2020,3,0,15,10,81201720,3643,65602080,2941,27393
2021,7,0,18,7,81211740,3643,65602080,2940,27400
2022,4,0,18,7,81228720,3643,65602080,2940,27404
2023,7,0,19,6,81251700,3643,65602080,2939,27411
2024,7,0,21,4,81264360,3643,65602080,2938,27418
2025,12,0,22,3,81310200,3643,65602080,2936,27430
2026,4,0,19,6,81338280,3643,65602080,2936,27434
2027,10,0,23,2,81361140,3643,65602740,2934,27444
2028,15,4,25,0,81397020,3643,65603100,2933,27459
2029,12,0,25,0,81449700,3643,65611560,2931,27471
2030,10,0,24,1,81491520,3643,65611620,2930,27481
2031,16,2,25,0,81533760,3643,65611620,2928,27497
2032,4,0,21,4,81564720,3643,65612460,2927,27501
2033,9,0,22,3,81610620,3643,65612460,2926,27510
2034,6,0,21,4,81636540,3644,65612460,2925,27516
2035,13,2,25,0,81668820,3644,65615460,2924,27529
2036,6,0,14,11,81744960,3644,65615820,2923,27535
2037,4,0,15,10,81751800,3644,65615820,2923,27539
2038,4,0,17,8,81766260,3644,65615820,2922,27543
2039,6,0,20,5,81776040,3644,65615820,2921,27549
2040,6,0,16,9,81813240,3644,65615820,2921,27555
2041,4,0,16,9,81830460,3644,65615820,2920,27559
2042,10,0,19,6,81847140,3644,65615820,2919,27569
2043,12,0,21,4,81875280,3644,65616000,2917,27581
2044,6,0,18,7,81917940,3644,65616000,2916,27587
2045,5,0,20,5,81934440,3644,65616000,2916,27592
2046,10,0,23,2,81965820,3645,65616000,2914,27602
2047,7,0,21,4,81997080,3644,65616240,2914,27609
2048,6,0,17,8,82040340,3645,65616240,2913,27615
2049,9,0,20,5,82064940,3645,65616240,2912,27624
2050,8,0,21,4,82090440,3645,65616240,2911,27632
2051,14,0,23,2,82129740,3645,65616240,2909,27646
2052,6,0,24,1,82149960,3645,65616240,2908,27652
2053,13,0,22,3,82211820,3645,65617500,2906,27665
2054,13,2,25,0,82245660,3645,65620800,2905,27678
2055,11,4,25,0,82293180,3646,65631360,2904,27689
2056,9,0,21,4,82341600,3645,65636460,2903,27698
2057,11,0,23,2,82379880,3646,65636460,2902,27709
2058,12,1,25,0,82416900,3646,65637420,2900,27721
2059,7,0,24,1,82452180,3646,65637480,2899,27728
2060,8,0,17,8,82507080,3646,65637480,2898,27736
2061,5,0,16,9,82525620,3646,65637480,2898,27741
2062,9,0,17,8,82544940,3645,65637480,2896,27750
2063,4,0,17,8,82557060,3645,65637480,2896,27754
2064,2,0,15,10,82575660,3645,65637480,2896,27756
2065,4,0,17,8,82584300,3645,65637480,2895,27760
2066,8,0,17,8,82604520,3645,65637480,2894,27768
2067,3,0,18,7,82617840,3645,65637480,2894,27771
2068,6,0,16,9,82646100,3645,65637480,2893,27777
2069,10,0,21,4,82660860,3645,65637480,2892,27787
2070,11,0,23,2,82690020,3645,65638680,2890,27798
2071,11,0,22,3,82737060,3645,65638800,2889,27809
2072,7,0,19,6,82772280,3645,65638980,2888,27816
2073,8,0,19,6,82810620,3645,65638980,2887,27824
2074,13,0,22,3,82832640,3645,65638980,2885,27837
2075,13,5,25,0,82852560,3645,65641500,2884,27850
2076,12,4,25,0,82899540,3645,65657220,2883,27862
2077,14,3,25,0,82955880,3645,65667900,2882,27876
2078,13,7,25,0,83000640,3645,65672160,2880,27889
2079,10,12,25,0,83026740,3646,65678580,2880,27899
2080,9,11,25,0,83089440,3647,65693220,2879,27908
2081,10,9,25,0,83151360,3648,65736960,2880,27918
2082,7,0,21,4,83197740,3647,65813580,2882,27925
2083,7,0,20,5,83226240,3647,65813580,2881,27932
2084,5,0,19,6,83252820,3647,65813580,2880,27937
2085,9,0,20,5,83286780,3647,65813580,2879,27946
2086,6,0,20,5,83309880,3647,65813580,2878,27952
2087,9,0,22,3,83333340,3647,65813580,2877,27961
2088,7,0,21,4,83360880,3647,65813580,2876,27968
2089,6,0,19,6,83399700,3647,65813580,2876,27974
2090,5,0,17,8,83428800,3647,65813580,2875,27979
2091,5,0,16,9,83452080,3648,65813580,2874,27984
2092,3,0,19,6,83452080,3648,65813580,2874,27987
2093,12,0,24,1,83484000,3648,65814660,2873,27999
2094,5,0,24,1,83496420,3648,65816040,2872,28004
2095,11,0,21,4,83557260,3648,65816040,2871,28015
2096,14,0,25,0,83605080,3648,65816040,2869,28029
2097,11,0,25,0,83648340,3649,65816700,2868,28040
2098,11,3,25,0,83671680,3648,65817420,2866,28051
2099,9,0,24,1,83726040,3649,65820060,2865,28060
2100,8,0,22,3,83775480,3649,65820060,2864,28068
2101,14,1,25,0,83807820,3649,65820060,2863,28082
2102,9,0,23,2,83851980,3649,65820840,2861,28091
2103,14,3,25,0,83880540,3649,65821860,2860,28105
2104,8,0,20,5,83932020,3649,65824620,2859,28113
2105,10,0,22,3,83954340,3648,65824620,2858,28123
2106,4,0,19,6,83986380,3649,65824620,2857,28127
2107,6,0,18,7,84027840,3649,65824620,2856,28133
2108,8,0,18,7,84054660,3649,65824620,2855,28141
2109,6,0,19,6,84071580,3649,65824620,2855,28147
2110,2,0,16,9,84093780,3649,65824620,2854,28149
2111,7,0,22,3,84099660,3649,65824620,2853,28156
2112,5,0,19,6,84130680,3649,65824620,2853,28161
2113,8,0,19,6,84160440,3649,65824620,2852,28169
2114,7,0,22,3,84167160,3649,65824620,2851,28176
2115,5,0,18,7,84208860,3649,65824620,2850,28181
2116,9,0,20,5,84233040,3649,65824620,2849,28190
2117,8,0,23,2,84252180,3649,65824620,2848,28198
2118,4,0,17,8,84289380,3649,65824620,2848,28202
2119,4,0,16,9,84308460,3650,65824620,2847,28206
2120,9,0,22,3,84324660,3650,65824620,2846,28215
2121,14,1,25,0,84354180,3649,65826840,2845,28229
2122,9,1,25,0,84386700,3649,65827920,2844,28238
2123,6,0,19,6,84435900,3650,65829180,2843,28244
2124,14,0,22,3,84485400,3650,65829180,2841,28258
2125,7,0,20,5,84514380,3650,65829180,2840,28265
2126,14,0,24,1,84540120,3649,65829180,2839,28279
2127,14,5,25,0,84572280,3649,65833500,2837,28293
2128,8,0,25,0,84621660,3650,65847900,2837,28301
2129,10,2,25,0,84662880,3650,65851860,2836,28311
2130,7,0,19,6,84716700,3650,65853780,2835,28318
2131,8,0,20,5,84745140,3650,65853780,2834,28326
2132,6,0,20,5,84766920,3650,65853780,2833,28332
2133,4,0,18,7,84799740,3651,65853780,2833,28336
2134,2,0,16,9,84817800,3651,65853780,2832,28338
2135,2,0,14,11,84838200,3651,65853780,2832,28340
2136,6,0,17,8,84842220,3651,65853780,2831,28346
2137,3,0,16,9,84855480,3651,65853780,2831,28349
2138,3,0,15,10,84866880,3650,65853780,2831,28352
2139,5,0,15,10,84885060,3650,65853780,2830,28357
2140,6,0,18,7,84891780,3650,65853780,2829,28363
2141,3,0,15,10,84907440,3650,65853780,2829,28366
2142,9,0,19,6,84923940,3650,65853780,2828,28375
2143,6,0,21,4,84934920,3650,65853780,2827,28381
2144,5,0,18,7,84965820,3650,65853780,2827,28386
2145,7,0,20,5,84986100,3650,65853780,2826,28393
2146,12,0,23,2,85013160,3650,65853960,2824,28405
2147,10,0,20,5,85056300,3650,65853960,2823,28415
2148,10,0,21,4,85088160,3649,65853960,2822,28425
2149,9,0,20,5,85123380,3649,65853960,2821,28434
2150,15,0,22,3,85161780,3649,65853960,2819,28449
2151,13,0,24,1,85190820,3649,65853960,2817,28462
2152,8,0,24,1,85215120,3648,65853960,2816,28470
2153,7,0,18,7,85275180,3649,65853960,2816,28477
2154,14,0,23,2,85303320,3649,65853960,2814,28491
2155,7,0,18,7,85330860,3648,65853960,2813,28498
2156,3,0,16,9,85356060,3648,65853960,2813,28501
2157,3,0,14,11,85372560,3648,65853960,2812,28504
2158,8,0,19,6,85380720,3648,65853960,2811,28512
2159,8,0,23,2,85391760,3648,65853960,2810,28520
2160,6,0,19,6,85433820,3648,65853960,2810,28526
2161,5,0,21,4,85443960,3648,65853960,2809,28531
2162,8,0,20,5,85487520,3649,65853960,2808,28539
2163,7,0,20,5,85509420,3648,65853960,2807,28546
2164,7,0,21,4,85535040,3649,65853960,2806,28553
2165,6,0,21,4,85554540,3649,65853960,2806,28559
2166,6,0,19,6,85593540,3649,65853960,2805,28565
2167,9,0,21,4,85625160,3649,65853960,2804,28574
2168,8,0,20,5,85650120,3649,65853960,2803,28582
2169,7,0,19,6,85681620,3649,65853960,2802,28589
2170,12,0,19,6,85710360,3648,65853960,2801,28601
2171,9,0,18,7,85740420,3648,65853960,2800,28610
2172,11,0,23,2,85755300,3648,65853960,2798,28621
2173,8,0,21,4,85795920,3648,65853960,2797,28629
2174,7,0,23,2,85823700,3648,65853960,2797,28636
2175,6,0,16,9,85875540,3648,65853960,2796,28642
2176,12,0,24,1,85890600,3649,65853960,2794,28654
2177,14,1,25,0,85931820,3648,65855160,2793,28668
2178,9,0,20,5,85976640,3648,65858760,2792,28677
2179,7,0,19,6,86017620,3648,65858760,2791,28684
2180,9,0,20,5,86041140,3648,65858760,2790,28693
2181,7,0,17,8,86070060,3648,65858760,2789,28700
2182,9,0,22,3,86084580,3648,65858760,2788,28709
2183,7,0,23,2,86116860,3648,65858760,2787,28716
2184,3,0,18,7,86155440,3649,65858760,2787,28719
2185,6,0,14,11,86185980,3649,65858760,2786,28725
2186,3,0,13,12,86193960,3648,65858760,2786,28728
2187,5,0,14,11,86201340,3648,65858760,2785,28733
2188,8,0,16,9,86215500,3648,65858760,2784,28741
2189,5,0,18,7,86218620,3647,65858760,2784,28746
2190,2,0,15,10,86239440,3647,65858760,2784,28748
2191,8,0,19,6,86249340,3647,65858760,2783,28756
2192,5,0,19,6,86272800,3647,65858760,2782,28761
2193,13,0,20,5,86306580,3647,65858760,2780,28774
2194,9,0,20,5,86340420,3647,65858760,2779,28783
2195,10,0,23,2,86365080,3647,65858760,2778,28793
2196,12,1,25,0,86400240,3647,65860140,2777,28805
2197,6,0,19,6,86460900,3648,65862060,2776,28811
2198,6,0,20,5,86479800,3648,65862060,2776,28817
2199,9,0,18,7,86524800,3648,65862060,2775,28826
2200,7,0,18,7,86549520,3648,65862060,2774,28833
2201,6,0,19,6,86566860,3648,65862060,2773,28839
2202,5,0,18,7,86595480,3648,65862060,2772,28844
2203,5,0,16,9,86623980,3648,65862060,2772,28849
2204,10,0,19,6,86647380,3648,65862060,2771,28859
2205,4,0,18,7,86659320,3648,65862060,2770,28863
2206,12,0,20,5,86688960,3648,65862060,2769,28875
2207,5,0,16,9,86712960,3647,65862060,2768,28880
2208,5,0,19,6,86724480,3647,65862060,2768,28885
2209,5,0,18,7,86761560,3648,65862060,2767,28890
2210,9,0,21,4,86780220,3648,65862060,2766,28899
2211,7,0,19,6,86816100,3648,65862060,2765,28906
2212,9,0,24,1,86821560,3648,65862060,2764,28915
2213,10,0,19,6,86876820,3648,65862060,2763,28925
2214,7,0,19,6,86904420,3648,65862060,2762,28932
2215,11,0,22,3,86918460,3647,65862060,2761,28943
2216,11,0,24,1,86944560,3647,65862060,2760,28954
2217,12,1,25,0,86990760,3647,65862840,2758,28966
2218,12,0,25,0,87031020,3647,65862840,2757,28978
2219,9,0,20,5,87074280,3647,65862900,2756,28987
2220,11,0,25,0,87100380,3647,65863080,2755,28998
2221,17,7,25,0,87150540,3647,65867640,2753,29015
2222,11,8,25,0,87197040,3648,65875020,2752,29026
2223,8,5,25,0,87239640,3648,65907900,2753,29034
2224,10,0,22,3,87296280,3647,65927520,2752,29044
2225,7,0,20,5,87320520,3647,65927520,2751,29051
2226,16,1,25,0,87365160,3647,65928600,2749,29067
2227,9,4,25,0,87384180,3647,65931900,2749,29076
2228,10,3,25,0,87446040,3648,65940120,2748,29086
2229,10,0,23,2,87504840,3648,65943960,2747,29096
2230,5,0,18,7,87540120,3648,65943960,2746,29101
2231,2,0,12,13,87576060,3649,65943960,2746,29103
2232,7,0,17,8,87577500,3648,65943960,2745,29110
2233,5,0,17,8,87588060,3648,65943960,2745,29115
2234,7,0,19,6,87609300,3648,65943960,2744,29122
2235,8,0,19,6,87629760,3648,65943960,2743,29130
2236,9,0,23,2,87644940,3648,65943960,2742,29139
2237,7,0,21,4,87685920,3648,65943960,2741,29146
2238,6,0,20,5,87712500,3648,65943960,2740,29152
2239,8,0,20,5,87739560,3648,65943960,2739,29160
2240,7,0,22,3,87756360,3648,65943960,2739,29167
2241,3,0,16,9,87814860,3649,65943960,2738,29170
2242,12,0,25,0,87823560,3649,65943960,2737,29182
2243,7,0,22,3,87855120,3649,65943960,2736,29189
2244,11,0,21,4,87901140,3649,65943960,2735,29200
2245,8,0,21,4,87922380,3648,65943960,2734,29208
2246,10,0,22,3,87963540,3649,65943960,2733,29218
2247,11,1,25,0,87991800,3649,65944260,2732,29229
2248,7,0,20,5,88025280,3648,65944320,2731,29236
2249,11,0,23,2,88057920,3649,65944320,2730,29247
2250,9,0,22,3,88099560,3649,65944320,2729,29256
2251,14,0,19,6,88147860,3648,65945580,2727,29270
2252,10,0,25,0,88158600,3648,65945580,2726,29280
2253,7,1,25,0,88206300,3649,65950260,2725,29287
2254,1,0,17,8,88258980,3650,65950740,2725,29288
2255,2,0,14,11,88287180,3650,65950740,2725,29290
2256,7,0,16,9,88293120,3650,65950740,2724,29297
2257,7,0,19,6,88299240,3649,65950740,2723,29304
2258,7,0,21,4,88317660,3649,65950740,2723,29311
2259,5,0,19,6,88345080,3649,65950740,2722,29316
2260,3,0,16,9,88373400,3650,65950740,2722,29319
2261,11,0,21,4,88399320,3650,65950740,2720,29330
2262,10,0,20,5,88431600,3649,65950740,2719,29340
2263,3,0,14,11,88469700,3650,65950740,2719,29343
2264,4,0,16,9,88477620,3650,65950740,2719,29347
2265,4,0,15,10,88488900,3649,65950740,2718,29351
2266,14,0,25,0,88495620,3649,65952120,2717,29365
2267,12,0,23,2,88541040,3649,65952480,2715,29377
2268,6,0,17,8,88584240,3649,65952480,2715,29383
2269,11,0,20,5,88613280,3649,65952480,2713,29394
2270,12,1,25,0,88635420,3649,65952480,2712,29406
2271,15,1,25,0,88680000,3648,65952600,2710,29421
2272,8,4,25,0,88699920,3649,65956320,2710,29429
2273,9,4,25,0,88736700,3649,65963760,2709,29438
2274,7,0,22,3,88793880,3649,65990760,2709,29445
2275,9,0,23,2,88836180,3649,65990760,2708,29454
2276,8,0,20,5,88878120,3650,65991300,2707,29462
2277,4,0,16,9,88905900,3649,65991300,2707,29466
2278,6,0,18,7,88925520,3650,65991300,2706,29472
2279,7,0,21,4,88935840,3649,65991300,2706,29479
2280,4,0,16,9,88976340,3650,65991300,2705,29483
2281,8,0,18,7,88992120,3650,65991300,2704,29491
2282,2,0,15,10,89014380,3650,65991300,2704,29493
2283,8,0,17,8,89033880,3650,65991300,2703,29501
2284,8,0,20,5,89045640,3649,65991300,2702,29509
2285,5,0,20,5,89062680,3649,65991300,2702,29514
2286,8,0,20,5,89098020,3650,65991300,2701,29522
2287,6,0,18,7,89124480,3649,65991300,2700,29528
2288,7,0,18,7,89146560,3649,65991300,2699,29535
2289,10,0,21,4,89170200,3649,65991300,2698,29545
2290,8,0,25,0,89194920,3650,65992380,2697,29553
2291,9,0,21,4,89249520,3650,65992620,2696,29562
2292,8,0,18,7,89281620,3650,65992620,2695,29570
2293,15,1,25,0,89302920,3649,65992620,2694,29585
2294,8,0,24,1,89340240,3649,65992980,2693,29593
2295,12,0,25,0,89383260,3650,65999100,2692,29605
2296,17,1,25,0,89430540,3649,66001860,2690,29622
2297,7,0,23,2,89461380,3649,66002580,2689,29629
2298,5,0,17,8,89511420,3649,66002580,2689,29634
2299,5,0,16,9,89538960,3650,66002580,2688,29639
2300,5,0,17,8,89549580,3649,66002580,2688,29644
2301,6,0,19,6,89557800,3649,66002580,2687,29650
2302,9,0,21,4,89590620,3649,66002580,2686,29659
2303,9,0,21,4,89623860,3649,66002580,2685,29668
2304,4,0,18,7,89655480,3650,66002580,2685,29672
2305,9,0,19,6,89683800,3650,66002580,2684,29681
2306,8,0,19,6,89704140,3649,66002580,2683,29689
2307,7,0,20,5,89727300,3649,66002580,2682,29696
2308,3,0,16,9,89757480,3650,66002580,2682,29699
2309,7,0,18,7,89777460,3650,66002580,2681,29706
2310,6,0,19,6,89788860,3649,66002580,2680,29712
2311,12,1,25,0,89800260,3649,66002580,2679,29724
2312,4,0,23,2,89840520,3650,66002880,2679,29728
2313,8,0,16,9,89908320,3650,66002880,2678,29736
2314,6,0,18,7,89920860,3650,66002880,2677,29742
2315,18,2,25,0,89941620,3650,66003060,2675,29760
2316,6,0,20,5,89979600,3649,66003720,2675,29766
2317,16,3,25,0,90018900,3650,66006720,2673,29782
2318,6,0,21,4,90064620,3650,66014400,2673,29788
2319,6,0,21,4,90095460,3650,66014400,2672,29794
2320,10,0,21,4,90129240,3650,66014400,2671,29804
2321,8,0,17,8,90174600,3650,66014400,2670,29812
2322,10,0,22,3,90188220,3650,66014400,2669,29822
2323,12,0,23,2,90212940,3649,66015120,2668,29834
2324,5,0,24,1,90237300,3649,66015120,2667,29839
2325,10,0,22,3,90293640,3650,66015300,2666,29849
2326,6,0,18,7,90331500,3650,66015300,2665,29855
2327,5,0,19,6,90346020,3650,66015300,2665,29860
2328,7,0,20,5,90377460,3650,66015300,2664,29867
2329,5,0,16,9,90418320,3651,66015300,2664,29872
2330,10,0,21,4,90428580,3650,66015300,2662,29882
2331,5,0,17,8,90455820,3650,66015300,2662,29887
2332,8,0,22,3,90469620,3650,66015300,2661,29895
2333,6,0,18,7,90506520,3650,66015300,2660,29901
2334,7,0,21,4,90524640,3650,66015300,2660,29908
2335,15,1,25,0,90556440,3650,66015600,2658,29923
2336,5,0,21,4,90600360,3651,66016800,2658,29928
2337,7,0,20,5,90637380,3651,66016800,2657,29935
2338,12,0,21,4,90679020,3651,66016800,2656,29947
2339,5,0,18,7,90701220,3651,66016800,2655,29952
2340,11,0,23,2,90723540,3651,66016800,2654,29963
2341,15,0,25,0,90764880,3650,66017400,2652,29978
2342,10,0,24,1,90804960,3650,66018540,2651,29988
2343,12,0,20,5,90840720,3649,66019380,2650,30000
2344,8,0,20,5,90890280,3650,66019380,2649,30008
2345,6,0,21,4,90905880,3650,66019380,2649,30014
2346,8,0,19,6,90944940,3650,66019380,2648,30022
2347,8,0,18,7,90970260,3650,66019380,2647,30030
2348,11,0,22,3,90999960,3650,66019380,2646,30041
2349,5,0,18,7,91021920,3650,66019380,2645,30046
2350,7,0,20,5,91033320,3649,66019380,2644,30053
2351,5,0,22,3,91051380,3650,66019380,2644,30058
2352,2,0,16,9,91105200,3651,66019380,2644,30060
2353,10,0,19,6,91134960,3651,66019380,2643,30070
2354,17,3,25,0,91152180,3650,66021120,2641,30087
2355,24,18,25,0,91189560,3651,66024060,2639,30111
2356,20,29,25,0,91244520,3651,66039180,2637,30131
2357,37,40,25,0,91292220,3652,66048600,2635,30168
2358,34,40,25,0,91336440,3652,66073800,2635,30202
2359,31,40,25,0,91377300,3652,66109080,2636,30233
2360,29,40,25,0,91427820,3653,66190740,2638,30262
2361,35,40,25,0,91470480,3653,66226980,2638,30297
2362,29,38,25,0,91526340,3654,66311100,2640,30326
2363,25,39,25,0,91583700,3654,66367740,2641,30351
2364,37,39,25,0,91631040,3653,66433800,2642,30388
2365,28,39,25,0,91659360,3653,66466080,2642,30416
2366,34,40,25,0,91720020,3652,66554940,2643,30450
2367,26,38,25,0,91755480,3652,66601020,2644,30476
2368,31,40,25,0,91806900,3652,66615420,2643,30507
2369,43,40,25,0,91839480,3652,66618540,2643,30550
2370,26,39,25,0,91920000,3652,66728100,2645,30576
2371,30,40,25,0,91944720,3652,66735540,2644,30606
2372,31,40,25,0,92002080,3652,66793200,2645,30637
2373,30,39,25,0,92051640,3652,66832260,2645,30667
2374,34,40,25,0,92079540,3652,66849600,2645,30701
2375,32,40,25,0,92132160,3652,66881100,2644,30733
2376,21,40,25,0,92180400,3652,66963660,2647,30754
2377,39,40,25,0,92221560,3652,66970860,2645,30793
2378,22,35,25,0,92288640,3652,67304160,2657,30815
2379,24,36,25,0,92327820,3651,67349100,2657,30839
2380,28,40,25,0,92367660,3651,67486980,2660,30867
2381,31,39,25,0,92409540,3651,67505460,2660,30898
2382,30,38,25,0,92470380,3651,67539720,2660,30928
2383,40,38,25,0,92528040,3651,67560900,2659,30968
2384,37,39,25,0,92564220,3650,67586040,2658,31005
2385,18,37,25,0,92610120,3650,67887240,2669,31023
2386,26,39,25,0,92646900,3650,67924380,2669,31049
2387,30,40,25,0,92690640,3649,67952820,2669,31079
2388,27,40,25,0,92747340,3650,67983540,2668,31106
2389,43,40,25,0,92786640,3650,68000100,2668,31149
2390,35,39,25,0,92844540,3650,68010900,2667,31184
2391,37,40,25,0,92883840,3650,68015880,2666,31221
2392,31,39,25,0,92920080,3650,68043060,2666,31252
2393,37,40,25,0,92967480,3650,68100180,2667,31289
2394,33,38,25,0,93033180,3650,68161680,2668,31322
2395,41,40,25,0,93063780,3650,68165280,2667,31363
2396,36,40,25,0,93103500,3650,68233260,2669,31399
2397,30,40,25,0,93165060,3651,68297820,2670,31429
2398,28,39,25,0,93208200,3651,68365680,2671,31457
2399,31,37,25,0,93266100,3651,68613660,2679,31488

