Hour,Arrivals,Waiting,Treating,Available Rooms,Total Treatment Time,Average Treatment Time,Total Wait Time,Average Wait Time,Total Arrivals
1,7,0,3,22,3600,900,0,0,7
2,3,0,3,22,10800,1542,0,0,10
3,4,0,4,21,21960,2196,0,0,14
4,7,0,5,20,36600,2287,0,0,21
5,8,0,8,17,49980,2380,0,0,29
6,5,0,5,20,75420,2600,0,0,34
7,14,0,12,13,90720,2520,0,0,48
8,11,0,15,10,116640,2650,0,0,59
9,8,0,11,14,169620,3028,0,0,67
10,6,0,6,19,224400,3349,0,0,73
11,12,0,9,16,248880,3274,0,0,85
12,14,0,9,16,277440,3082,0,0,99
13,13,0,13,12,308760,3118,0,0,112
14,12,0,12,13,349140,3117,0,0,124
15,5,0,5,20,396540,3197,0,0,129
16,17,0,12,13,420960,3141,0,0,146
17,9,0,13,12,441540,3109,0,0,155
18,8,0,14,11,477360,3203,0,0,163
19,7,0,7,18,540540,3316,0,0,170
20,10,0,13,12,555900,3328,0,0,180
21,5,0,11,14,591180,3397,0,0,185
22,5,0,8,17,628080,3450,0,0,190
23,6,0,6,19,671100,3532,0,0,196
24,4,0,3,22,706260,3585,0,0,200
25,2,0,1,24,726060,3612,0,0,202
26,4,0,2,23,730920,3582,0,0,206
27,8,0,6,19,739080,3553,0,0,214
28,9,0,7,18,755940,3499,0,0,223
29,8,0,7,18,786420,3510,0,0,231
30,8,0,9,16,804660,3498,0,0,239
31,8,0,8,17,845520,3537,0,0,247
32,10,0,8,17,873840,3509,0,0,257
33,8,0,9,16,900420,3517,0,0,265
34,16,0,15,10,925740,3480,0,0,281
35,11,0,9,16,984660,3479,0,0,292
36,9,0,10,15,1013880,3484,0,0,301
37,14,0,11,14,1054560,3468,0,0,315
38,15,0,14,11,1092300,3456,0,0,330
39,15,0,16,9,1133040,3443,0,0,345
40,14,0,18,7,1182780,3468,0,0,359
41,9,0,12,13,1242840,3491,0,0,368
42,3,0,5,20,1278480,3493,0,0,371
43,5,0,4,21,1312740,3528,0,0,376
44,8,0,5,20,1332960,3517,0,0,384
45,8,0,7,18,1350660,3508,0,0,392
46,7,0,6,19,1378380,3507,0,0,399
47,6,0,6,19,1406760,3525,0,0,405
48,5,0,5,20,1423920,3515,0,0,410
49,5,0,4,21,1452960,3535,0,0,415
50,7,0,4,21,1464900,3504,0,0,422
51,7,0,7,18,1478580,3503,0,0,429
52,7,0,6,19,1514100,3521,0,0,436
53,6,0,8,17,1525740,3515,0,0,442
54,12,0,10,15,1556400,3505,0,0,454
55,8,0,11,14,1585080,3514,0,0,462
56,13,0,10,15,1636860,3520,0,0,475
57,5,0,6,19,1656240,3494,0,0,480
58,12,0,11,14,1685460,3504,0,0,492
59,9,0,10,15,1715100,3493,0,0,501
60,6,0,8,17,1752000,3511,0,0,507
61,11,0,11,14,1786560,3523,0,0,518
62,11,0,12,13,1816500,3513,0,0,529
63,8,0,12,13,1864800,3552,0,0,537
64,12,0,14,11,1894560,3541,0,0,549
65,9,0,11,14,1950300,3565,0,0,558
66,5,0,7,18,1982760,3566,0,0,563
67,8,0,10,15,2007480,3578,0,0,571
68,2,0,5,20,2040240,3591,0,0,573
69,8,0,7,18,2074860,3614,0,0,581
70,5,0,7,18,2095500,3619,0,0,586
71,7,0,7,18,2122080,3621,0,0,593
72,6,0,7,18,2137020,3609,0,0,599
73,3,0,2,23,2171760,3619,0,0,602
74,3,0,2,23,2181060,3617,0,0,605
75,8,0,8,17,2184480,3610,0,0,613
76,5,0,7,18,2211360,3619,0,0,618
77,4,0,4,21,2239020,3623,0,0,622
78,6,0,5,20,2252520,3615,0,0,628
79,8,0,7,18,2275800,3618,0,0,636
80,4,0,8,17,2286660,3618,0,0,640
81,9,0,7,18,2329140,3627,0,0,649
82,13,0,11,14,2342040,3597,0,0,662
83,5,0,6,19,2384220,3606,0,0,667
84,8,0,5,20,2415120,3604,0,0,675
85,8,0,6,19,2430660,3590,0,0,683
86,15,0,10,15,2457420,3571,0,0,698
87,11,0,12,13,2483580,3563,0,0,709
88,10,0,13,12,2511420,3557,0,0,719
89,7,0,7,18,2564700,3567,0,0,726
90,3,0,4,21,2598120,3583,0,0,729
91,7,0,3,22,2620140,3574,0,0,736
92,4,0,4,21,2628420,3571,0,0,740
93,5,0,3,22,2649120,3570,0,0,745
94,8,0,7,18,2658000,3563,0,0,753
95,4,0,6,19,2675820,3563,0,0,757
96,2,0,1,24,2713020,3579,0,0,759
97,6,0,5,20,2716020,3573,0,0,765
98,7,0,9,16,2724780,3571,0,0,772
99,9,0,7,18,2760420,3566,0,0,781
100,6,0,5,20,2787780,3564,0,0,787
101,5,0,2,23,2819460,3568,0,0,792
102,10,0,7,18,2828520,3557,0,0,802
103,9,0,9,16,2840700,3542,0,0,811
104,8,0,10,15,2868780,3546,0,0,819
105,9,0,10,15,2916000,3564,0,0,828
106,9,0,11,14,2939040,3558,0,0,837
107,10,0,10,15,2998380,3582,0,0,847
108,9,0,6,19,3038940,3575,0,0,856
109,4,0,7,18,3056100,3582,0,0,860
110,15,0,10,15,3096180,3579,0,0,875
111,12,0,13,12,3121140,3571,0,0,887
112,10,0,14,11,3152580,3570,0,0,897
113,8,0,10,15,3211500,3588,0,0,905
114,6,0,8,17,3249540,3598,0,0,911
115,13,0,9,16,3284460,3589,0,0,924
116,6,0,7,18,3317820,3594,0,0,930
117,8,0,12,13,3332580,3598,0,0,938
118,2,0,3,22,3380040,3607,0,0,940
119,5,0,3,22,3402780,3612,0,0,945
120,8,0,8,17,3409020,3607,0,0,953
121,4,0,4,21,3433680,3603,0,0,957
122,5,0,3,22,3447540,3594,0,0,962
123,6,0,4,21,3460740,3589,0,0,968
124,5,0,6,19,3463980,3582,0,0,973
125,9,0,6,19,3488700,3574,0,0,982
126,10,0,8,17,3507060,3564,0,0,992
127,5,0,2,23,3549840,3567,0,0,997
128,5,0,6,19,3550380,3564,0,0,1002
129,6,0,7,18,3571080,3567,0,0,1008
130,11,0,9,16,3593340,3557,0,0,1019
131,10,0,13,12,3611040,3554,0,0,1029
132,9,0,10,15,3657900,3558,0,0,1038
133,14,0,12,13,3703980,3561,0,0,1052
134,18,0,15,10,3743460,3548,0,0,1070
135,9,0,15,10,3789120,3561,0,0,1079
136,15,0,14,11,3854700,3569,0,0,1094
137,9,0,10,15,3908700,3576,0,0,1103
138,7,0,9,16,3941160,3579,0,0,1110
139,4,0,5,20,3980760,3589,0,0,1114
140,11,0,6,19,4009920,3583,0,0,1125
141,3,0,3,22,4028460,3580,0,0,1128
142,7,0,5,20,4041060,3576,0,0,1135
143,5,0,5,20,4050780,3568,0,0,1140
144,7,0,6,19,4068660,3565,0,0,1147
145,7,0,6,19,4101000,3572,0,0,1154
146,7,0,9,16,4111200,3568,0,0,1161
147,1,0,5,20,4129920,3569,0,0,1162
148,8,0,7,18,4170720,3586,0,0,1170
149,5,0,6,19,4186980,3581,0,0,1175
150,8,0,6,19,4223760,3588,0,0,1183
151,12,0,8,17,4250100,3580,0,0,1195
152,6,0,9,16,4264260,3577,0,0,1201
153,13,0,12,13,4300800,3578,0,0,1214
154,10,0,10,15,4344660,3578,0,0,1224
155,8,0,9,16,4387560,3587,0,0,1232
156,10,0,9,16,4425540,3589,0,0,1242
157,15,0,11,14,4458900,3578,0,0,1257
158,11,0,9,16,4499280,3573,0,0,1268
159,13,0,12,13,4524480,3565,0,0,1281
160,17,0,18,7,4554480,3558,0,0,1298
161,8,0,13,12,4607520,3563,0,0,1306
162,16,0,13,12,4678620,3574,0,0,1322
163,8,0,7,18,4720020,3567,0,0,1330
164,8,0,10,15,4743720,3572,0,0,1338
165,6,0,7,18,4774140,3570,0,0,1344
166,6,0,8,17,4808460,3583,0,0,1350
167,3,0,4,21,4838280,3586,0,0,1353
168,4,0,4,21,4854240,3587,0,0,1357
169,7,0,7,18,4870140,3588,0,0,1364
170,4,0,5,20,4888620,3586,0,0,1368
171,5,0,3,22,4911360,3584,0,0,1373
172,8,0,8,17,4923240,3585,0,0,1381
173,6,0,5,20,4958400,3587,0,0,1387
174,7,0,7,18,4976100,3587,0,0,1394
175,11,0,10,15,5001120,3585,0,0,1405
176,10,0,11,14,5036460,3587,0,0,1415
177,6,0,11,14,5061000,3589,0,0,1421
178,7,0,5,20,5111400,3591,0,0,1428
179,8,0,9,16,5134200,3597,0,0,1436
180,11,0,11,14,5156040,3590,0,0,1447
181,8,0,5,20,5197740,3584,0,0,1455
182,12,0,9,16,5229240,3586,0,0,1467
183,9,0,12,13,5253360,3588,0,0,1476
184,7,0,7,18,5296380,3588,0,0,1483
185,13,0,11,14,5326320,3586,0,0,1496
186,9,0,10,15,5349780,3578,0,0,1505
187,9,0,9,16,5394360,3584,0,0,1514
188,4,0,6,19,5418300,3583,0,0,1518
189,10,0,8,17,5452980,3587,0,0,1528
190,3,0,6,19,5468340,3585,0,0,1531
191,4,0,5,20,5492820,3590,0,0,1535
192,9,0,7,18,5508900,3584,0,0,1544
193,3,0,3,22,5531940,3582,0,0,1547
194,4,0,3,22,5549820,3585,0,0,1551
195,8,0,4,21,5569260,3581,0,0,1559
196,6,0,3,22,5591640,3579,0,0,1565
197,7,0,5,20,5605200,3577,0,0,1572
198,5,0,4,21,5624100,3575,0,0,1577
199,8,0,5,20,5648400,3574,0,0,1585
200,10,0,10,15,5660460,3571,0,0,1595
201,8,0,7,18,5693760,3567,0,0,1603
202,5,0,7,18,5716380,3570,0,0,1608
203,13,0,15,10,5736960,3572,0,0,1621
204,8,0,10,15,5797980,3581,0,0,1629
205,7,0,8,17,5829420,3580,0,0,1636
206,9,0,9,16,5854440,3578,0,0,1645
207,12,0,12,13,5888460,3579,0,0,1657
208,7,0,9,16,5916540,3574,0,0,1664
209,6,0,6,19,5964300,3584,0,0,1670
210,11,0,14,11,5978520,3586,0,0,1681
211,3,0,8,17,6016020,3589,0,0,1684
212,5,0,6,19,6049860,3594,0,0,1689
213,8,0,6,19,6078360,3594,0,0,1697
214,6,0,6,19,6094440,3591,0,0,1703
215,2,0,3,22,6115800,3593,0,0,1705
216,6,0,6,19,6125340,3592,0,0,1711
217,3,0,4,21,6135540,3588,0,0,1714
218,3,0,1,24,6156780,3587,0,0,1717
219,2,0,3,22,6156780,3587,0,0,1719
220,2,0,2,23,6167100,3587,0,0,1721
221,5,0,3,22,6173160,3582,0,0,1726
222,5,0,4,21,6186480,3582,0,0,1731
223,9,0,9,16,6198420,3580,0,0,1740
224,11,0,8,17,6219000,3567,0,0,1751
225,13,0,10,15,6239520,3557,0,0,1764
226,8,0,8,17,6287640,3564,0,0,1772
227,8,0,9,16,6314160,3565,0,0,1780
228,6,0,8,17,6345420,3568,0,0,1786
229,10,0,13,12,6360060,3567,0,0,1796
230,15,0,20,5,6392400,3569,0,0,1811
231,11,0,14,11,6466320,3576,0,0,1822
232,9,0,13,12,6508320,3579,0,0,1831
233,14,0,12,13,6563760,3580,0,0,1845
234,1,0,4,21,6621720,3594,0,0,1846
235,7,0,3,22,6643920,3591,0,0,1853
236,9,0,11,14,6644520,3589,0,0,1862
237,9,0,13,12,6673920,3591,0,0,1871
238,9,0,9,16,6721380,3592,0,0,1880
239,5,0,7,18,6760200,3599,0,0,1885
240,4,0,2,23,6784380,3595,0,0,1889
241,7,0,7,18,6789840,3594,0,0,1896
242,4,0,4,21,6806340,3589,0,0,1900
243,3,0,2,23,6830160,3592,0,0,1903
244,5,0,6,19,6831060,3591,0,0,1908
245,6,0,2,23,6853860,3584,0,0,1914
246,6,0,5,20,6870600,3587,0,0,1920
247,9,0,6,19,6882900,3579,0,0,1929
248,7,0,4,21,6906360,3574,0,0,1936
249,6,0,7,18,6914820,3573,0,0,1942
250,4,0,6,19,6929640,3571,0,0,1946
251,13,0,13,12,6952680,3572,0,0,1959
252,9,0,7,18,6992280,3565,0,0,1968
253,14,0,10,15,7024800,3562,0,0,1982
254,7,0,5,20,7058220,3557,0,0,1989
255,11,0,11,14,7068900,3553,0,0,2000
256,17,0,12,13,7135800,3559,0,0,2017
257,4,0,6,19,7163580,3555,0,0,2021
258,6,0,7,18,7190340,3559,0,0,2027
259,7,0,7,18,7218780,3561,0,0,2034
260,8,0,6,19,7241340,3556,0,0,2042
261,4,0,4,21,7256460,3553,0,0,2046
262,6,0,5,20,7280820,3556,0,0,2052
263,5,0,6,19,7291200,3554,0,0,2057
264,7,0,12,13,7297800,3556,0,0,2064
265,5,0,7,18,7336020,3557,0,0,2069
266,6,0,3,22,7367100,3555,0,0,2075
267,2,0,2,23,7382280,3557,0,0,2077
268,4,0,5,20,7385280,3557,0,0,2081
269,3,0,4,21,7396440,3555,0,0,2084
270,10,0,10,15,7409700,3555,0,0,2094
271,6,0,6,19,7451340,3558,0,0,2100
272,8,0,8,17,7459380,3552,0,0,2108
273,9,0,8,17,7492560,3552,0,0,2117
274,4,0,4,21,7533840,3558,0,0,2121
275,13,0,13,12,7542900,3556,0,0,2134
276,8,0,9,16,7585560,3556,0,0,2142
277,7,0,10,15,7599060,3552,0,0,2149
278,9,0,12,13,7625760,3553,0,0,2158
279,13,0,10,15,7690440,3558,0,0,2171
280,12,0,12,13,7725540,3558,0,0,2183
281,8,0,9,16,7770960,3561,0,0,2191
282,7,0,6,19,7808340,3562,0,0,2198
283,9,0,4,21,7855500,3565,0,0,2207
284,7,0,9,16,7858620,3564,0,0,2214
285,6,0,5,20,7896660,3565,0,0,2220
286,6,0,7,18,7911720,3565,0,0,2226
287,7,0,8,17,7942140,3569,0,0,2233
288,6,0,6,19,7964580,3566,0,0,2239
289,8,0,8,17,7987440,3567,0,0,2247
290,8,0,7,18,8016780,3566,0,0,2255
291,5,0,5,20,8042040,3566,0,0,2260
292,5,0,7,18,8057280,3568,0,0,2265
293,5,0,9,16,8070900,3569,0,0,2270
294,2,0,5,20,8102580,3574,0,0,2272
295,16,0,12,13,8133300,3573,0,0,2288
296,10,0,9,16,8165940,3567,0,0,2298
297,12,0,10,15,8196420,3563,0,0,2310
298,11,0,11,14,8236080,3565,0,0,2321
299,9,0,9,16,8264400,3560,0,0,2330
300,9,0,8,17,8307600,3563,0,0,2339
301,17,0,14,11,8338560,3560,0,0,2356
302,12,0,17,8,8364420,3557,0,0,2368
303,16,0,17,8,8413320,3554,0,0,2384
304,11,0,10,15,8494140,3561,0,0,2395
305,15,0,10,15,8538120,3557,0,0,2410
306,8,0,12,13,8560080,3557,0,0,2418
307,11,0,9,16,8610780,3558,0,0,2429
308,12,0,9,16,8644020,3554,0,0,2441
309,9,0,8,17,8677620,3553,0,0,2450
310,4,0,6,19,8706840,3556,0,0,2454
311,7,0,7,18,8727720,3556,0,0,2461
312,9,0,8,17,8761980,3558,0,0,2470
313,6,0,9,16,8770140,3554,0,0,2476
314,3,0,4,21,8816220,3562,0,0,2479
315,4,0,4,21,8829900,3561,0,0,2483
316,6,0,3,22,8850780,3560,0,0,2489
317,6,0,5,20,8861940,3559,0,0,2495
318,7,0,7,18,8876160,3557,0,0,2502
319,5,0,7,18,8884140,3553,0,0,2507
320,6,0,7,18,8916240,3557,0,0,2513
321,9,0,7,18,8944500,3556,0,0,2522
322,5,0,6,19,8981220,3562,0,0,2527
323,8,0,8,17,8995320,3559,0,0,2535
324,9,0,10,15,9016920,3558,0,0,2544
325,12,0,11,14,9060720,3560,0,0,2556
326,7,0,5,20,9097500,3556,0,0,2563
327,13,0,8,17,9128160,3554,0,0,2576
328,5,0,7,18,9146400,3553,0,0,2581
329,8,0,4,21,9192720,3556,0,0,2589
330,9,0,7,18,9202200,3551,0,0,2598
331,10,0,9,16,9230640,3551,0,0,2608
332,6,0,9,16,9251940,3551,0,0,2614
333,8,0,8,17,9288720,3553,0,0,2622
334,2,0,3,22,9321540,3556,0,0,2624
335,4,0,4,21,9337440,3558,0,0,2628
336,8,0,9,16,9349500,3559,0,0,2636
337,7,0,8,17,9388800,3563,0,0,2643
338,14,0,16,9,9405060,3561,0,0,2657
339,13,0,15,10,9441480,3556,0,0,2670
340,19,0,18,7,9502140,3557,0,0,2689
341,33,9,25,0,9560940,3556,3480,1,2722
342,28,16,25,0,9656880,3564,14100,5,2750
343,25,29,25,0,9730500,3576,19800,7,2775
344,31,39,25,0,9829800,3594,36060,12,2806
345,34,40,25,0,9918840,3606,74880,26,2840
346,33,37,25,0,10028820,3615,175140,61,2873
347,34,33,25,0,10123920,3610,291240,101,2907
348,23,23,25,0,10213260,3600,483120,167,2930
349,35,35,25,0,10296540,3600,488820,167,2965
350,33,36,25,0,10379040,3608,512400,174,2998
351,36,40,25,0,10465800,3618,527160,178,3034
352,35,37,25,0,10570740,3622,623820,209,3069
353,37,40,25,0,10640940,3623,708180,235,3106
354,27,36,25,0,10748520,3625,793680,262,3133
355,28,39,25,0,10829820,3624,820440,268,3161
356,25,32,25,0,10938600,3624,978300,318,3186
357,33,36,25,0,11024880,3619,990000,318,3219
358,27,34,25,0,11098020,3616,1119060,358,3246
359,32,38,25,0,11191740,3616,1160220,367,3278
360,34,40,25,0,11274540,3621,1167840,367,3312
361,31,33,25,0,11389320,3617,1329900,414,3343
362,27,39,25,0,11460600,3616,1357020,419,3370
363,38,37,25,0,11549580,3620,1385400,426,3408
364,26,38,25,0,11646600,3623,1418340,433,3434
365,30,31,25,0,11756520,3616,1704240,515,3464
366,35,38,25,0,11815440,3618,1715400,515,3499
367,33,37,25,0,11900040,3626,1750920,523,3532
368,32,33,25,0,12017640,3629,1838700,545,3564
369,36,37,25,0,12101820,3620,2032260,597,3600
370,23,37,25,0,12187440,3621,2083980,608,3623
371,19,24,25,0,12264780,3610,2748720,797,3642
372,28,34,25,0,12353760,3617,2755560,793,3670
373,38,39,25,0,12457560,3626,2774580,792,3708
374,32,37,25,0,12538740,3629,2800740,796,3740
375,34,40,25,0,12640020,3625,2959920,833,3774
376,30,40,25,0,12706560,3626,2977260,834,3804
377,31,40,25,0,12823140,3634,3009360,838,3835
378,32,31,25,0,12922260,3620,3236880,892,3867
379,31,40,25,0,12986940,3618,3248160,889,3898
380,35,39,25,0,13086420,3621,3292620,895,3933
381,34,38,25,0,13168620,3623,3300180,892,3967
382,31,38,25,0,13271100,3623,3375300,906,3998
383,35,35,25,0,13362900,3619,3476640,926,4033
384,28,37,25,0,13448580,3617,3546960,938,4061
385,26,36,25,0,13538520,3624,3601620,948,4087
386,21,12,25,0,13652340,3611,5170260,1354,4108
387,31,0,24,1,13730460,3590,5735880,1490,4139
388,34,18,25,0,13801680,3595,5744160,1479,4173
389,27,31,25,0,13872540,3600,5762940,1476,4200
390,31,40,25,0,13958760,3606,5778660,1468,4231
391,32,40,25,0,14064720,3618,5832660,1476,4263
392,38,38,25,0,14180760,3619,5942940,1493,4301
393,28,33,25,0,14254560,3612,6008460,1500,4329
394,21,27,25,0,14335620,3608,6151080,1528,4350
395,20,29,25,0,14419440,3612,6170280,1525,4370
396,26,32,25,0,14524980,3618,6254580,1536,4396
397,37,40,25,0,14601000,3618,6265260,1528,4433
398,31,36,25,0,14702460,3614,6372300,1544,4464
399,30,40,25,0,14788440,3614,6409380,1542,4494
400,32,40,25,0,14884860,3619,6427140,1539,4526
401,39,40,25,0,14968620,3615,6482940,1542,4565
402,20,28,25,0,15059940,3614,6715140,1591,4585
403,34,28,25,0,15169320,3611,7109340,1671,4619
404,35,40,25,0,15242400,3612,7117380,1661,4654
405,31,40,25,0,15306600,3616,7140180,1661,4685
406,31,30,25,0,15441660,3615,7300740,1687,4716
407,21,2,25,0,15539700,3597,8062020,1854,4737
408,33,6,25,0,15615480,3590,8067180,1843,4770
409,31,18,25,0,15670440,3587,8074560,1833,4801
410,28,29,25,0,15764220,3595,8088660,1822,4829
411,33,40,25,0,15855780,3604,8097060,1814,4862
412,23,40,25,0,15949080,3612,8134020,1816,4885
413,20,34,25,0,16057200,3618,8205960,1825,4905
414,28,38,25,0,16134720,3620,8268300,1829,4933
415,31,40,25,0,16220280,3625,8366700,1843,4964
416,31,37,25,0,16323540,3629,8443260,1851,4995
417,26,30,25,0,16416240,3623,8605680,1877,5021
418,36,26,25,0,16508220,3611,8901000,1925,5057
419,31,38,25,0,16579560,3612,8912700,1916,5088
420,23,39,25,0,16676340,3617,8986860,1922,5111
421,34,40,25,0,16769820,3616,9047940,1924,5145
422,28,38,25,0,16844100,3612,9109320,1927,5173
423,29,33,25,0,16973040,3618,9244380,1947,5202
424,31,34,25,0,17031660,3607,9469920,1981,5233
425,27,40,25,0,17120040,3613,9483360,1974,5260
426,28,39,25,0,17221800,3621,9509340,1974,5288
427,37,40,25,0,17298060,3626,9570240,1979,5325
428,36,39,25,0,17398200,3627,9588660,1972,5361
429,35,39,25,0,17484180,3625,9642840,1973,5396
430,43,39,25,0,17595720,3627,9737520,1984,5439
431,35,40,25,0,17651940,3628,9748020,1977,5474
432,38,38,25,0,17760300,3631,9785280,1975,5512
433,29,40,25,0,17843640,3628,9846180,1978,5541
434,29,39,25,0,17911140,3627,9865260,1973,5570
435,36,40,25,0,18016920,3632,9898380,1970,5606
436,35,39,25,0,18117000,3635,9942360,1969,5641
437,25,38,25,0,18189540,3638,9968220,1970,5666
438,21,13,25,0,18303120,3627,11342820,2231,5687
439,25,6,25,0,18393780,3622,11849220,2320,5712
440,37,23,25,0,18481560,3625,11860740,2305,5749
441,27,35,25,0,18560220,3630,11879100,2298,5776
442,33,40,25,0,18651540,3635,11907360,2292,5809
443,30,39,25,0,18728100,3637,11945100,2291,5839
444,29,33,25,0,18846600,3643,12031980,2300,5868
445,33,20,25,0,18942480,3629,12323100,2341,5901
446,35,32,25,0,19017060,3627,12356220,2332,5936
447,34,40,25,0,19092300,3629,12367020,2323,5970
448,35,37,25,0,19186740,3634,12394920,2320,6005
449,33,37,25,0,19282800,3639,12452100,2324,6038
450,28,36,25,0,19392180,3643,12525600,2326,6066
451,33,34,25,0,19477320,3641,12548760,2320,6099
452,33,40,25,0,19548660,3637,12642060,2324,6132
453,37,39,25,0,19646460,3640,12688740,2323,6169
454,29,38,25,0,19731300,3637,12802620,2333,6198
455,34,40,25,0,19826940,3637,12818760,2324,6232
456,33,36,25,0,19916040,3637,12912300,2332,6265
457,27,40,25,0,19995840,3638,12920640,2324,6292
458,32,40,25,0,20091480,3639,12954180,2320,6324
459,29,39,25,0,20190960,3638,13063800,2327,6353
460,29,35,25,0,20293860,3634,13155720,2331,6382
461,33,38,25,0,20395980,3634,13208400,2327,6415
462,32,35,25,0,20474580,3631,13238160,2323,6447
463,46,40,25,0,20526960,3629,13242780,2315,6493
464,44,39,25,0,20644620,3632,13317420,2317,6537
465,35,36,25,0,20719740,3635,13341420,2316,6572
466,33,40,25,0,20788680,3635,13404780,2317,6605
467,39,36,25,0,20923860,3633,13824480,2375,6644
468,28,39,25,0,20986080,3635,13834380,2370,6672
469,34,40,25,0,21081360,3638,13856640,2365,6706
470,32,38,25,0,21175620,3639,13924380,2368,6738
471,30,39,25,0,21258660,3639,13957320,2363,6768
472,34,34,25,0,21373140,3638,14092080,2376,6802
473,32,40,25,0,21426900,3637,14118360,2371,6834
474,27,35,25,0,21533580,3636,14199900,2374,6861
475,29,31,25,0,21623220,3631,14769120,2457,6890
476,36,39,25,0,21714420,3631,14875380,2461,6926
477,26,40,25,0,21793320,3634,14889240,2456,6952
478,30,37,25,0,21915960,3635,14931360,2452,6982
479,34,40,25,0,21971220,3631,14995020,2452,7016
480,20,30,25,0,22081560,3631,15418800,2514,7036
481,23,14,25,0,22178520,3624,16485000,2677,7059
482,36,22,25,0,22262820,3621,16503720,2665,7095
483,37,39,25,0,22329600,3624,16511460,2652,7132
484,31,38,25,0,22430820,3628,16550760,2650,7163
485,24,33,25,0,22518180,3626,16629480,2653,7187
486,27,36,25,0,22608480,3626,16820940,2672,7214
487,26,38,25,0,22707420,3632,16839240,2667,7240
488,30,39,25,0,22796580,3631,16866240,2661,7270
489,23,37,25,0,22886400,3634,16880400,2654,7293
490,37,40,25,0,22991820,3635,16894380,2644,7330
491,40,40,25,0,23072340,3633,16958040,2643,7370
492,26,34,25,0,23162880,3633,17083440,2655,7396
493,29,36,25,0,23261400,3634,17163120,2656,7425
494,32,40,25,0,23323260,3632,17167140,2647,7457
495,20,31,25,0,23407200,3632,17390580,2675,7477
496,31,38,25,0,23525100,3638,17403600,2666,7508
497,25,37,25,0,23608140,3639,17436300,2662,7533
498,31,28,25,0,23705160,3631,18098400,2751,7564
499,26,32,25,0,23786280,3632,18106200,2740,7590
500,33,40,25,0,23851440,3634,18115560,2734,7623
501,37,38,25,0,23974800,3639,18181860,2734,7660
502,35,40,25,0,24053460,3638,18215760,2729,7695
503,22,33,25,0,24148560,3641,18319320,2739,7717
504,17,0,21,4,24254820,3627,20131500,3001,7734
505,10,0,13,12,24320580,3627,20131500,2997,7744
506,6,0,6,19,24381780,3629,20131500,2994,7750
507,4,0,2,23,24406320,3629,20131500,2992,7754
508,9,0,6,19,24416760,3628,20131500,2988,7763
509,9,0,10,15,24431220,3627,20131500,2984,7772
510,6,0,9,16,24457260,3627,20131500,2982,7778
511,7,0,12,13,24471600,3627,20131500,2978,7785
512,10,0,9,16,24519600,3627,20131500,2974,7795
513,14,0,10,15,24573240,3628,20131500,2968,7809
514,16,0,14,11,24604860,3626,20131500,2961,7825
515,11,0,10,15,24655200,3626,20131500,2956,7836
516,9,0,9,16,24684420,3625,20131500,2952,7845
517,7,0,8,17,24712740,3625,20131500,2949,7852
518,6,0,5,20,24750120,3625,20131500,2947,7858
519,7,0,5,20,24766440,3624,20131500,2944,7865
520,11,0,11,14,24782220,3624,20131500,2939,7876
521,17,0,14,11,24825540,3623,20131500,2932,7893
522,10,0,12,13,24872100,3623,20131500,2927,7903
523,8,0,5,20,24920700,3622,20131500,2924,7911
524,6,0,7,18,24933480,3622,20131500,2921,7917
525,7,0,7,18,24964860,3623,20131500,2918,7924
526,8,0,8,17,24993600,3623,20131500,2915,7932
527,12,0,11,14,25030800,3624,20131500,2910,7944
528,4,0,4,21,25071300,3624,20131500,2908,7948
529,5,0,4,21,25081920,3623,20131500,2906,7953
530,4,0,3,22,25103580,3624,20131500,2904,7957
531,1,0,3,22,25109520,3624,20131500,2904,7958
532,12,0,11,14,25117560,3623,20131500,2899,7970
533,5,0,5,20,25158780,3623,20131500,2897,7975
534,7,0,7,18,25182780,3624,20131500,2894,7982
535,9,0,9,16,25201500,3623,20131500,2890,7991
536,7,0,9,16,25223220,3622,20131500,2887,7998
537,11,0,13,12,25261380,3624,20131500,2883,8009
538,5,0,11,14,25293060,3625,20131500,2881,8014
539,11,0,6,19,25353660,3626,20131500,2876,8025
540,10,0,12,13,25373400,3626,20131500,2872,8035
541,6,0,11,14,25389060,3625,20131500,2870,8041
542,10,0,11,14,25429500,3626,20131500,2866,8051
543,10,0,10,15,25477380,3627,20131500,2862,8061
544,10,0,12,13,25490580,3624,20131500,2857,8071
545,7,0,9,16,25541700,3627,20131500,2855,8078
546,7,0,7,18,25581060,3628,20131500,2852,8085
547,8,0,12,13,25590720,3627,20131500,2849,8093
548,3,0,4,21,25645620,3629,20131500,2847,8096
549,6,0,6,19,25655700,3629,20131500,2845,8102
550,9,0,10,15,25676640,3629,20131500,2841,8111
551,5,0,8,17,25697760,3629,20131500,2839,8116
552,3,0,3,22,25743360,3631,20131500,2838,8119
553,5,0,3,22,25756140,3630,20131500,2836,8124
554,2,0,4,21,25756920,3630,20131500,2835,8126
555,4,0,4,21,25778640,3631,20131500,2834,8130
556,4,0,4,21,25795920,3631,20131500,2832,8134
557,5,0,4,21,25805460,3630,20131500,2830,8139
558,12,0,11,14,25819140,3629,20131500,2825,8151
559,13,0,16,9,25850820,3630,20131500,2820,8164
560,7,0,12,13,25896300,3631,20131500,2817,8171
561,9,0,12,13,25936740,3632,20131500,2814,8180
562,8,0,12,13,25963800,3631,20131500,2811,8188
563,8,0,13,12,26009760,3634,20131500,2808,8196
564,10,0,9,16,26065020,3635,20131500,2804,8206
565,10,0,6,19,26113200,3635,20131500,2800,8216
566,12,0,7,18,26136240,3633,20131500,2795,8228
567,7,0,8,17,26152200,3632,20131500,2792,8235
568,9,0,7,18,26184060,3631,20131500,2789,8244
569,12,0,9,16,26208900,3630,20131500,2784,8256
570,5,0,2,23,26256660,3630,20131500,2782,8261
571,10,0,8,17,26261160,3629,20131500,2779,8271
572,12,0,11,14,26287740,3628,20131500,2774,8283
573,8,0,10,15,26319540,3628,20131500,2771,8291
574,8,0,7,18,26356380,3627,20131500,2768,8299
575,4,0,5,20,26382780,3628,20131500,2766,8303
576,3,0,5,20,26396760,3628,20131500,2765,8306
577,4,0,4,21,26423640,3630,20131500,2764,8310
578,8,0,9,16,26434800,3630,20131500,2761,8318
579,5,0,7,18,26457360,3629,20131500,2759,8323
580,7,0,7,18,26486580,3630,20131500,2756,8330
581,6,0,6,19,26508360,3629,20131500,2754,8336
582,9,0,9,16,26530920,3629,20131500,2750,8345
583,15,0,15,10,26562420,3629,20131500,2745,8360
584,10,0,9,16,26627700,3630,20131500,2741,8370
585,8,0,10,15,26657160,3631,20131500,2738,8378
586,6,0,5,20,26699040,3631,20131500,2736,8384
587,13,0,9,16,26731860,3631,20131500,2731,8397
588,8,0,9,16,26757540,3631,20131500,2728,8405
589,10,0,11,14,26786400,3631,20131500,2724,8415
590,10,0,11,14,26822460,3631,20131500,2721,8425
591,10,0,11,14,26861100,3631,20131500,2717,8435
592,8,0,8,17,26900880,3631,20131500,2714,8443
593,15,0,9,16,26938800,3629,20131500,2709,8458
594,6,0,7,18,26955120,3627,20131500,2706,8464
595,5,0,8,17,26980080,3629,20131500,2705,8469
596,7,0,4,21,27021480,3629,20131500,2702,8476
597,5,0,4,21,27040620,3629,20131500,2700,8481
598,3,0,3,22,27058020,3630,20131500,2699,8484
599,4,0,2,23,27064440,3628,20131500,2698,8488
600,5,0,5,20,27068820,3628,20131500,2696,8493
601,5,0,5,20,27087240,3628,20131500,2694,8498
602,13,0,14,11,27095820,3627,20131500,2689,8511
603,2,0,9,16,27122160,3627,20131500,2689,8513
604,6,0,4,21,27170160,3628,20131500,2687,8519
605,6,0,3,22,27199740,3629,20131500,2684,8525
606,4,0,4,21,27206820,3628,20131500,2683,8529
607,8,0,8,17,27223740,3628,20131500,2680,8537
608,6,0,7,18,27242340,3627,20131500,2678,8543
609,12,0,13,12,27264660,3628,20131500,2674,8555
610,10,0,11,14,27301860,3627,20131500,2670,8565
611,7,0,11,14,27332820,3627,20131500,2668,8572
612,14,0,11,14,27387960,3628,20131500,2663,8586
613,11,0,14,11,27426360,3629,20131500,2659,8597
614,8,0,15,10,27460200,3630,20131500,2656,8605
615,10,0,14,11,27515460,3632,20131500,2653,8615
616,7,0,11,14,27555600,3633,20131500,2650,8622
617,6,0,11,14,27579180,3633,20131500,2648,8628
618,13,0,13,12,27616800,3633,20131500,2644,8641
619,8,0,12,13,27661260,3634,20131500,2641,8649
620,9,0,7,18,27731100,3637,20131500,2638,8658
621,8,0,7,18,27759660,3637,20131500,2635,8666
622,6,0,9,16,27774480,3637,20131500,2633,8672
623,3,0,4,21,27804960,3637,20131500,2632,8675
624,6,0,3,22,27834240,3637,20131500,2630,8681
625,3,0,3,22,27841320,3637,20131500,2629,8684
626,5,0,6,19,27850680,3637,20131500,2627,8689
627,5,0,3,22,27877560,3637,20131500,2625,8694
628,7,0,5,20,27890100,3636,20131500,2623,8701
629,4,0,4,21,27906720,3636,20131500,2621,8705
630,9,0,11,14,27912660,3636,20131500,2618,8714
631,10,0,14,11,27929520,3635,20131500,2615,8724
632,10,0,11,14,27991380,3637,20131500,2612,8734
633,10,0,12,13,28029960,3637,20131500,2608,8744
634,12,0,12,13,28065900,3636,20131500,2604,8756
635,16,0,14,11,28117200,3636,20131500,2599,8772
636,11,0,15,10,28159920,3637,20131500,2595,8783
637,11,0,12,13,28233420,3640,20131500,2591,8794
638,9,0,8,17,28280940,3640,20131500,2588,8803
639,11,0,13,12,28314480,3642,20131500,2585,8814
640,6,0,9,16,28348140,3641,20131500,2583,8820
641,6,0,7,18,28385520,3642,20131500,2581,8826
642,4,0,4,21,28408740,3642,20131500,2579,8830
643,8,0,9,16,28421580,3642,20131500,2577,8838
644,6,0,9,16,28445880,3643,20131500,2575,8844
645,5,0,4,21,28494840,3644,20131500,2573,8849
646,7,0,6,19,28506000,3643,20131500,2571,8856
647,7,0,11,14,28524900,3645,20131500,2569,8863
648,7,0,7,18,28561200,3644,20131500,2566,8870
649,3,0,4,21,28584180,3645,20131500,2565,8873
650,4,0,4,21,28608000,3646,20131500,2564,8877
651,6,0,6,19,28615860,3645,20131500,2562,8883
652,1,0,3,22,28633680,3645,20131500,2562,8884
653,3,0,2,23,28654860,3646,20131500,2561,8887
654,8,0,6,19,28664400,3645,20131500,2558,8895
655,15,0,9,16,28688520,3643,20131500,2553,8910
656,7,0,9,16,28707060,3642,20131500,2551,8917
657,16,0,9,16,28761960,3642,20131500,2546,8933
658,8,0,5,20,28788480,3639,20131500,2543,8941
659,11,0,11,14,28804680,3639,20131500,2540,8952
660,5,0,10,15,28828020,3639,20131500,2538,8957
661,16,0,16,9,28878960,3641,20131500,2533,8973
662,8,0,14,11,28916580,3641,20131500,2530,8981
663,8,0,10,15,28977660,3644,20131500,2528,8989
664,7,0,6,19,29024940,3644,20131500,2526,8996
665,12,0,12,13,29045880,3644,20131500,2522,9008
666,7,0,7,18,29081760,3643,20131500,2520,9015
667,6,0,3,22,29117640,3643,20131500,2518,9021
668,5,0,4,21,29127360,3643,20131500,2516,9026
669,5,0,5,20,29141820,3643,20131500,2515,9031
670,5,0,6,19,29160480,3643,20131500,2513,9036
671,7,0,8,17,29180100,3643,20131500,2511,9043
672,5,0,6,19,29206740,3644,20131500,2509,9048
673,5,0,10,15,29208480,3643,20131500,2508,9053
674,5,0,9,16,29220960,3642,20131500,2506,9058
675,8,0,12,13,29238300,3642,20131500,2504,9066
676,4,0,11,14,29264340,3643,20131500,2502,9070
677,2,0,8,17,29281800,3643,20131500,2502,9072
678,12,0,14,11,29301000,3643,20131500,2498,9084
679,12,0,19,6,29320980,3642,20131500,2494,9096
680,12,0,20,5,29359140,3642,20131500,2491,9108
681,8,0,16,9,29422560,3644,20131500,2488,9116
682,11,0,17,8,29469120,3645,20131500,2485,9127
683,8,0,13,12,29515620,3646,20131500,2482,9135
684,13,0,14,11,29571300,3647,20131500,2478,9148
685,11,0,15,10,29594040,3645,20131500,2475,9159
686,9,0,12,13,29640660,3646,20131500,2472,9168
687,9,0,16,9,29654880,3645,20131500,2470,9177
688,10,0,17,8,29688840,3645,20131500,2467,9187
689,10,0,15,10,29728860,3645,20131500,2464,9197
690,14,0,16,9,29779260,3645,20131500,2459,9211
691,8,0,18,7,29802660,3646,20131500,2457,9219
692,5,0,11,14,29856180,3647,20131500,2455,9224
693,7,0,12,13,29885700,3648,20131500,2453,9231
694,3,0,8,17,29913780,3648,20131500,2452,9234
695,5,0,9,16,29925300,3648,20131500,2451,9239
696,1,0,8,17,29937300,3648,20131500,2451,9240
697,3,0,8,17,29953620,3649,20131500,2450,9243
698,4,0,8,17,29967540,3649,20131500,2449,9247
699,5,0,9,16,29979060,3648,20131500,2447,9252
700,3,0,10,15,29984940,3648,20131500,2446,9255
701,7,0,10,15,30006180,3648,20131500,2444,9262
702,8,0,12,13,30034380,3648,20131500,2442,9270
703,11,0,16,9,30058620,3648,20131500,2438,9281
704,9,0,13,12,30100500,3648,20131500,2436,9290
705,8,0,16,9,30117720,3648,20131500,2433,9298
706,7,0,13,12,30156240,3648,20131500,2431,9305
707,5,0,7,18,30197760,3648,20131500,2430,9310
708,11,0,15,10,30200220,3647,20131500,2427,9321
709,8,0,16,9,30224820,3647,20131500,2424,9329
710,8,0,15,10,30264900,3648,20131500,2422,9337
711,10,0,16,9,30298440,3648,20131500,2419,9347
712,6,0,14,11,30333000,3649,20131500,2417,9353
713,11,0,14,11,30376020,3649,20131500,2414,9364
714,8,0,13,12,30403560,3649,20131500,2412,9372
715,3,0,8,17,30433860,3649,20131500,2411,9375
716,3,0,10,15,30440760,3649,20131500,2410,9378
717,2,0,9,16,30452580,3649,20131500,2410,9380
718,7,0,10,15,30465300,3648,20131500,2408,9387
719,3,0,8,17,30496680,3650,20131500,2407,9390
720,6,0,8,17,30516840,3649,20131500,2405,9396
721,4,0,10,15,30523200,3649,20131500,2404,9400
722,6,0,11,14,30538320,3649,20131500,2402,9406
723,7,0,12,13,30556560,3648,20131500,2400,9413
724,4,0,10,15,30583380,3649,20131500,2399,9417
725,4,0,10,15,30600300,3649,20131500,2398,9421
726,10,0,16,9,30613740,3649,20131500,2395,9431
727,8,0,12,13,30640560,3647,20131500,2393,9439
728,10,0,14,11,30670560,3647,20131500,2390,9449
729,5,0,13,12,30703200,3649,20131500,2388,9454
730,15,0,18,7,30735600,3648,20131500,2384,9469
731,11,0,15,10,30769740,3646,20131500,2381,9480
732,8,0,15,10,30808140,3647,20131500,2379,9488
733,9,0,13,12,30851880,3648,20131500,2376,9497
734,10,0,14,11,30874080,3646,20131500,2373,9507
735,9,0,16,9,30900060,3646,20131500,2371,9516
736,10,0,16,9,30948180,3648,20131500,2368,9526
737,5,0,16,9,30966840,3648,20131500,2367,9531
738,6,0,11,14,31025220,3650,20131500,2365,9537
739,8,0,12,13,31048620,3650,20131500,2363,9545
740,6,0,14,11,31063560,3650,20131500,2361,9551
741,6,0,12,13,31096980,3650,20131500,2360,9557
742,5,0,12,13,31120620,3651,20131500,2358,9562
743,4,0,8,17,31155480,3652,20131500,2357,9566
744,7,0,9,16,31163400,3650,20131500,2355,9573
745,6,0,8,17,31185300,3649,20131500,2354,9579
746,6,0,10,15,31188720,3648,20131500,2352,9585
747,5,0,11,14,31213800,3649,20131500,2350,9590
748,3,0,7,18,31233420,3649,20131500,2350,9593
749,2,0,7,18,31239300,3649,20131500,2349,9595
750,3,0,8,17,31249200,3649,20131500,2348,9598
751,8,0,11,14,31257960,3648,20131500,2346,9606
752,10,0,19,6,31263360,3648,20131500,2343,9616
753,12,0,19,6,31298880,3647,20131500,2340,9628
754,15,0,16,9,31372860,3648,20131500,2336,9643
755,7,0,15,10,31398060,3647,20131500,2334,9650
756,9,0,11,14,31442340,3647,20131500,2332,9659
757,3,0,11,14,31465020,3648,20131500,2331,9662
758,7,0,11,14,31486500,3648,20131500,2329,9669
759,14,0,17,8,31514640,3647,20131500,2325,9683
760,14,0,17,8,31551420,3646,20131500,2321,9697
761,9,0,15,10,31594260,3646,20131500,2319,9706
762,7,0,11,14,31640820,3647,20131500,2317,9713
763,7,0,11,14,31658220,3646,20131500,2315,9720
764,7,0,10,15,31678860,3645,20131500,2313,9727
765,10,0,17,8,31693800,3645,20131500,2311,9737
766,4,0,12,13,31730160,3646,20131500,2310,9741
767,13,0,16,9,31762740,3646,20131500,2306,9754
768,7,0,13,12,31793880,3645,20131500,2304,9761
769,5,0,8,17,31827300,3645,20131500,2303,9766
770,4,0,9,16,31836360,3645,20131500,2302,9770
771,7,0,13,12,31842300,3644,20131500,2300,9777
772,6,0,12,13,31873080,3645,20131500,2299,9783
773,11,0,13,12,31896300,3643,20131500,2296,9794
774,9,0,15,10,31927320,3644,20131500,2293,9803
775,5,0,9,16,31974720,3645,20131500,2292,9808
776,11,0,14,11,31998180,3645,20131500,2289,9819
777,13,0,17,8,32016720,3643,20131500,2286,9832
778,11,0,20,5,32046240,3643,20131500,2283,9843
779,13,0,16,9,32114160,3643,20131500,2280,9856
780,9,0,15,10,32153160,3644,20131500,2277,9865
781,11,0,15,10,32190180,3643,20131500,2275,9876
782,14,0,17,8,32230080,3643,20131500,2271,9890
783,15,0,15,10,32279160,3642,20131500,2267,9905
784,10,0,14,11,32327580,3642,20131500,2265,9915
785,7,0,14,11,32353800,3643,20131500,2263,9922
786,11,0,15,10,32392440,3643,20131500,2260,9933
787,13,0,21,4,32412300,3642,20131500,2257,9946
788,1,0,9,16,32472600,3644,20131500,2256,9947
789,9,0,14,11,32487780,3644,20131500,2254,9956
790,5,0,11,14,32522220,3644,20131500,2253,9961
791,4,0,11,14,32543640,3645,20131500,2252,9965
792,4,0,11,14,32558220,3645,20131500,2251,9969
793,3,0,9,16,32584860,3646,20131500,2250,9972
794,3,0,9,16,32603820,3647,20131500,2249,9975
795,7,0,12,13,32615340,3647,20131500,2248,9982
796,5,0,11,14,32637540,3647,20131500,2246,9987
797,11,0,16,9,32653620,3646,20131500,2244,9998
798,6,0,14,11,32682780,3646,20131500,2242,10004
799,7,0,10,15,32724960,3646,20131500,2240,10011
800,10,0,13,12,32741100,3645,20131500,2238,10021
801,7,0,14,11,32753640,3644,20131500,2236,10028
802,9,0,14,11,32794980,3645,20131500,2234,10037
803,10,0,15,10,32821800,3644,20131500,2231,10047
804,13,0,21,4,32848740,3645,20131500,2228,10060
805,12,0,17,8,32919480,3646,20131500,2225,10072
806,15,0,19,6,32951400,3644,20131500,2222,10087
807,19,0,18,7,33018300,3644,20131500,2217,10106
808,9,0,17,8,33053220,3643,20131500,2215,10115
809,5,0,12,13,33100800,3645,20131500,2213,10120
810,10,0,10,15,33154260,3646,20131500,2211,10130
811,10,0,15,10,33162480,3645,20131500,2209,10140
812,5,0,14,11,33180900,3644,20131500,2207,10145
813,2,0,10,15,33220500,3646,20131500,2207,10147
814,8,0,13,12,33240840,3646,20131500,2205,10155
815,8,0,17,8,33254940,3646,20131500,2203,10163
816,7,0,15,10,33302100,3648,20131500,2201,10170
817,12,0,16,9,33337260,3647,20131500,2198,10182
818,5,0,9,16,33391140,3648,20131500,2197,10187
819,7,0,13,12,33402240,3648,20131500,2196,10194
820,6,0,13,12,33424800,3648,20131500,2194,10200
821,12,0,16,9,33454380,3648,20131500,2191,10212
822,11,0,16,9,33484500,3647,20131500,2189,10223
823,12,0,17,8,33520560,3647,20131500,2186,10235
824,6,0,13,12,33557280,3647,20131500,2184,10241
825,11,0,17,8,33577440,3646,20131500,2182,10252
826,12,0,14,11,33631800,3646,20131500,2179,10264
827,9,0,12,13,33668580,3646,20131500,2177,10273
828,7,0,12,13,33691680,3645,20131500,2175,10280
829,8,0,15,10,33707700,3645,20131500,2173,10288
830,14,0,17,8,33751140,3645,20131500,2170,10302
831,11,0,15,10,33787920,3644,20131500,2167,10313
832,13,0,17,8,33825420,3644,20131500,2164,10326
833,8,0,15,10,33868260,3644,20131500,2163,10334
834,10,0,16,9,33906600,3645,20131500,2160,10344
835,10,0,17,8,33939780,3645,20131500,2158,10354
836,7,0,11,14,33994320,3646,20131500,2156,10361
837,9,0,12,13,34025760,3646,20131500,2154,10370
838,5,0,12,13,34038840,3645,20131500,2153,10375
839,3,0,9,16,34068060,3646,20131500,2152,10378
840,1,0,8,17,34079100,3647,20131500,2152,10379
841,1,0,8,17,34090800,3648,20131500,2152,10380
842,3,0,6,19,34112220,3648,20131500,2151,10383
843,4,0,9,16,34118160,3648,20131500,2150,10387
844,5,0,9,16,34127340,3647,20131500,2149,10392
845,7,0,12,13,34134360,3646,20131500,2148,10399
846,4,0,12,13,34157340,3647,20131500,2147,10403
847,9,0,13,12,34179780,3647,20131500,2145,10412
848,9,0,16,9,34210920,3647,20131500,2143,10421
849,8,0,17,8,34242360,3648,20131500,2141,10429
850,10,0,17,8,34279440,3648,20131500,2138,10439
851,8,0,17,8,34322040,3650,20131500,2137,10447
852,11,0,17,8,34363020,3650,20131500,2134,10458
853,8,0,15,10,34397520,3649,20131500,2132,10466
854,7,0,11,14,34440780,3650,20131500,2131,10473
855,8,0,15,10,34459080,3650,20131500,2129,10481
856,10,0,12,13,34499400,3649,20131500,2127,10491
857,14,0,17,8,34528140,3649,20131500,2124,10505
858,10,0,18,7,34554000,3648,20131500,2121,10515
859,12,0,21,4,34590900,3649,20131500,2119,10527
860,6,0,13,12,34648440,3649,20131500,2117,10533
861,12,0,15,10,34681080,3649,20131500,2115,10545
862,4,0,11,14,34722780,3650,20131500,2114,10549
863,6,0,11,14,34750020,3651,20131500,2112,10555
864,8,0,12,13,34773120,3651,20131500,2111,10563
865,6,0,12,13,34786080,3650,20131500,2109,10569
866,13,0,17,8,34816200,3650,20131500,2106,10582
867,5,0,13,12,34842420,3649,20131500,2105,10587
868,4,0,10,15,34873260,3650,20131500,2104,10591
869,7,0,11,14,34896120,3650,20131500,2103,10598
870,4,0,8,17,34922460,3650,20131500,2102,10602
871,7,0,13,12,34932180,3650,20131500,2100,10609
872,5,0,11,14,34948620,3649,20131500,2099,10614
873,11,0,15,10,34965300,3648,20131500,2097,10625
874,20,0,25,0,34996740,3648,20131500,2093,10645
875,15,0,21,4,35054280,3646,20133780,2090,10660
876,11,0,14,11,35135820,3648,20133780,2087,10671
877,10,0,14,11,35167380,3648,20133780,2085,10681
878,5,0,13,12,35192760,3648,20133780,2084,10686
879,7,0,13,12,35218500,3648,20133780,2082,10693
880,4,0,10,15,35256120,3649,20133780,2082,10697
881,13,0,16,9,35278680,3649,20133780,2079,10710
882,8,0,13,12,35307240,3648,20133780,2077,10718
883,3,0,7,18,35341860,3648,20133780,2076,10721
884,7,0,9,16,35350380,3647,20133780,2075,10728
885,8,0,9,16,35360880,3645,20133780,2073,10736
886,5,0,10,15,35368980,3644,20133780,2072,10741
887,9,0,15,10,35393700,3645,20133780,2070,10750
888,2,0,8,17,35431140,3646,20133780,2070,10752
889,9,0,13,12,35446560,3646,20133780,2068,10761
890,2,0,9,16,35468340,3646,20133780,2067,10763
891,3,0,10,15,35477760,3646,20133780,2067,10766
892,10,0,13,12,35507220,3647,20133780,2065,10776
893,3,0,7,18,35532900,3646,20133780,2064,10779
894,5,0,8,17,35542140,3645,20133780,2063,10784
895,5,0,10,15,35548740,3645,20133780,2062,10789
896,4,0,11,14,35554980,3644,20133780,2061,10793
897,11,0,17,8,35576820,3645,20133780,2059,10804
898,12,0,19,6,35604840,3644,20133780,2056,10816
899,11,0,16,9,35667120,3645,20133780,2054,10827
900,12,0,17,8,35700720,3644,20133780,2051,10839
901,10,0,17,8,35752740,3646,20133780,2049,10849
902,13,0,18,7,35795460,3646,20133780,2047,10862
903,10,0,18,7,35839140,3647,20133780,2045,10872
904,15,0,18,7,35908320,3648,20133780,2041,10887
905,12,0,17,8,35949060,3647,20133780,2039,10899
906,13,0,19,6,35989920,3647,20133780,2036,10912
907,12,0,16,9,36049680,3648,20133780,2034,10924
908,9,0,17,8,36080160,3648,20133780,2032,10933
909,7,0,15,10,36125760,3649,20133780,2031,10940
910,6,0,11,14,36161280,3649,20133780,2029,10946
911,7,0,10,15,36193380,3649,20133780,2028,10953
912,3,0,11,14,36196680,3649,20133780,2027,10956
913,3,0,8,17,36219300,3649,20133780,2027,10959
914,7,0,8,17,36245340,3649,20133780,2025,10966
915,5,0,7,18,36261720,3649,20133780,2024,10971
916,2,0,6,19,36268800,3648,20133780,2024,10973
917,3,0,6,19,36274320,3648,20133780,2023,10976
918,8,0,9,16,36282240,3647,20133780,2022,10984
919,6,0,12,13,36292140,3647,20133780,2020,10990
920,6,0,11,14,36318300,3647,20133780,2019,10996
921,7,0,15,10,36329880,3647,20133780,2018,11003
922,10,0,11,14,36370500,3646,20133780,2016,11013
923,11,0,15,10,36394500,3646,20133780,2013,11024
924,11,0,15,10,36431520,3645,20133780,2011,11035
925,13,0,11,14,36475980,3643,20133780,2009,11048
926,7,0,13,12,36491880,3643,20133780,2007,11055
927,11,0,14,11,36524280,3643,20133780,2005,11066
928,12,0,22,3,36536580,3643,20133780,2003,11078
929,12,0,17,8,36598080,3643,20133780,2000,11090
930,7,0,15,10,36657660,3645,20133780,1999,11097
931,7,0,13,12,36685680,3645,20133780,1997,11104
932,7,0,12,13,36719820,3645,20133780,1996,11111
933,8,0,11,14,36754680,3645,20133780,1995,11119
934,8,0,11,14,36777300,3645,20133780,1993,11127
935,3,0,6,19,36808500,3645,20133780,1992,11130
936,4,0,6,19,36812100,3644,20133780,1992,11134
937,10,0,10,15,36819180,3642,20133780,1990,11144
938,6,0,10,15,36835920,3642,20133780,1988,11150
939,9,0,13,12,36850920,3641,20133780,1987,11159
940,6,0,14,11,36862080,3641,20133780,1985,11165
941,7,0,11,14,36899880,3641,20133780,1984,11172
942,3,0,10,15,36913860,3641,20133780,1984,11175
943,4,0,7,18,36949920,3642,20133780,1983,11179
944,9,0,12,13,36963540,3642,20133780,1981,11188
945,9,0,14,11,36978000,3641,20133780,1979,11197
946,12,0,15,10,36999000,3639,20133780,1977,11209
947,11,0,19,6,37024260,3639,20133780,1975,11220
948,9,0,16,9,37073820,3639,20133780,1973,11229
949,13,0,18,7,37105020,3638,20133780,1971,11242
950,12,0,20,5,37151220,3639,20133780,1968,11254
951,5,0,15,10,37192800,3640,20133780,1967,11259
952,13,0,19,6,37235340,3641,20133780,1965,11272
953,10,0,15,10,37297140,3642,20133780,1963,11282
954,12,0,17,8,37337400,3642,20133780,1961,11294
955,13,0,16,9,37392780,3643,20133780,1958,11307
956,3,0,11,14,37424880,3643,20133780,1957,11310
957,6,0,12,13,37448880,3643,20133780,1956,11316
958,11,0,14,11,37467720,3642,20133780,1954,11327
959,11,0,16,9,37504200,3642,20133780,1952,11338
960,5,0,11,14,37538580,3642,20133780,1951,11343
961,6,0,10,15,37565280,3642,20133780,1950,11349
962,4,0,6,19,37585080,3641,20133780,1949,11353
963,2,0,7,18,37586760,3641,20133780,1949,11355
964,4,0,8,17,37590900,3641,20133780,1948,11359
965,4,0,10,15,37595880,3640,20133780,1947,11363
966,4,0,10,15,37610340,3640,20133780,1947,11367
967,7,0,8,17,37636080,3640,20133780,1945,11374
968,15,0,17,8,37644900,3638,20133780,1943,11389
969,8,0,18,7,37671840,3639,20133780,1941,11397
970,10,0,15,10,37724760,3639,20133780,1939,11407
971,12,0,19,6,37759920,3640,20133780,1937,11419
972,13,0,21,4,37795200,3639,20133780,1935,11432
973,15,0,23,2,37847640,3640,20133780,1932,11447
974,14,0,24,1,37891980,3639,20133780,1929,11461
975,11,0,20,5,37959000,3641,20133780,1927,11472
976,7,0,14,11,38028300,3643,20133780,1926,11479
977,10,0,12,13,38082780,3644,20133780,1924,11489
978,9,0,10,15,38113320,3643,20133780,1922,11498
979,5,0,12,13,38119080,3642,20133780,1921,11503
980,11,0,15,10,38152080,3643,20133780,1919,11514
981,4,0,9,16,38193240,3643,20133780,1919,11518
982,5,0,8,17,38216820,3643,20133780,1918,11523
983,3,0,9,16,38222580,3643,20133780,1917,11526
984,5,0,10,15,38233680,3643,20133780,1916,11531
985,2,0,7,18,38252160,3643,20133780,1916,11533
986,5,0,9,16,38262660,3643,20133780,1915,11538
987,6,0,11,14,38271720,3642,20133780,1914,11544
988,8,0,13,12,38290500,3642,20133780,1912,11552
989,3,0,7,18,38328300,3643,20133780,1912,11555
990,5,0,9,16,38335920,3642,20133780,1911,11560
991,10,0,15,10,38349660,3642,20133780,1909,11570
992,7,0,13,12,38382420,3642,20133780,1908,11577
993,9,0,15,10,38413680,3643,20133780,1906,11586
994,12,0,19,6,38427840,3641,20133780,1904,11598
995,10,0,15,10,38498340,3643,20133780,1902,11608
996,5,0,9,16,38542080,3643,20133780,1901,11613
997,11,0,15,10,38560740,3643,20133780,1899,11624
998,2,0,11,14,38576700,3643,20133780,1899,11626
999,11,0,11,14,38615100,3643,20133780,1897,11637
1000,10,0,15,10,38629920,3642,20133780,1895,11647
1001,16,0,21,4,38670420,3642,20133780,1892,11663
1002,10,0,19,6,38724240,3643,20133780,1891,11673
1003,7,0,12,13,38778180,3644,20133780,1889,11680
1004,6,0,9,16,38812440,3644,20133780,1888,11686
1005,5,0,10,15,38830740,3644,20133780,1888,11691
1006,5,0,9,16,38851140,3644,20133780,1887,11696
1007,3,0,7,18,38866020,3644,20133780,1886,11699
1008,6,0,8,17,38885640,3644,20133780,1885,11705
1009,2,0,6,19,38901540,3644,20133780,1885,11707
1010,12,0,15,10,38907180,3644,20133780,1883,11719
1011,19,0,20,5,38938200,3642,20133780,1879,11738
1012,30,5,25,0,38981760,3639,20136180,1875,11768
1013,34,24,25,0,39048360,3640,20139960,1869,11802
1014,29,40,25,0,39098820,3642,20150340,1865,11831
1015,42,40,25,0,39168420,3644,20172480,1865,11873
1016,40,40,25,0,39247260,3647,20210220,1867,11913
1017,33,40,25,0,39333840,3650,20297280,1872,11946
1018,37,35,25,0,39414540,3650,20415360,1880,11983
1019,32,38,25,0,39502860,3650,20470920,1880,12015
1020,27,40,25,0,39552480,3649,20491140,1879,12042
1021,33,40,25,0,39632700,3651,20508420,1878,12075
1022,32,40,25,0,39702600,3651,20569680,1880,12107
1023,29,38,25,0,39767700,3651,20623740,1882,12136
1024,32,40,25,0,39829920,3651,20651820,1882,12168
1025,33,40,25,0,39919560,3651,20713920,1883,12201
1026,26,38,25,0,39983760,3650,20760060,1884,12227
1027,32,40,25,0,40040580,3650,20831760,1887,12259
1028,32,39,25,0,40135500,3652,20882820,1889,12291
1029,34,40,25,0,40176780,3650,20911920,1889,12325
1030,37,40,25,0,40275240,3650,20934300,1886,12362
1031,31,38,25,0,40339860,3650,21008520,1890,12393
1032,16,25,25,0,40431780,3648,21684600,1948,12409
1033,28,33,25,0,40485840,3647,21961080,1968,12437
1034,30,39,25,0,40566960,3649,21977160,1966,12467
1035,34,39,25,0,40635240,3649,22065540,1970,12501
1036,30,40,25,0,40713960,3649,22098840,1969,12531
1037,30,38,25,0,40763880,3649,22137420,1970,12561
1038,33,40,25,0,40850700,3650,22211280,1973,12594
1039,27,40,25,0,40909200,3651,22225740,1972,12621
1040,36,40,25,0,40971540,3651,22278360,1973,12657
1041,24,39,25,0,41059320,3653,22293060,1972,12681
1042,38,39,25,0,41125500,3655,22330080,1973,12719
1043,26,39,25,0,41201700,3657,22363080,1974,12745
1044,31,39,25,0,41269260,3657,22381920,1972,12776
1045,37,40,25,0,41341800,3658,22403340,1971,12813
1046,30,40,25,0,41431740,3657,22694280,1991,12843
1047,23,39,25,0,41483760,3657,22734480,1993,12866
1048,33,40,25,0,41571240,3659,22800300,1995,12899
1049,23,38,25,0,41637180,3658,22928280,2003,12922
1050,36,39,25,0,41714280,3658,22959420,2002,12958
1051,34,39,25,0,41798880,3656,23011080,2001,12992
1052,36,40,25,0,41846520,3655,23052960,2002,13028
1053,27,40,25,0,41910000,3655,23097900,2003,13055
1054,28,36,25,0,42012060,3655,23175300,2005,13083
1055,32,40,25,0,42072240,3654,23225700,2006,13115
1056,31,33,25,0,42171960,3653,23633280,2037,13146
1057,36,40,25,0,42213960,3649,24180120,2078,13182
1058,27,40,25,0,42266520,3650,24192360,2078,13209
1059,31,36,25,0,42364320,3652,24267060,2081,13240
1060,38,39,25,0,42443940,3652,24300420,2080,13278
1061,35,40,25,0,42486420,3651,24321360,2079,13313
1062,30,40,25,0,42542280,3652,24341340,2078,13343
1063,34,39,25,0,42654240,3653,24383340,2077,13377
1064,32,40,25,0,42729900,3654,24453960,2080,13409
1065,35,35,25,0,42801720,3654,24591120,2088,13444
1066,31,40,25,0,42857580,3653,24605640,2086,13475
1067,34,40,25,0,42944700,3654,24661980,2087,13509
1068,21,33,25,0,43019160,3652,24717120,2088,13530
1069,32,40,25,0,43083720,3650,24723660,2083,13562
1070,29,40,25,0,43157040,3650,24839220,2090,13591
1071,29,40,25,0,43227480,3651,24850980,2087,13620
1072,35,40,25,0,43292100,3652,24870420,2086,13655
1073,36,40,25,0,43363980,3653,24897060,2086,13691
1074,26,37,25,0,43444620,3654,24977400,2090,13717
1075,30,40,25,0,43509240,3653,24997860,2088,13747
1076,28,38,25,0,43600200,3653,25096440,2092,13775
1077,27,40,25,0,43655040,3652,25142820,2092,13802
1078,37,40,25,0,43723320,3652,25183980,2092,13839
1079,32,39,25,0,43797120,3652,25202700,2090,13871
1080,31,40,25,0,43847100,3653,25245600,2092,13902
1081,34,39,25,0,43962540,3654,25357440,2097,13936
1082,30,40,25,0,44015700,3653,25365780,2094,13966
1083,38,40,25,0,44083680,3654,25399380,2094,14004
1084,35,40,25,0,44150760,3655,25441200,2095,14039
1085,30,39,25,0,44239860,3655,25702200,2112,14069
1086,30,40,25,0,44291940,3654,25744080,2112,14099
1087,43,40,25,0,44374980,3656,25765200,2111,14142
1088,39,40,25,0,44443020,3656,25801140,2111,14181
1089,28,39,25,0,44513760,3657,25836600,2111,14209
1090,30,39,25,0,44591280,3656,25920600,2114,14239
1091,34,39,25,0,44672580,3657,26042580,2121,14273
1092,28,36,25,0,44742720,3656,26107800,2122,14301
1093,30,40,25,0,44815860,3656,26160300,2123,14331
1094,28,40,25,0,44872980,3656,26171040,2121,14359
1095,31,36,25,0,44950200,3657,26265120,2126,14390
1096,37,39,25,0,45034320,3657,26307840,2125,14427
1097,30,40,25,0,45092220,3656,26323800,2123,14457
1098,34,39,25,0,45172680,3657,26355420,2122,14491
1099,39,40,25,0,45245880,3657,26436720,2125,14530
1100,33,40,25,0,45311580,3656,26475660,2125,14563
1101,34,40,25,0,45385500,3656,26527500,2126,14597
1102,35,38,25,0,45462900,3656,26594400,2128,14632
1103,22,40,25,0,45528480,3657,26632140,2128,14654
1104,32,40,25,0,45587340,3655,26847900,2142,14686
1105,31,40,25,0,45657180,3657,26861460,2140,14717
1106,37,40,25,0,45740700,3658,26882220,2139,14754
1107,26,39,25,0,45816780,3658,26955660,2141,14780
1108,36,40,25,0,45888960,3659,26983080,2140,14816
1109,25,34,25,0,45958020,3658,28402140,2250,14841
1110,40,40,25,0,46024560,3658,28406400,2246,14881
1111,33,40,25,0,46110540,3659,28428960,2244,14914
1112,32,38,25,0,46189500,3659,28464960,2243,14946
1113,27,39,25,0,46247220,3659,28521600,2245,14973
1114,25,38,25,0,46330260,3659,28608000,2248,14998
1115,38,38,25,0,46398240,3658,28640880,2247,15036
1116,33,37,25,0,46477140,3657,28689900,2246,15069
1117,30,40,25,0,46524120,3656,28751040,2248,15099
1118,27,35,25,0,46617060,3657,28841160,2252,15126
1119,28,40,25,0,46677960,3658,28957920,2258,15154
1120,31,37,25,0,46769040,3658,28996860,2257,15185
1121,20,36,25,0,46824600,3656,29201820,2269,15205
1122,30,39,25,0,46908420,3656,29297580,2272,15235
1123,31,40,25,0,46983660,3656,29309760,2269,15266
1124,34,40,25,0,47027160,3655,29369940,2271,15300
1125,26,39,25,0,47104860,3658,29388960,2271,15326
1126,24,38,25,0,47200800,3658,29475240,2273,15350
1127,35,40,25,0,47265540,3658,29497200,2271,15385
1128,28,40,25,0,47336820,3657,29561820,2272,15413
1129,32,40,25,0,47399340,3657,29574660,2270,15445
1130,39,40,25,0,47461440,3658,29580840,2268,15484
1131,30,40,25,0,47526420,3659,29648640,2271,15514
1132,25,40,25,0,47614860,3661,29700060,2272,15539
1133,36,38,25,0,47709660,3661,29802180,2276,15575
1134,30,40,25,0,47750820,3661,29810400,2274,15605
1135,35,40,25,0,47826600,3662,29839680,2274,15640
1136,34,40,25,0,47883360,3662,29843220,2271,15674
1137,32,40,25,0,47967840,3662,30141180,2290,15706
1138,27,39,25,0,48049740,3663,30155580,2288,15733
1139,34,40,25,0,48116820,3663,30172320,2286,15767
1140,31,39,25,0,48198240,3663,30279360,2290,15798
1141,26,39,25,0,48256560,3662,30368340,2293,15824
1142,27,37,25,0,48345780,3662,30449160,2296,15851
1143,33,37,25,0,48419580,3662,30615480,2304,15884
1144,32,39,25,0,48473160,3661,30629040,2302,15916
1145,31,40,25,0,48530940,3661,30660540,2302,15947
1146,34,40,25,0,48630360,3661,30811380,2308,15981
1147,30,40,25,0,48693600,3662,30834660,2308,16011
1148,38,37,25,0,48776040,3661,31012320,2316,16049
1149,32,40,25,0,48844500,3660,31035120,2315,16081
1150,38,40,25,0,48909120,3661,31057020,2313,16119
1151,32,39,25,0,48995400,3661,31106340,2313,16151
1152,33,40,25,0,49055520,3661,31129140,2312,16184
1153,23,34,25,0,49125420,3661,31235220,2317,16207
1154,22,32,25,0,49210560,3661,31727040,2350,16229
1155,35,38,25,0,49280040,3660,31775460,2349,16264
1156,36,40,25,0,49338600,3659,31803360,2348,16300
1157,23,25,25,0,49420020,3657,35158440,2592,16323
1158,30,39,25,0,49487460,3657,35163900,2587,16353
1159,29,39,25,0,49548780,3659,35182140,2586,16382
1160,32,40,25,0,49640100,3660,35206020,2584,16414
1161,24,38,25,0,49707360,3659,35243520,2582,16438
1162,37,40,25,0,49771140,3659,35303700,2583,16475
1163,32,40,25,0,49836060,3661,35314800,2582,16507
1164,33,39,25,0,49933500,3661,35792820,2612,16540
1165,23,38,25,0,49989840,3661,35804700,2610,16563
1166,28,31,25,0,50075400,3658,37110780,2700,16591
1167,33,40,25,0,50121420,3658,37117560,2696,16624
1168,31,39,25,0,50206320,3659,37139940,2694,16655
1169,30,29,25,0,50286060,3658,37342320,2706,16685
1170,33,39,25,0,50341560,3656,37493760,2711,16718
1171,23,40,25,0,50416320,3659,37531320,2712,16741
1172,37,38,25,0,50513100,3658,37600800,2711,16778
1173,29,39,25,0,50574600,3657,37611120,2707,16807
1174,31,39,25,0,50617980,3658,37632540,2707,16838
1175,24,34,25,0,50711460,3659,37698660,2709,16862
1176,17,8,25,0,50808000,3655,42323640,3038,16879
1177,4,0,12,13,50865600,3653,42498960,3049,16883
1178,7,0,12,13,50900220,3653,42498960,3048,16890
1179,4,0,10,15,50920200,3653,42498960,3047,16894
1180,10,0,17,8,50938080,3654,42498960,3044,16904
1181,4,0,11,14,50973360,3654,42498960,3044,16908
1182,7,0,12,13,50992620,3653,42498960,3042,16915
1183,8,0,9,16,51029340,3653,42498960,3040,16923
1184,9,0,11,14,51044280,3652,42498960,3038,16932
1185,4,0,10,15,51060780,3652,42498960,3038,16936
1186,12,0,14,11,51078240,3651,42498960,3035,16948
1187,7,0,13,12,51101640,3651,42498960,3033,16955
1188,7,0,9,16,51146460,3651,42498960,3032,16962
1189,10,0,14,11,51159780,3651,42498960,3030,16972
1190,5,0,12,13,51185400,3651,42498960,3029,16977
1191,6,0,9,16,51212280,3650,42498960,3027,16983
1192,14,0,16,9,51231300,3650,42498960,3024,16997
1193,7,0,11,14,51268440,3650,42498960,3023,17004
1194,8,0,10,15,51286140,3648,42498960,3021,17012
1195,6,0,14,11,51292080,3648,42498960,3020,17018
1196,6,0,12,13,51328740,3649,42498960,3019,17024
1197,6,0,12,13,51341940,3648,42498960,3017,17030
1198,8,0,13,12,51361440,3648,42498960,3016,17038
1199,6,0,10,15,51382800,3647,42498960,3014,17044
1200,4,0,7,18,51410820,3647,42498960,3013,17048
1201,5,0,7,18,51424380,3647,42498960,3012,17053
1202,7,0,11,14,51432000,3647,42498960,3011,17060
1203,4,0,11,14,51443640,3646,42498960,3010,17064
1204,8,0,13,12,51464880,3646,42498960,3008,17072
1205,8,0,11,14,51503640,3647,42498960,3007,17080
1206,9,0,14,11,51527400,3647,42498960,3005,17089
1207,12,0,15,10,51549420,3645,42498960,3002,17101
1208,4,0,12,13,51592560,3647,42498960,3001,17105
1209,10,0,15,10,51622920,3647,42498960,2999,17115
1210,10,0,16,9,51660000,3647,42498960,2997,17125
1211,10,0,12,13,51703200,3647,42498960,2995,17135
1212,12,0,15,10,51730140,3646,42498960,2992,17147
1213,4,0,14,11,51753420,3647,42498960,2992,17151
1214,7,0,16,9,51776940,3647,42498960,2990,17158
1215,11,0,18,7,51817680,3648,42498960,2988,17169
1216,10,0,14,11,51893640,3649,42498960,2986,17179
1217,10,0,17,8,51914220,3649,42498960,2984,17189
1218,9,0,12,13,51963840,3649,42498960,2982,17198
1219,6,0,14,11,51989340,3650,42498960,2980,17204
1220,8,0,14,11,52020660,3650,42498960,2979,17212
1221,10,0,18,7,52040220,3650,42498960,2977,17222
1222,5,0,8,17,52105560,3650,42498960,2976,17227
1223,5,0,9,16,52113540,3650,42498960,2975,17232
1224,7,0,11,14,52129320,3650,42498960,2973,17239
1225,5,0,11,14,52143420,3649,42498960,2972,17244
1226,6,0,13,12,52160220,3650,42498960,2971,17250
1227,6,0,11,14,52201080,3650,42498960,2970,17256
1228,6,0,11,14,52221780,3650,42498960,2968,17262
1229,4,0,12,13,52240560,3651,42498960,2968,17266
1230,7,0,14,11,52259880,3651,42498960,2966,17273
1231,5,0,12,13,52293720,3652,42498960,2965,17278
1232,10,0,14,11,52321380,3651,42498960,2963,17288
1233,8,0,12,13,52365900,3652,42498960,2961,17296
1234,5,0,15,10,52371840,3652,42498960,2960,17301
1235,11,0,16,9,52414380,3652,42498960,2958,17312
1236,15,0,21,4,52440960,3652,42498960,2955,17327
1237,10,0,17,8,52489800,3651,42498960,2953,17337
1238,19,0,24,1,52538940,3652,42498960,2949,17356
1239,8,0,12,13,52618080,3652,42500220,2947,17364
1240,9,0,14,11,52654380,3653,42500220,2946,17373
1241,10,0,17,8,52671420,3652,42500220,2944,17383
1242,10,0,14,11,52710660,3652,42500220,2942,17393
1243,5,0,13,12,52744440,3653,42500220,2940,17398
1244,7,0,14,11,52773360,3653,42500220,2939,17405
1245,9,0,16,9,52787880,3652,42500220,2937,17414
1246,4,0,9,16,52842240,3653,42500220,2936,17418
1247,8,0,9,16,52866480,3653,42500220,2935,17426
1248,3,0,9,16,52884060,3653,42500220,2934,17429
1249,5,0,11,14,52898760,3654,42500220,2933,17434
1250,11,0,12,13,52930800,3653,42500220,2931,17445
1251,9,0,10,15,52964280,3653,42500220,2929,17454
1252,4,0,13,12,52967760,3653,42500220,2928,17458
1253,10,0,18,7,52995300,3654,42500220,2926,17468
1254,7,0,15,10,53034840,3654,42500220,2925,17475
1255,10,0,14,11,53083860,3654,42500220,2923,17485
1256,7,0,12,13,53115720,3654,42500220,2921,17492
1257,6,0,10,15,53132700,3653,42500220,2920,17498
1258,11,0,14,11,53170800,3654,42500220,2918,17509
1259,13,0,20,5,53186460,3654,42500220,2915,17522
1260,15,0,19,6,53228700,3653,42500220,2912,17537
1261,16,0,22,3,53275560,3653,42500220,2909,17553
1262,8,0,11,14,53339280,3652,42500220,2908,17561
1263,9,0,10,15,53376300,3652,42500220,2906,17570
1264,14,0,18,7,53389260,3652,42500220,2903,17584
1265,9,0,21,4,53405040,3651,42500220,2901,17593
1266,6,0,10,15,53469600,3651,42500220,2900,17599
1267,12,0,11,14,53503920,3651,42500220,2898,17611
1268,11,0,12,13,53528280,3650,42500220,2896,17622
1269,2,0,9,16,53544780,3650,42500220,2895,17624
1270,13,0,15,10,53573640,3650,42500220,2893,17637
1271,4,0,14,11,53595840,3650,42500220,2892,17641
1272,5,0,10,15,53637900,3651,42500220,2891,17646
1273,4,0,10,15,53654040,3651,42500220,2890,17650
1274,9,0,15,10,53669580,3651,42500220,2888,17659
1275,7,0,16,9,53691180,3651,42500220,2887,17666
1276,5,0,13,12,53721720,3651,42500220,2886,17671
1277,7,0,13,12,53758740,3652,42500220,2885,17678
1278,10,0,16,9,53783160,3652,42500220,2883,17688
1279,3,0,14,11,53797260,3652,42500220,2882,17691
1280,8,0,14,11,53858700,3654,42500220,2880,17699
1281,8,0,15,10,53881440,3654,42500220,2879,17707
1282,14,0,18,7,53919840,3654,42500220,2876,17721
1283,12,0,14,11,53968560,3653,42500220,2874,17733
1284,6,0,11,14,54003840,3653,42500220,2873,17739
1285,10,0,15,10,54023220,3653,42500220,2871,17749
1286,7,0,13,12,54060540,3653,42500220,2869,17756
1287,5,0,10,15,54105180,3654,42500220,2868,17761
1288,8,0,10,15,54124080,3654,42500220,2867,17769
1289,8,0,11,14,54136440,3653,42500220,2865,17777
1290,9,0,13,12,54161040,3653,42500220,2864,17786
1291,10,0,11,14,54202860,3652,42500220,2862,17796
1292,9,0,13,12,54223320,3652,42500220,2860,17805
1293,5,0,14,11,54242820,3652,42500220,2859,17810
1294,3,0,9,16,54283080,3653,42500220,2858,17813
1295,2,0,10,15,54288660,3653,42500220,2858,17815
1296,11,0,17,8,54312000,3654,42500220,2856,17826
1297,1,0,15,10,54326040,3654,42500220,2856,17827
1298,11,0,13,12,54389880,3655,42500220,2854,17838
1299,5,0,11,14,54413280,3655,42500220,2853,17843
1300,5,0,8,17,54440520,3655,42500220,2852,17848
1301,5,0,8,17,54460620,3655,42500220,2851,17853
1302,8,0,12,13,54470100,3655,42500220,2849,17861
1303,6,0,15,10,54487920,3655,42500220,2848,17867
1304,8,0,15,10,54520200,3655,42500220,2847,17875
1305,9,0,19,6,54542100,3656,42500220,2845,17884
1306,9,0,19,6,54573240,3656,42500220,2843,17893
1307,11,0,14,11,54652680,3657,42500220,2841,17904
1308,15,0,15,10,54696720,3656,42500220,2838,17919
1309,8,0,14,11,54720120,3656,42500220,2837,17927
1310,9,0,15,10,54755220,3656,42500220,2835,17936
1311,9,0,15,10,54793020,3657,42500220,2833,17945
1312,8,0,15,10,54833520,3657,42500220,2832,17953
1313,6,0,12,13,54851820,3656,42500220,2831,17959
1314,10,0,14,11,54893400,3657,42500220,2829,17969
1315,5,0,8,17,54937680,3657,42500220,2828,17974
1316,4,0,8,17,54957060,3658,42500220,2827,17978
1317,6,0,7,18,54967560,3657,42500220,2826,17984
1318,5,0,10,15,54973320,3657,42500220,2825,17989
1319,12,0,15,10,54993060,3656,42500220,2823,18001
1320,7,0,13,12,55012080,3655,42500220,2821,18008
1321,7,0,12,13,55047840,3656,42500220,2820,18015
1322,4,0,8,17,55075980,3656,42500220,2819,18019
1323,2,0,8,17,55084740,3656,42500220,2819,18021
1324,9,0,14,11,55090740,3655,42500220,2817,18030
1325,7,0,12,13,55125660,3656,42500220,2816,18037
1326,10,0,14,11,55166460,3656,42500220,2814,18047
1327,6,0,13,12,55193160,3656,42500220,2813,18053
1328,7,0,15,10,55214580,3657,42500220,2812,18060
1329,11,0,16,9,55245960,3656,42500220,2810,18071
1330,13,0,19,6,55295880,3657,42500220,2807,18084
1331,10,0,18,7,55330800,3657,42500220,2805,18094
1332,5,0,15,10,55363620,3657,42500220,2804,18099
1333,12,0,14,11,55418100,3657,42500220,2802,18111
1334,14,0,15,10,55458780,3657,42500220,2800,18125
1335,10,0,15,10,55493880,3657,42500220,2798,18135
1336,7,0,11,14,55531920,3657,42500220,2796,18142
1337,4,0,11,14,55548780,3657,42500220,2796,18146
1338,10,0,15,10,55569900,3657,42500220,2794,18156
1339,7,0,11,14,55611000,3657,42500220,2793,18163
1340,3,0,11,14,55623720,3657,42500220,2792,18166
1341,7,0,12,13,55651800,3657,42500220,2791,18173
1342,5,0,8,17,55672560,3657,42500220,2790,18178
1343,3,0,9,16,55692000,3657,42500220,2789,18181
1344,5,0,8,17,55708980,3657,42500220,2788,18186
1345,7,0,11,14,55715160,3657,42500220,2787,18193
1346,8,0,12,13,55731240,3656,42500220,2786,18201
1347,2,0,9,16,55748460,3656,42500220,2785,18203
1348,5,0,11,14,55761120,3656,42500220,2784,18208
1349,5,0,12,13,55777560,3656,42500220,2783,18213
1350,5,0,11,14,55791600,3656,42500220,2783,18218
1351,5,0,12,13,55805940,3656,42500220,2782,18223
1352,1,0,12,13,55812660,3656,42500220,2781,18224
1353,4,0,11,14,55843140,3657,42500220,2781,18228
1354,12,0,15,10,55857480,3656,42500220,2779,18240
1355,11,0,18,7,55888560,3656,42500220,2777,18251
1356,7,0,17,8,55924800,3656,42500220,2775,18258
1357,11,0,17,8,55967820,3656,42500220,2773,18269
1358,8,0,14,11,56010420,3656,42500220,2772,18277
1359,16,0,20,5,56042520,3656,42500220,2769,18293
1360,14,0,14,11,56096820,3655,42500220,2766,18307
1361,10,0,17,8,56123640,3655,42500220,2765,18317
1362,10,0,15,10,56156220,3654,42500220,2763,18327
1363,9,0,17,8,56181660,3654,42500220,2761,18336
1364,6,0,14,11,56219220,3655,42500220,2760,18342
1365,8,0,15,10,56244960,3655,42500220,2759,18350
1366,4,0,11,14,56274240,3655,42500220,2758,18354
1367,7,0,14,11,56296860,3655,42500220,2757,18361
1368,7,0,13,12,56325360,3655,42500220,2755,18368
1369,6,0,12,13,56351700,3655,42500220,2754,18374
1370,6,0,14,11,56366100,3655,42500220,2753,18380
1371,6,0,15,10,56386080,3655,42500220,2752,18386
1372,4,0,12,13,56418840,3656,42500220,2752,18390
1373,8,0,12,13,56441460,3655,42500220,2750,18398
1374,7,0,15,10,56458680,3655,42500220,2749,18405
1375,10,0,16,9,56485800,3655,42500220,2747,18415
1376,8,0,17,8,56518620,3656,42500220,2746,18423
1377,6,0,14,11,56556540,3656,42500220,2745,18429
1378,6,0,13,12,56581020,3656,42500220,2744,18435
1379,11,0,11,14,56609100,3655,42500220,2742,18446
1380,14,0,17,8,56624340,3654,42500220,2739,18460
1381,10,0,18,7,56640120,3653,42500220,2737,18470
1382,13,0,21,4,56681220,3653,42500220,2735,18483
1383,14,0,23,2,56748240,3654,42500220,2733,18497
1384,6,0,18,7,56788260,3654,42500220,2732,18503
1385,14,0,18,7,56849940,3655,42500220,2729,18517
1386,5,0,12,13,56892840,3655,42500220,2728,18522
1387,10,0,11,14,56920980,3654,42500220,2726,18532
1388,5,0,13,12,56930340,3654,42500220,2726,18537
1389,10,0,17,8,56951700,3654,42500220,2724,18547
1390,5,0,15,10,56975820,3654,42500220,2723,18552
1391,4,0,13,12,57008880,3655,42500220,2722,18556
1392,3,0,9,16,57038820,3655,42500220,2722,18559
1393,4,0,8,17,57047880,3655,42500220,2721,18563
1394,4,0,10,15,57053880,3654,42500220,2720,18567
1395,7,0,14,11,57059640,3654,42500220,2719,18574
1396,4,0,12,13,57068760,3653,42500220,2718,18578
1397,9,0,16,9,57089580,3653,42500220,2717,18587
1398,6,0,12,13,57126660,3654,42500220,2716,18593
1399,5,0,13,12,57146640,3654,42500220,2715,18598
1400,9,0,17,8,57161100,3654,42500220,2713,18607
1401,11,0,22,3,57174780,3653,42500220,2712,18618
1402,6,0,19,6,57225780,3654,42500220,2710,18624
1403,13,0,21,4,57279060,3655,42500220,2708,18637
1404,9,0,14,11,57340800,3655,42500220,2707,18646
1405,6,0,14,11,57370140,3656,42500220,2706,18652
1406,8,0,13,12,57403800,3656,42500220,2704,18660
1407,9,0,16,9,57414540,3655,42500220,2703,18669
1408,8,0,14,11,57450480,3655,42500220,2701,18677
1409,9,0,17,8,57467760,3655,42500220,2700,18686
1410,11,0,14,11,57511680,3654,42500220,2698,18697
1411,6,0,13,12,57543000,3655,42500220,2697,18703
1412,7,0,13,12,57560040,3654,42500220,2696,18710
1413,6,0,13,12,57577620,3654,42500220,2695,18716
1414,3,0,13,12,57592380,3654,42500220,2694,18719
1415,6,0,12,13,57615660,3654,42500220,2693,18725
1416,2,0,8,17,57635460,3654,42500220,2693,18727
1417,5,0,12,13,57642600,3654,42500220,2692,18732
1418,7,0,14,11,57651480,3653,42500220,2691,18739
1419,8,0,14,11,57687060,3654,42500220,2689,18747
1420,7,0,13,12,57716700,3654,42500220,2688,18754
1421,3,0,11,14,57740040,3654,42500220,2688,18757
1422,3,0,9,16,57752460,3654,42500220,2687,18760
1423,6,0,11,14,57766380,3654,42500220,2686,18766
1424,11,0,14,11,57782040,3653,42500220,2684,18777
1425,9,0,16,9,57805560,3653,42500220,2683,18786
1426,6,0,14,11,57835740,3653,42500220,2682,18792
1427,19,0,21,4,57863220,3652,42500220,2679,18811
1428,14,0,21,4,57908580,3651,42500220,2676,18825
1429,6,0,14,11,57968280,3652,42500220,2675,18831
1430,16,0,20,5,58004700,3652,42500220,2672,18847
1431,14,0,21,4,58041840,3652,42500220,2670,18861
1432,9,0,16,9,58097220,3652,42500220,2669,18870
1433,14,0,18,7,58127940,3651,42500220,2666,18884
1434,12,0,20,5,58160100,3651,42500220,2664,18896
1435,8,0,16,9,58210080,3651,42500220,2663,18904
1436,5,0,16,9,58226520,3651,42500220,2662,18909
1437,3,0,10,15,58268820,3652,42500220,2662,18912
1438,5,0,12,13,58283580,3652,42500220,2661,18917
1439,3,0,10,15,58298520,3652,42500220,2660,18920
1440,4,0,10,15,58311660,3652,42500220,2660,18924
1441,6,0,11,14,58333560,3652,42500220,2659,18930
1442,8,0,13,12,58351500,3651,42500220,2657,18938
1443,7,0,15,10,58369380,3651,42500220,2656,18945
1444,7,0,13,12,58407000,3652,42500220,2655,18952
1445,8,0,15,10,58428540,3652,42500220,2654,18960
1446,5,0,11,14,58456020,3651,42500220,2653,18965
1447,10,0,14,11,58469940,3651,42500220,2651,18975
1448,7,0,13,12,58486320,3650,42500220,2650,18982
1449,13,0,19,6,58512900,3650,42500220,2648,18995
1450,8,0,17,8,58546320,3650,42500220,2646,19003
1451,10,0,16,9,58581720,3649,42500220,2645,19013
1452,8,0,15,10,58614600,3649,42500220,2644,19021
1453,3,0,14,11,58636980,3650,42500220,2643,19024
1454,12,0,16,9,58671840,3650,42500220,2641,19036
1455,17,0,25,0,58687200,3649,42500460,2638,19053
1456,11,0,22,3,58744380,3649,42501300,2637,19064
1457,15,0,18,7,58815480,3649,42501420,2634,19079
1458,9,0,14,11,58863180,3649,42501420,2633,19088
1459,8,0,15,10,58881540,3649,42501420,2631,19096
1460,8,0,12,13,58908420,3648,42501420,2630,19104
1461,3,0,10,15,58925460,3648,42501420,2630,19107
1462,3,0,12,13,58928760,3648,42501420,2629,19110
1463,7,0,17,8,58930200,3648,42501420,2628,19117
1464,4,0,13,12,58969440,3648,42501420,2627,19121
1465,4,0,14,11,58983000,3649,42501420,2627,19125
1466,7,0,15,10,59010420,3649,42501420,2625,19132
1467,4,0,10,15,59043540,3649,42501420,2625,19136
1468,5,0,13,12,59057820,3649,42501420,2624,19141
1469,7,0,16,9,59069040,3649,42501420,2623,19148
1470,17,4,25,0,59091420,3650,42501540,2621,19165
1471,12,1,25,0,59158380,3650,42510900,2619,19177
1472,8,0,13,12,59239980,3651,42512820,2618,19185
1473,8,0,15,10,59263320,3651,42512820,2616,19193
1474,8,0,10,15,59296320,3650,42512820,2615,19201
1475,11,0,18,7,59312520,3650,42512820,2613,19212
1476,8,0,16,9,59336940,3649,42512820,2612,19220
1477,12,0,17,8,59364300,3649,42512820,2610,19232
1478,5,0,12,13,59411820,3649,42512820,2609,19237
1479,9,0,14,11,59429460,3649,42512820,2608,19246
1480,19,0,24,1,59459160,3649,42512820,2605,19265
1481,10,0,23,2,59506500,3649,42514560,2603,19275
1482,4,0,15,10,59555520,3649,42514560,2603,19279
1483,8,0,16,9,59604540,3651,42514560,2601,19287
1484,4,0,14,11,59635740,3651,42514560,2601,19291
1485,9,0,16,9,59665500,3652,42514560,2599,19300
1486,9,0,15,10,59699100,3651,42514560,2598,19309
1487,3,0,13,12,59718060,3652,42514560,2597,19312
1488,4,0,12,13,59749740,3652,42514560,2597,19316
1489,4,0,11,14,59775240,3653,42514560,2596,19320
1490,7,0,13,12,59786640,3652,42514560,2595,19327
1491,5,0,14,11,59813400,3653,42514560,2594,19332
1492,3,0,15,10,59820360,3653,42514560,2594,19335
1493,7,0,14,11,59851140,3653,42514560,2593,19342
1494,10,0,14,11,59888760,3653,42514560,2591,19352
1495,8,0,13,12,59920680,3653,42514560,2590,19360
1496,13,0,15,10,59940000,3652,42514560,2588,19373
1497,11,0,18,7,59964660,3652,42514560,2586,19384
1498,8,0,16,9,60003600,3652,42514560,2585,19392
1499,13,0,20,5,60032580,3652,42514560,2583,19405
1500,10,0,18,7,60082920,3652,42514560,2581,19415
1501,10,0,18,7,60115620,3652,42514560,2580,19425
1502,10,0,18,7,60153780,3652,42514560,2578,19435
1503,5,0,15,10,60180840,3652,42514560,2577,19440
1504,9,0,14,11,60224700,3652,42514560,2576,19449
1505,6,0,15,10,60242820,3652,42514560,2575,19455
1506,14,0,17,8,60275880,3651,42514560,2573,19469
1507,9,0,16,9,60303360,3651,42514560,2571,19478
1508,4,0,13,12,60330540,3651,42514560,2571,19482
1509,6,0,11,14,60360720,3651,42514560,2570,19488
1510,12,0,17,8,60382860,3651,42514560,2568,19500
1511,5,0,13,12,60402540,3650,42514560,2567,19505
1512,10,0,15,10,60424200,3650,42514560,2566,19515
1513,3,0,11,14,60457320,3650,42514560,2565,19518
1514,6,0,10,15,60481860,3650,42514560,2564,19524
1515,9,0,13,12,60491940,3650,42514560,2563,19533
1516,8,0,16,9,60499380,3649,42514560,2562,19541
1517,8,0,14,11,60535980,3649,42514560,2560,19549
1518,7,0,15,10,60552780,3649,42514560,2559,19556
1519,6,0,13,12,60578520,3648,42514560,2558,19562
1520,14,0,22,3,60591240,3648,42514560,2556,19576
1521,11,0,18,7,60634620,3647,42514560,2554,19587
1522,14,0,17,8,60688260,3647,42514560,2552,19601
1523,8,0,16,9,60714240,3647,42514560,2551,19609
1524,11,0,17,8,60749460,3647,42514560,2549,19620
1525,17,0,19,6,60786300,3646,42514560,2547,19637
1526,11,0,17,8,60832800,3646,42514560,2545,19648
1527,11,0,17,8,60870600,3646,42514560,2543,19659
1528,14,0,19,6,60906480,3645,42514560,2541,19673
1529,9,0,17,8,60954960,3646,42514560,2540,19682
1530,5,0,18,7,60973260,3646,42514560,2539,19687
1531,6,0,16,9,61012260,3646,42514560,2538,19693
1532,4,0,10,15,61061700,3647,42514560,2538,19697
1533,5,0,10,15,61080000,3647,42514560,2537,19702
1534,3,0,8,17,61098720,3647,42514560,2536,19705
1535,7,0,12,13,61101240,3647,42514560,2535,19712
1536,4,0,12,13,61114740,3647,42514560,2535,19716
1537,6,0,14,11,61130820,3647,42514560,2534,19722
1538,6,0,15,10,61150920,3647,42514560,2533,19728
1539,2,0,12,13,61170120,3647,42514560,2533,19730
1540,7,0,14,11,61197240,3647,42514560,2532,19737
1541,8,0,15,10,61214160,3647,42514560,2530,19745
1542,4,0,14,11,61243500,3648,42514560,2530,19749
1543,9,0,14,11,61275840,3648,42514560,2528,19758
1544,5,0,14,11,61300260,3648,42514560,2528,19763
1545,11,0,19,6,61324800,3648,42514560,2526,19774
1546,12,0,24,1,61345500,3648,42514560,2524,19786
1547,8,0,19,6,61400460,3648,42514680,2523,19794
1548,13,0,19,6,61460460,3649,42514680,2521,19807
1549,8,0,16,9,61494600,3649,42514680,2520,19815
1550,18,4,25,0,61511340,3649,42515400,2517,19833
1551,7,0,22,3,61576860,3649,42519300,2516,19840
1552,7,0,17,8,61656240,3651,42519300,2515,19847
1553,10,0,16,9,61707840,3652,42519300,2514,19857
1554,12,0,18,7,61735980,3652,42519300,2512,19869
1555,8,0,16,9,61778520,3652,42519300,2511,19877
1556,9,0,16,9,61815780,3652,42519300,2510,19886
1557,4,0,10,15,61849560,3652,42519300,2509,19890
1558,5,0,12,13,61854120,3652,42519300,2508,19895
1559,6,0,15,10,61865760,3652,42519300,2507,19901
1560,6,0,11,14,61900200,3652,42519300,2507,19907
1561,3,0,8,17,61924260,3652,42519300,2506,19910
1562,3,0,10,15,61930680,3652,42519300,2506,19913
1563,5,0,13,12,61937460,3652,42519300,2505,19918
1564,9,0,13,12,61966020,3652,42519300,2504,19927
1565,4,0,10,15,61990560,3652,42519300,2503,19931
1566,5,0,13,12,61997400,3652,42519300,2502,19936
1567,6,0,12,13,62024400,3652,42519300,2501,19942
1568,8,0,13,12,62040540,3651,42519300,2500,19950
1569,11,0,13,12,62063880,3650,42519300,2499,19961
1570,9,0,15,10,62074620,3649,42519300,2497,19970
1571,17,0,21,4,62111400,3649,42519300,2495,19987
1572,7,0,17,8,62145960,3649,42519300,2494,19994
1573,8,0,14,11,62192820,3649,42519300,2493,20002
1574,9,0,18,7,62211000,3649,42519300,2491,20011
1575,10,0,17,8,62266680,3650,42519300,2490,20021
1576,7,0,15,10,62296260,3650,42519300,2489,20028
1577,12,0,14,11,62336400,3649,42519300,2487,20040
1578,7,0,14,11,62357160,3649,42519300,2486,20047
1579,10,0,17,8,62378160,3649,42519300,2485,20057
1580,5,0,14,11,62402400,3649,42519300,2484,20062
1581,8,0,14,11,62428020,3648,42519300,2483,20070
1582,3,0,12,13,62457240,3649,42519300,2482,20073
1583,6,0,14,11,62477880,3649,42519300,2481,20079
1584,5,0,12,13,62504040,3649,42519300,2481,20084
1585,4,0,12,13,62518920,3649,42519300,2480,20088
1586,6,0,13,12,62530980,3649,42519300,2479,20094
1587,3,0,11,14,62562360,3650,42519300,2479,20097
1588,3,0,11,14,62576760,3650,42519300,2478,20100
1589,16,0,16,9,62601480,3649,42519300,2476,20116
1590,9,0,14,11,62633640,3649,42519300,2475,20125
1591,8,0,17,8,62650020,3649,42519300,2474,20133
1592,8,0,15,10,62683980,3648,42519300,2472,20141
1593,8,0,14,11,62712660,3648,42519300,2471,20149
1594,12,0,20,5,62728020,3648,42519300,2470,20161
1595,8,0,15,10,62773260,3648,42519300,2468,20169
1596,17,0,17,8,62819940,3647,42519300,2466,20186
1597,14,0,20,5,62844600,3646,42519300,2464,20200
1598,10,0,22,3,62882580,3647,42519300,2463,20210
1599,11,0,20,5,62926020,3647,42519300,2461,20221
1600,12,0,22,3,62968020,3647,42519300,2459,20233
1601,10,0,18,7,63015000,3647,42519300,2458,20243
1602,7,0,12,13,63070980,3647,42519300,2457,20250
1603,10,0,17,8,63082200,3647,42519300,2455,20260
1604,6,0,15,10,63108300,3647,42519300,2455,20266
1605,6,0,14,11,63134820,3647,42519300,2454,20272
1606,4,0,11,14,63162480,3647,42519300,2453,20276
1607,4,0,11,14,63166620,3646,42519300,2453,20280
1608,4,0,10,15,63186240,3646,42519300,2452,20284
1609,5,0,10,15,63203160,3646,42519300,2451,20289
1610,1,0,8,17,63210360,3646,42519300,2451,20290
1611,4,0,10,15,63211860,3646,42519300,2451,20294
1612,4,0,10,15,63225600,3646,42519300,2450,20298
1613,5,0,9,16,63240900,3645,42519300,2449,20303
1614,9,0,14,11,63252420,3645,42519300,2448,20312
1615,4,0,12,13,63265200,3644,42519300,2447,20316
1616,6,0,13,12,63288900,3645,42519300,2447,20322
1617,10,0,15,10,63309720,3644,42519300,2445,20332
1618,8,0,14,11,63336300,3644,42519300,2444,20340
1619,14,0,18,7,63364440,3643,42519300,2442,20354
1620,11,0,13,12,63409380,3643,42519300,2441,20365
1621,13,0,13,12,63440340,3642,42519300,2439,20378
1622,7,0,16,9,63450660,3641,42519300,2438,20385
1623,11,0,17,8,63490980,3642,42519300,2436,20396
1624,5,0,17,8,63510180,3642,42519300,2436,20401
1625,10,0,18,7,63549900,3642,42519300,2434,20411
1626,10,0,16,9,63596220,3642,42519300,2433,20421
1627,10,0,18,7,63630720,3643,42519300,2431,20431
1628,5,0,13,12,63670200,3643,42519300,2431,20436
1629,6,0,12,13,63694860,3643,42519300,2430,20442
1630,5,0,12,13,63719040,3643,42519300,2429,20447
1631,3,0,12,13,63729600,3643,42519300,2429,20450
1632,5,0,11,14,63751860,3643,42519300,2428,20455
1633,6,0,12,13,63758460,3642,42519300,2427,20461
1634,4,0,14,11,63761640,3642,42519300,2427,20465
1635,5,0,12,13,63792060,3642,42519300,2426,20470
1636,4,0,8,17,63821220,3642,42519300,2425,20474
1637,7,0,14,11,63824100,3642,42519300,2424,20481
1638,1,0,9,16,63855000,3643,42519300,2424,20482
1639,5,0,12,13,63867120,3643,42519300,2424,20487
1640,12,0,17,8,63882600,3643,42519300,2422,20499
1641,9,0,18,7,63906180,3642,42519300,2421,20508
1642,7,0,15,10,63949260,3643,42519300,2420,20515
1643,9,0,13,12,63987660,3643,42519300,2419,20524
1644,10,0,16,9,64015260,3643,42519300,2417,20534
1645,14,0,20,5,64037940,3642,42519300,2415,20548
1646,10,0,20,5,64069560,3642,42519300,2414,20558
1647,11,0,18,7,64123440,3642,42519300,2412,20569
1648,8,0,15,10,64164900,3642,42519300,2411,20577
1649,9,0,18,7,64190520,3642,42519300,2410,20586
1650,9,0,17,8,64225080,3642,42519300,2409,20595
1651,11,0,16,9,64269120,3642,42519300,2407,20606
1652,7,0,16,9,64291020,3642,42519300,2406,20613
1653,6,0,11,14,64333320,3642,42519300,2406,20619
1654,9,0,12,13,64353660,3642,42519300,2404,20628
1655,3,0,11,14,64370760,3642,42519300,2404,20631
1656,5,0,13,12,64386060,3642,42519300,2403,20636
1657,0,0,10,15,64397040,3642,42519300,2403,20636
1658,13,0,17,8,64414680,3642,42519300,2401,20649
1659,7,0,18,7,64433460,3642,42519300,2400,20656
1660,6,0,13,12,64479240,3642,42519300,2400,20662
1661,5,0,13,12,64500360,3642,42519300,2399,20667
1662,4,0,13,12,64519020,3642,42519300,2398,20671
1663,5,0,17,8,64524060,3642,42519300,2398,20676
1664,5,0,10,15,64577340,3643,42519300,2397,20681
1665,9,0,13,12,64595640,3643,42519300,2396,20690
1666,6,0,17,8,64600920,3643,42519300,2395,20696
1667,13,0,16,9,64650660,3643,42519300,2393,20709
1668,15,0,19,6,64672020,3641,42519300,2391,20724
1669,11,0,22,3,64709160,3642,42519300,2390,20735
1670,11,0,20,5,64749060,3641,42519300,2388,20746
1671,14,0,20,5,64814820,3642,42519300,2386,20760
1672,6,0,14,11,64850820,3642,42519300,2386,20766
1673,9,0,13,12,64874580,3641,42519300,2384,20775
1674,13,0,14,11,64916820,3641,42519300,2383,20788
1675,13,0,19,6,64936440,3640,42519300,2381,20801
1676,13,0,20,5,64971360,3640,42519300,2379,20814
1677,7,0,16,9,65008860,3640,42519300,2378,20821
1678,7,0,14,11,65049480,3640,42519300,2377,20828
1679,7,0,15,10,65074560,3640,42519300,2376,20835
1680,7,0,15,10,65100180,3640,42519300,2376,20842
1681,9,0,17,8,65125260,3640,42519300,2374,20851
1682,16,0,25,0,65152740,3640,42519300,2372,20867
1683,21,1,25,0,65220480,3640,42521220,2370,20888
1684,25,10,25,0,65272620,3640,42525960,2367,20913
1685,36,38,25,0,65323440,3641,42533220,2362,20949
1686,26,40,25,0,65390700,3642,42547680,2361,20975
1687,28,40,25,0,65453040,3644,42580080,2362,21003
1688,28,39,25,0,65537400,3645,42653100,2364,21031
1689,28,37,25,0,65616720,3646,42813120,2371,21059
1690,33,37,25,0,65671380,3645,42857280,2370,21092
1691,27,38,25,0,65723700,3644,42909480,2371,21119
1692,22,39,25,0,65790960,3644,42948300,2370,21141
1693,36,40,25,0,65855340,3644,42992040,2370,21177
1694,44,40,25,0,65926080,3644,43026120,2370,21221
1695,33,38,25,0,65984760,3643,43045500,2368,21254
1696,28,40,25,0,66043680,3643,43073760,2367,21282
1697,37,40,25,0,66117060,3644,43116780,2368,21319
1698,33,40,25,0,66175620,3645,43141860,2368,21352
1699,34,40,25,0,66251460,3645,43195920,2368,21386
1700,39,40,25,0,66305700,3645,43247460,2369,21425
1701,36,38,25,0,66383340,3645,43303500,2369,21461
1702,28,40,25,0,66430320,3646,43319460,2369,21489
1703,33,38,25,0,66498780,3645,43450080,2373,21522
1704,37,40,25,0,66582900,3645,43537560,2375,21559
1705,42,40,25,0,66631440,3645,43555740,2374,21601
1706,32,40,25,0,66708900,3645,43659780,2377,21633
1707,27,35,25,0,66769800,3644,43703820,2377,21660
1708,32,40,25,0,66834180,3643,43973820,2389,21692
1709,34,40,25,0,66876420,3644,43989060,2388,21726
1710,35,39,25,0,66966360,3646,44035140,2389,21761
1711,37,39,25,0,67016160,3646,44043360,2388,21798
1712,33,40,25,0,67067760,3647,44058180,2387,21831
1713,28,31,25,0,67150260,3647,44292960,2398,21859
1714,26,32,25,0,67209540,3645,45007680,2433,21885
1715,25,39,25,0,67299120,3646,45015000,2430,21910
1716,32,40,25,0,67348140,3646,45021120,2429,21942
1717,26,38,25,0,67402320,3647,45038220,2428,21968
1718,26,40,25,0,67473060,3647,45340260,2442,21994
1719,28,39,25,0,67541220,3647,45354000,2441,22022
1720,22,40,25,0,67597200,3648,45412320,2442,22044
1721,38,40,25,0,67668840,3649,45452220,2443,22082
1722,34,40,25,0,67736760,3649,45471780,2441,22116
1723,27,40,25,0,67782300,3649,45559440,2444,22143
1724,32,38,25,0,67854360,3650,45584880,2443,22175
1725,37,40,25,0,67918980,3650,45630000,2444,22212
1726,26,40,25,0,67980000,3650,45688440,2445,22238
1727,31,39,25,0,68058600,3651,45713640,2444,22269
1728,34,40,25,0,68110140,3651,45737160,2443,22303
1729,31,40,25,0,68203740,3651,45813360,2444,22334
1730,26,40,25,0,68244360,3651,45850620,2444,22360
1731,18,38,25,0,68321580,3652,45864480,2443,22378
1732,31,37,25,0,68390700,3652,46002600,2448,22409
1733,25,38,25,0,68463540,3652,46013280,2446,22434
1734,38,40,25,0,68511120,3652,46077600,2448,22472
1735,28,40,25,0,68585580,3651,46453200,2465,22500
1736,30,40,25,0,68636280,3652,46474020,2464,22530
1737,22,38,25,0,68713500,3653,46488960,2463,22552
1738,29,38,25,0,68779320,3654,46513380,2462,22581
1739,46,39,25,0,68836740,3653,46567020,2463,22627
1740,32,40,25,0,68900520,3653,46584960,2461,22659
1741,29,40,25,0,68961300,3653,46595640,2460,22688
1742,29,38,25,0,69028740,3653,46717860,2464,22717
1743,34,39,25,0,69092040,3654,46746180,2464,22751
1744,31,40,25,0,69167640,3653,46814520,2464,22782
1745,23,39,25,0,69225360,3654,46848600,2464,22805
1746,33,37,25,0,69310860,3654,46913100,2465,22838
1747,25,40,25,0,69356580,3654,46923600,2463,22863
1748,29,39,25,0,69402960,3654,46955220,2464,22892
1749,29,40,25,0,69483720,3655,47026140,2466,22921
1750,32,39,25,0,69550980,3656,47048040,2465,22953
1751,38,40,25,0,69609180,3656,47107980,2466,22991
1752,29,39,25,0,69681180,3657,47118180,2464,23020
1753,28,40,25,0,69751200,3657,47153400,2464,23048
1754,32,40,25,0,69821640,3655,47708340,2489,23080
1755,31,38,25,0,69883440,3655,47764560,2490,23111
1756,33,40,25,0,69934800,3655,47776320,2488,23144
1757,22,33,25,0,70005960,3654,48122280,2505,23166
1758,37,38,25,0,70076820,3654,48139860,2502,23203
1759,36,40,25,0,70145760,3654,48166980,2501,23239
1760,28,38,25,0,70201560,3654,48173700,2499,23267
1761,28,35,25,0,70275780,3654,48279960,2503,23295
1762,31,38,25,0,70336500,3653,48326940,2502,23326
1763,22,39,25,0,70388520,3653,48354780,2501,23348
1764,31,35,25,0,70466640,3654,48403380,2502,23379
1765,26,40,25,0,70534500,3654,48727080,2516,23405
1766,31,39,25,0,70600020,3653,48741120,2514,23436
1767,26,36,25,0,70664340,3652,48843180,2517,23462
1768,38,40,25,0,70720380,3652,48850560,2514,23500
1769,24,40,25,0,70765860,3652,48866520,2513,23524
1770,35,40,25,0,70860600,3652,48959940,2515,23559
1771,33,39,25,0,70916640,3651,49003140,2515,23592
1772,34,40,25,0,70976580,3651,49018680,2514,23626
1773,33,40,25,0,71038860,3652,49066860,2514,23659
1774,42,40,25,0,71106300,3652,49130340,2515,23701
1775,34,40,25,0,71164260,3652,49161240,2514,23735
1776,32,40,25,0,71240220,3651,49240200,2515,23767
1777,26,39,25,0,71298180,3651,49272900,2515,23793
1778,39,39,25,0,71374260,3651,49335180,2515,23832
1779,26,40,25,0,71431380,3650,49355280,2514,23858
1780,30,40,25,0,71472480,3651,49392300,2515,23888
1781,28,40,25,0,71546160,3651,49399980,2513,23916
1782,26,39,25,0,71630220,3652,49455240,2513,23942
1783,33,38,25,0,71690700,3651,49558140,2516,23975
1784,27,40,25,0,71763600,3651,49602420,2515,24002
1785,24,33,25,0,71827080,3650,49831020,2525,24026
1786,28,40,25,0,71880000,3651,49840020,2523,24054
1787,27,39,25,0,71945640,3650,49925880,2525,24081
1788,34,38,25,0,72008580,3650,50064060,2530,24115
1789,36,40,25,0,72083820,3651,50174820,2533,24151
1790,28,39,25,0,72146160,3650,50221740,2533,24179
1791,35,39,25,0,72208260,3651,50228340,2531,24214
1792,31,39,25,0,72283260,3652,50262000,2531,24245
1793,36,40,25,0,72337500,3651,50279100,2530,24281
1794,27,38,25,0,72401280,3651,50345760,2531,24308
1795,30,37,25,0,72471960,3650,50442600,2533,24338
1796,29,40,25,0,72525420,3650,50483220,2532,24367
1797,24,31,25,0,72618300,3649,51030240,2557,24391
1798,33,40,25,0,72665940,3649,51036000,2555,24424
1799,26,40,25,0,72717360,3649,51055680,2554,24450
1800,36,40,25,0,72794880,3650,51080520,2553,24486
1801,34,38,25,0,72851460,3650,51086760,2552,24520
1802,22,40,25,0,72921540,3651,51107700,2550,24542
1803,30,37,25,0,72984360,3651,51135480,2550,24572
1804,24,40,25,0,73049040,3651,51221220,2552,24596
1805,32,36,25,0,73123800,3651,51324660,2555,24628
1806,35,39,25,0,73180860,3651,51330060,2553,24663
1807,31,38,25,0,73254660,3651,51478980,2558,24694
1808,31,40,25,0,73304760,3650,51525720,2557,24725
1809,32,37,25,0,73382340,3650,51541800,2556,24757
1810,28,40,25,0,73448760,3650,51575280,2555,24785
1811,26,36,25,0,73501860,3649,51632760,2556,24811
1812,25,34,25,0,73591560,3649,51757200,2559,24836
1813,27,39,25,0,73623960,3648,51764520,2557,24863
1814,26,40,25,0,73703940,3649,51775080,2555,24889
1815,37,40,25,0,73765140,3649,51817560,2555,24926
1816,25,40,25,0,73802100,3649,51826860,2554,24951
1817,30,40,25,0,73912080,3650,51974880,2558,24981
1818,35,39,25,0,73960920,3650,52022640,2559,25016
1819,31,40,25,0,74032800,3649,52074900,2559,25047
1820,26,40,25,0,74085120,3650,52098000,2558,25073
1821,29,39,25,0,74126100,3650,52102380,2557,25102
1822,32,40,25,0,74212740,3651,52135320,2557,25134
1823,28,39,25,0,74291580,3651,52194240,2557,25162
1824,32,40,25,0,74344560,3650,52247460,2557,25194
1825,35,38,25,0,74424600,3650,52298400,2557,25229
1826,32,34,25,0,74494320,3649,52427160,2561,25261
1827,31,40,25,0,74529720,3648,52839480,2578,25292
1828,30,39,25,0,74608500,3649,52893360,2579,25322
1829,36,40,25,0,74676720,3649,52946160,2580,25358
1830,31,40,25,0,74733060,3649,52955520,2578,25389
1831,27,38,25,0,74798100,3649,53012340,2578,25416
1832,32,40,25,0,74853960,3649,53041080,2578,25448
1833,29,40,25,0,74932620,3649,53074980,2577,25477
1834,32,36,25,0,75009180,3649,53153460,2578,25509
1835,35,40,25,0,75067140,3648,53192340,2577,25544
1836,29,34,25,0,75143940,3648,53253120,2578,25573
1837,32,40,25,0,75197760,3646,53668800,2594,25605
1838,36,40,25,0,75247380,3646,53686440,2593,25641
1839,27,37,25,0,75334020,3646,53752080,2594,25668
1840,29,40,25,0,75374880,3646,53770020,2593,25697
1841,29,38,25,0,75459660,3646,53831280,2594,25726
1842,44,40,25,0,75509520,3646,53839740,2592,25770
1843,32,40,25,0,75574860,3646,53895720,2592,25802
1844,33,40,25,0,75643200,3645,53920440,2591,25835
1845,35,40,25,0,75686280,3646,53930040,2590,25870
1846,29,40,25,0,75754740,3646,53986920,2591,25899
1847,19,16,25,0,75867900,3645,62272980,2986,25918
1848,16,0,21,4,75913440,3641,65146980,3121,25934
1849,8,0,19,6,75950700,3641,65146980,3120,25942
1850,5,0,13,12,75996420,3641,65146980,3119,25947
1851,3,0,11,14,76024860,3642,65146980,3119,25950
1852,7,0,14,11,76039800,3642,65146980,3118,25957
1853,7,0,13,12,76058700,3641,65146980,3117,25964
1854,8,0,14,11,76082940,3641,65146980,3116,25972
1855,10,0,19,6,76103580,3641,65146980,3114,25982
1856,11,0,22,3,76133520,3641,65146980,3113,25993
1857,7,0,14,11,76192740,3642,65146980,3112,26000
1858,13,0,22,3,76210860,3642,65146980,3110,26013
1859,5,0,14,11,76264380,3642,65146980,3109,26018
1860,9,0,17,8,76285080,3642,65146980,3108,26027
1861,11,0,15,10,76320780,3641,65146980,3106,26038
1862,16,0,21,4,76337160,3640,65146980,3104,26054
1863,10,0,13,12,76401900,3640,65146980,3102,26064
1864,12,0,15,10,76433760,3640,65146980,3100,26076
1865,16,0,20,5,76456380,3639,65146980,3098,26092
1866,13,0,18,7,76497240,3639,65146980,3096,26105
1867,9,0,16,9,76536960,3639,65146980,3095,26114
1868,8,0,14,11,76579980,3639,65146980,3093,26122
1869,7,0,12,13,76609860,3639,65146980,3092,26129
1870,8,0,12,13,76643160,3639,65146980,3091,26137
1871,6,0,14,11,76649460,3639,65146980,3090,26143
1872,6,0,13,12,76672440,3638,65146980,3090,26149
1873,9,0,17,8,76687740,3638,65146980,3088,26158
1874,6,0,16,9,76720500,3639,65146980,3087,26164
1875,6,0,13,12,76764960,3639,65146980,3086,26170
1876,7,0,15,10,76773180,3639,65146980,3085,26177
1877,7,0,19,6,76798920,3639,65146980,3084,26184
1878,3,0,11,14,76853100,3640,65146980,3084,26187
1879,14,0,19,6,76871880,3640,65146980,3082,26201
1880,12,0,21,4,76906920,3640,65146980,3080,26213
1881,6,0,18,7,76946460,3640,65146980,3079,26219
1882,16,0,22,3,76992180,3640,65146980,3077,26235
1883,12,0,23,2,77038200,3641,65146980,3075,26247
1884,9,0,14,11,77099400,3640,65146980,3074,26256
1885,13,0,16,9,77141880,3641,65146980,3072,26269
1886,11,0,17,8,77172840,3640,65146980,3070,26280
1887,7,0,14,11,77210580,3640,65146980,3069,26287
1888,12,0,18,7,77236560,3640,65146980,3068,26299
1889,8,0,17,8,77268060,3640,65146980,3067,26307
1890,1,0,11,14,77297280,3640,65146980,3066,26308
1891,4,0,13,12,77312820,3641,65146980,3066,26312
1892,12,0,16,9,77346180,3641,65146980,3064,26324
1893,12,0,20,5,77369100,3640,65146980,3062,26336
1894,7,0,16,9,77412300,3641,65146980,3061,26343
1895,6,0,13,12,77452920,3641,65146980,3060,26349
1896,5,0,11,14,77480460,3641,65146980,3060,26354
1897,1,0,8,17,77499420,3641,65146980,3060,26355
1898,2,0,9,16,77503680,3641,65146980,3059,26357
1899,4,0,11,14,77508720,3641,65146980,3059,26361
1900,10,0,15,10,77520900,3641,65146980,3057,26371
1901,6,0,16,9,77533020,3640,65146980,3056,26377
1902,5,0,10,15,77579400,3641,65146980,3056,26382
1903,7,0,12,13,77597820,3641,65146980,3055,26389
1904,12,0,15,10,77608020,3640,65146980,3053,26401
1905,10,0,18,7,77630280,3640,65146980,3052,26411
1906,7,0,17,8,77669700,3640,65146980,3051,26418
1907,5,0,17,8,77694060,3640,65146980,3050,26423
1908,9,0,12,13,77749440,3640,65146980,3049,26432
1909,6,0,16,9,77756700,3640,65146980,3048,26438
1910,6,0,12,13,77796180,3641,65146980,3047,26444
1911,13,0,17,8,77827080,3641,65146980,3045,26457
1912,10,0,21,4,77842140,3640,65146980,3044,26467
1913,13,0,20,5,77897520,3641,65147040,3042,26480
1914,10,0,14,11,77943480,3640,65147040,3040,26490
1915,9,0,17,8,77965920,3640,65147040,3039,26499
1916,2,0,12,13,77993100,3640,65147040,3039,26501
1917,11,0,14,11,78025980,3640,65147040,3037,26512
1918,8,0,17,8,78037020,3640,65147040,3036,26520
1919,4,0,14,11,78066840,3640,65147040,3036,26524
1920,7,0,17,8,78081840,3640,65147040,3035,26531
1921,8,0,16,9,78122820,3640,65147040,3033,26539
1922,6,0,11,14,78160380,3640,65147040,3033,26545
1923,4,0,10,15,78185880,3641,65147040,3032,26549
1924,5,0,10,15,78195780,3640,65147040,3031,26554
1925,9,0,12,13,78203820,3639,65147040,3030,26563
1926,7,0,10,15,78230460,3639,65147040,3029,26570
1927,8,0,11,14,78246480,3639,65147040,3028,26578
1928,10,0,19,6,78248460,3638,65147040,3026,26588
1929,15,0,23,2,78277980,3638,65147040,3024,26603
1930,6,0,18,7,78323100,3638,65147040,3024,26609
1931,4,0,12,13,78373680,3639,65147040,3023,26613
1932,9,0,14,11,78388980,3638,65147040,3022,26622
1933,13,0,19,6,78422100,3639,65147040,3020,26635
1934,9,0,21,4,78455700,3639,65147040,3019,26644
1935,9,0,19,6,78500100,3639,65147040,3017,26653
1936,9,0,11,14,78563100,3639,65147040,3016,26662
1937,10,0,18,7,78568080,3639,65147040,3015,26672
1938,9,0,16,9,78620340,3639,65147040,3013,26681
1939,5,0,13,12,78652080,3640,65147040,3013,26686
1940,7,0,16,9,78670260,3640,65147040,3012,26693
1941,8,0,18,7,78694440,3640,65147040,3011,26701
1942,1,0,10,15,78736980,3640,65147040,3011,26702
1943,9,0,17,8,78750240,3641,65147040,3009,26711
1944,4,0,13,12,78781560,3641,65147040,3009,26715
1945,5,0,13,12,78800700,3641,65147040,3008,26720
1946,5,0,12,13,78827880,3641,65147040,3007,26725
1947,3,0,10,15,78854400,3641,65147040,3007,26728
1948,8,0,13,12,78872040,3641,65147040,3006,26736
1949,4,0,10,15,78895620,3641,65147040,3005,26740
1950,8,0,13,12,78901860,3641,65147040,3004,26748
1951,9,0,14,11,78926160,3641,65147040,3003,26757
1952,13,0,21,4,78943800,3640,65147040,3001,26770
1953,5,0,16,9,78974880,3640,65147040,3000,26775
1954,14,0,18,7,79023120,3640,65147040,2998,26789
1955,7,0,16,9,79054800,3640,65147040,2998,26796
1956,10,0,17,8,79085820,3640,65147040,2996,26806
1957,14,0,18,7,79125600,3640,65147040,2994,26820
1958,9,0,15,10,79165320,3640,65147040,2993,26829
1959,8,0,15,10,79194180,3640,65147040,2992,26837
1960,10,0,14,11,79229100,3639,65147040,2991,26847
1961,7,0,17,8,79239540,3639,65147040,2990,26854
1962,10,0,17,8,79263120,3639,65147040,2988,26864
1963,8,0,10,15,79319760,3639,65147040,2987,26872
1964,7,0,14,11,79324560,3638,65147040,2986,26879
1965,10,0,18,7,79346460,3638,65147040,2985,26889
1966,2,0,12,13,79382280,3639,65147040,2984,26891
1967,4,0,11,14,79406880,3639,65147040,2984,26895
1968,9,0,16,9,79428360,3639,65147040,2983,26904
1969,4,0,14,11,79451040,3639,65147040,2982,26908
1970,7,0,17,8,79472100,3640,65147040,2981,26915
1971,5,0,13,12,79509900,3640,65147040,2981,26920
1972,4,0,11,14,79531860,3640,65147040,2980,26924
1973,13,0,14,11,79556520,3639,65147040,2978,26937
1974,9,0,12,13,79584720,3639,65147040,2977,26946
1975,7,0,15,10,79600200,3639,65147040,2976,26953
1976,8,0,16,9,79620600,3639,65147040,2975,26961
1977,14,0,20,5,79650420,3638,65147040,2973,26975
1978,6,0,13,12,79700340,3638,65147040,2972,26981
1979,7,0,10,15,79735740,3638,65147040,2971,26988
1980,10,0,16,9,79751700,3638,65147040,2970,26998
1981,13,0,20,5,79779840,3638,65147040,2968,27011
1982,17,0,22,3,79817880,3638,65147040,2966,27028
1983,7,0,19,6,79863240,3638,65147040,2965,27035
1984,9,0,15,10,79928040,3639,65147040,2964,27044
1985,14,0,18,7,79953960,3638,65147040,2962,27058
1986,9,0,15,10,79999620,3638,65147040,2961,27067
1987,7,0,16,9,80023800,3638,65147040,2960,27074
1988,7,0,16,9,80057880,3639,65147040,2959,27081
1989,3,0,12,13,80086200,3639,65147040,2958,27084
1990,9,0,15,10,80110020,3639,65147040,2957,27093
1991,3,0,12,13,80129280,3639,65147040,2957,27096
1992,5,0,12,13,80158920,3639,65147040,2956,27101
1993,8,0,15,10,80170260,3639,65147040,2955,27109
1994,5,0,13,12,80194260,3639,65147040,2954,27114
1995,6,0,13,12,80222820,3639,65147040,2953,27120
1996,2,0,11,14,80237700,3639,65147040,2953,27122
1997,10,0,14,11,80262660,3639,65147040,2952,27132
1998,2,0,12,13,80272920,3639,65147040,2952,27134
1999,9,0,14,11,80291760,3639,65147040,2950,27143
2000,8,0,13,12,80319960,3638,65147040,2949,27151
2001,11,0,17,8,80350440,3639,65147040,2948,27162
2002,11,0,20,5,80374200,3638,65147040,2946,27173
2003,8,0,14,11,80424600,3638,65147040,2945,27181
2004,11,0,14,11,80455680,3638,65147040,2944,27192
2005,9,0,16,9,80481360,3638,65147040,2943,27201
2006,9,0,16,9,80507160,3638,65147040,2941,27210
2007,15,0,21,4,80539140,3638,65147040,2939,27225
2008,13,0,23,2,80585520,3638,65147040,2938,27238
2009,12,0,19,6,80637960,3638,65147040,2936,27250
2010,11,0,19,6,80670000,3637,65147040,2935,27261
2011,9,0,17,8,80704680,3637,65147040,2934,27270
2012,5,0,13,12,80749500,3638,65147040,2933,27275
2013,6,0,11,14,80774700,3637,65147040,2932,27281
2014,10,0,16,9,80789700,3637,65147040,2931,27291
2015,9,0,15,10,80822160,3637,65147040,2930,27300
2016,6,0,16,9,80837400,3637,65147040,2929,27306
2017,6,0,19,6,80844960,3637,65147040,2928,27312
2018,10,0,24,1,80860320,3637,65147040,2927,27322
2019,7,0,25,0,80876460,3636,65147040,2926,27329
2020,8,0,24,1,80918160,3637,65147580,2925,27337
2021,3,0,17,8,80957460,3637,65147580,2924,27340
2022,6,0,20,5,80968500,3637,65147580,2924,27346
2023,10,0,24,1,80977080,3636,65147580,2922,27356
2024,12,3,25,0,80998920,3636,65147580,2921,27368
2025,7,0,25,0,81028800,3636,65155080,2920,27375
2026,11,0,25,0,81073020,3636,65155080,2919,27386
2027,11,8,25,0,81086520,3636,65157900,2917,27397
2028,7,8,25,0,81132180,3637,65167680,2917,27404
2029,16,19,25,0,81163080,3637,65182200,2916,27420
2030,4,14,25,0,81213660,3638,65226060,2917,27424
2031,7,12,25,0,81242520,3638,65268720,2918,27431
2032,7,0,20,5,81288420,3636,65387280,2922,27438
2033,14,0,21,4,81313320,3635,65387280,2920,27452
2034,7,0,22,3,81322860,3635,65387280,2919,27459
2035,7,0,23,2,81349260,3635,65387580,2919,27466
2036,8,1,25,0,81381000,3636,65389020,2918,27474
2037,4,0,19,6,81432480,3636,65389500,2917,27478
2038,4,0,22,3,81442020,3636,65389500,2917,27482
2039,5,0,22,3,81458160,3636,65389500,2916,27487
2040,10,0,25,0,81489720,3636,65389500,2915,27497
2041,4,0,25,0,81508860,3637,65389500,2914,27501
2042,4,0,21,4,81561360,3638,65389740,2914,27505
2043,4,0,21,4,81580500,3638,65389740,2913,27509
2044,5,0,19,6,81611520,3638,65389740,2912,27514
2045,10,0,23,2,81625860,3638,65389740,2911,27524
2046,6,0,19,6,81660900,3638,65389740,2910,27530
2047,14,1,25,0,81675240,3637,65390460,2909,27544
2048,3,0,23,2,81690300,3637,65391600,2908,27547
2049,11,0,21,4,81735600,3637,65391600,2907,27558
2050,9,0,20,5,81750120,3636,65391600,2906,27567
2051,9,0,25,0,81770040,3636,65391600,2905,27576
2052,10,0,23,2,81794520,3635,65392740,2903,27586
2053,10,0,25,0,81821700,3635,65392740,2902,27596
2054,13,0,23,2,81866760,3635,65393220,2900,27609
2055,17,7,25,0,81889080,3634,65395680,2899,27626
2056,7,9,25,0,81916980,3635,65401920,2898,27633
2057,10,12,25,0,81953160,3635,65411760,2897,27643
2058,7,13,25,0,81987540,3636,65422440,2896,27650
2059,10,8,25,0,82037820,3636,65481180,2898,27660
2060,4,0,23,2,82066620,3635,65571120,2901,27664
2061,2,0,18,7,82088520,3635,65571120,2901,27666
2062,1,0,17,8,82107480,3635,65571120,2901,27667
2063,8,0,20,5,82118640,3635,65571120,2900,27675
2064,1,0,17,8,82136640,3635,65571120,2900,27676
2065,4,0,18,7,82148760,3635,65571120,2899,27680
2066,6,0,18,7,82161900,3635,65571120,2898,27686
2067,6,0,19,6,82170420,3634,65571120,2898,27692
2068,4,0,19,6,82182720,3634,65571120,2897,27696
2069,10,0,21,4,82207260,3634,65571120,2896,27706
2070,9,0,22,3,82226160,3633,65571120,2895,27715
2071,5,0,21,4,82252740,3634,65571120,2894,27720
2072,5,0,23,2,82269240,3634,65571120,2893,27725
2073,11,0,25,0,82302540,3634,65571660,2892,27736
2074,6,1,25,0,82317600,3634,65572440,2891,27742
2075,13,8,25,0,82342560,3634,65577000,2890,27755
2076,14,10,25,0,82400460,3635,65596320,2889,27769
2077,9,13,25,0,82426200,3635,65600280,2888,27778
2078,10,18,25,0,82451040,3635,65604720,2887,27788
2079,9,17,25,0,82502340,3636,65626800,2887,27797
2080,12,22,25,0,82528500,3636,65633040,2886,27809
2081,7,25,25,0,82562580,3637,65638080,2885,27816
2082,12,33,25,0,82592340,3637,65661780,2885,27828
2083,8,28,25,0,82653720,3638,65707140,2885,27836
2084,7,27,25,0,82684200,3638,65756700,2886,27843
2085,3,23,25,0,82716060,3638,65795520,2888,27846
2086,4,4,25,0,82766220,3637,66253440,2907,27850
2087,13,0,25,0,82793880,3635,66371640,2911,27863
2088,6,0,22,3,82820100,3635,66371640,2910,27869
2089,2,0,19,6,82851060,3636,66371640,2910,27871
2090,7,0,23,2,82870200,3636,66371640,2909,27878
2091,4,0,18,7,82902180,3636,66371640,2908,27882
2092,5,0,21,4,82907400,3636,66371640,2908,27887
2093,4,0,19,6,82923300,3636,66371640,2907,27891
2094,9,1,25,0,82926120,3635,66371640,2906,27900
2095,6,0,25,0,82960680,3636,66371700,2905,27906
2096,8,0,24,1,83002980,3636,66372720,2904,27914
2097,8,1,25,0,83035740,3637,66373980,2904,27922
2098,9,0,24,1,83065260,3636,66374280,2902,27931
2099,10,0,24,1,83100660,3636,66374280,2901,27941
2100,12,2,25,0,83119620,3636,66374280,2900,27953
2101,13,6,25,0,83138640,3635,66376560,2898,27966
2102,5,1,25,0,83184480,3635,66388200,2898,27971
2103,8,0,23,2,83223060,3635,66388200,2897,27979
2104,10,0,25,0,83254740,3635,66388200,2896,27989
2105,19,14,25,0,83274120,3635,66391380,2894,28008
2106,9,16,25,0,83313060,3636,66408660,2893,28017
2107,13,25,25,0,83333400,3636,66414000,2892,28030
2108,7,27,25,0,83374800,3637,66430500,2891,28037
2109,8,27,25,0,83432760,3639,66453720,2892,28045
2110,5,30,25,0,83444160,3639,66462060,2891,28050
2111,7,29,25,0,83499900,3640,66486780,2891,28057
2112,6,27,25,0,83538300,3640,66543300,2893,28063
2113,5,21,25,0,83575980,3640,66706800,2900,28068
2114,5,2,25,0,83613960,3638,67139460,2918,28073
2115,4,0,21,4,83641140,3638,67165980,2918,28077
2116,6,0,20,5,83669640,3638,67165980,2918,28083
2117,2,0,18,7,83682540,3638,67165980,2917,28085
2118,3,0,19,6,83697780,3638,67165980,2917,28088
2119,8,0,24,1,83705520,3638,67165980,2916,28096
2120,8,0,23,2,83729760,3638,67165980,2915,28104
2121,20,8,25,0,83772120,3638,67168860,2913,28124
2122,12,16,25,0,83783940,3638,67174020,2911,28136
2123,15,29,25,0,83798340,3638,67175160,2910,28151
2124,14,36,25,0,83859240,3640,67191600,2908,28165
2125,10,40,25,0,83892780,3640,67207200,2908,28175
2126,10,40,25,0,83926680,3641,67257480,2910,28185
2127,9,38,25,0,83974560,3641,67317300,2911,28194
2128,15,37,25,0,84020520,3642,67367940,2912,28209
2129,10,39,25,0,84049740,3642,67395900,2912,28219
2130,13,40,25,0,84079860,3642,67432980,2912,28232
2131,7,37,25,0,84116760,3642,67476660,2914,28239
2132,6,34,25,0,84159840,3642,67619100,2919,28245
2133,4,24,25,0,84203160,3642,67946760,2933,28249
2134,3,0,17,8,84240540,3638,68660400,2963,28252
2135,2,0,16,9,84255960,3638,68660400,2963,28254
2136,2,0,17,8,84257040,3638,68660400,2963,28256
2137,5,0,18,7,84268560,3638,68660400,2962,28261
2138,2,0,18,7,84270180,3638,68660400,2962,28263
2139,7,0,21,4,84285600,3638,68660400,2961,28270
2140,4,0,21,4,84300780,3638,68660400,2960,28274
2141,8,0,23,2,84324900,3638,68660400,2959,28282
2142,9,2,25,0,84345420,3638,68660460,2958,28291
2143,7,4,25,0,84370020,3638,68667480,2958,28298
2144,5,0,23,2,84419700,3639,68677200,2957,28303
2145,9,0,22,3,84456120,3639,68677320,2956,28312
2146,12,0,23,2,84484920,3638,68677320,2955,28324
2147,9,0,22,3,84512040,3638,68677320,2953,28333
2148,15,10,25,0,84521040,3638,68677500,2952,28348
2149,8,12,25,0,84555000,3639,68688360,2952,28356
2150,8,15,25,0,84582540,3639,68702760,2951,28364
2151,7,14,25,0,84632940,3640,68725980,2951,28371
2152,11,18,25,0,84668640,3640,68730120,2950,28382
2153,8,21,25,0,84702300,3641,68736900,2949,28390
2154,9,22,25,0,84741660,3641,68767320,2949,28399
2155,6,17,25,0,84787080,3642,68806980,2950,28405
2156,14,17,25,0,84820440,3641,68869920,2951,28419
2157,7,9,25,0,84864000,3640,69030720,2957,28426
2158,5,0,20,5,84905820,3639,69234120,2965,28431
2159,5,0,21,4,84922860,3639,69234120,2964,28436
2160,8,0,22,3,84946500,3639,69234120,2963,28444
2161,8,0,22,3,84971760,3639,69234120,2962,28452
2162,3,0,20,5,84997920,3640,69234120,2962,28455
2163,7,0,22,3,85021440,3640,69234120,2961,28462
2164,1,0,16,9,85044240,3640,69234120,2961,28463
2165,6,0,19,6,85052760,3640,69234120,2960,28469
2166,9,0,25,0,85059060,3639,69234120,2959,28478
2167,4,0,23,2,85081980,3639,69234120,2958,28482
2168,6,0,21,4,85115940,3640,69234120,2958,28488
2169,3,0,17,8,85149840,3640,69234120,2957,28491
2170,10,0,23,2,85156200,3640,69234120,2956,28501
2171,11,0,24,1,85183560,3639,69234360,2955,28512
2172,12,4,25,0,85208040,3639,69240120,2953,28524
2173,9,7,25,0,85234380,3639,69249000,2953,28533
2174,9,6,25,0,85285380,3640,69265560,2952,28542
2175,7,0,19,6,85324140,3639,69305520,2953,28549
2176,9,2,25,0,85326420,3639,69305520,2952,28558
2177,20,16,25,0,85357860,3639,69309060,2950,28578
2178,6,16,25,0,85397880,3640,69328680,2950,28584
2179,5,17,25,0,85428900,3641,69340740,2950,28589
2180,6,12,25,0,85482660,3641,69423420,2952,28595
2181,9,13,25,0,85510620,3641,69427620,2951,28604
2182,6,12,25,0,85538340,3641,69454260,2952,28610
2183,3,0,21,4,85578840,3640,69633540,2959,28613
2184,4,0,20,5,85610280,3640,69633540,2958,28617
2185,6,0,23,2,85619220,3640,69633540,2958,28623
2186,5,0,18,7,85653180,3640,69633540,2957,28628
2187,9,0,24,1,85661220,3640,69633540,2956,28637
2188,2,0,19,6,85688460,3640,69633540,2956,28639
2189,3,0,19,6,85708380,3641,69633540,2955,28642
2190,9,0,23,2,85721220,3640,69633540,2954,28651
2191,7,0,22,3,85747380,3640,69633840,2953,28658
2192,4,0,21,4,85762740,3640,69633840,2953,28662
2193,6,0,22,3,85779600,3640,69633840,2952,28668
2194,11,1,25,0,85811460,3640,69635040,2951,28679
2195,10,5,25,0,85840680,3641,69640980,2950,28689
2196,10,3,25,0,85888140,3641,69662760,2950,28699
2197,12,9,25,0,85906260,3641,69669840,2948,28711
2198,7,10,25,0,85941480,3641,69687540,2948,28718
2199,13,15,25,0,85987080,3642,69703860,2947,28731
2200,7,16,25,0,86016420,3642,69711900,2947,28738
2201,10,18,25,0,86060400,3643,69722760,2946,28748
2202,8,17,25,0,86094360,3643,69765600,2947,28756
2203,11,23,25,0,86124900,3643,69774540,2946,28767
2204,8,24,25,0,86157360,3644,69781200,2945,28775
2205,5,12,25,0,86200380,3643,69971520,2952,28780
2206,6,0,21,4,86248020,3642,70200780,2961,28786
2207,8,0,23,2,86267460,3641,70200780,2960,28794
2208,2,0,19,6,86296860,3642,70200780,2960,28796
2209,4,0,20,5,86318100,3642,70200780,2960,28800
2210,8,0,21,4,86337840,3642,70200780,2959,28808
2211,6,0,18,7,86365260,3642,70200780,2958,28814
2212,4,0,21,4,86366700,3642,70200780,2957,28818
2213,8,0,25,0,86379060,3642,70200780,2956,28826
2214,9,1,25,0,86415360,3642,70204800,2955,28835
2215,10,0,25,0,86459400,3642,70206300,2954,28845
2216,15,11,25,0,86479260,3642,70213080,2953,28860
2217,5,11,25,0,86511900,3643,70222020,2952,28865
2218,10,14,25,0,86546340,3643,70248480,2952,28875
2219,15,23,25,0,86578200,3644,70251300,2951,28890
2220,11,25,25,0,86633760,3645,70282080,2950,28901
2221,12,30,25,0,86659860,3645,70298340,2950,28913
2222,8,29,25,0,86694420,3645,70331160,2950,28921
2223,12,31,25,0,86737260,3645,70361400,2950,28933
2224,8,36,25,0,86748000,3645,70378980,2950,28941
2225,10,39,25,0,86792340,3646,70405860,2950,28951
2226,7,39,25,0,86836980,3647,70410180,2949,28958
2227,8,39,25,0,86877120,3647,70436280,2949,28966
2228,7,36,25,0,86906520,3647,70588920,2955,28973
2229,8,19,25,0,86952300,3645,71095320,2975,28981
2230,5,0,25,0,87001260,3644,71583600,2995,28986
2231,6,0,20,5,87022680,3643,71583600,2994,28992
2232,6,0,22,3,87034320,3643,71583600,2993,28998
2233,2,0,18,7,87060180,3643,71583600,2993,29000
2234,3,0,19,6,87074580,3643,71583600,2993,29003
2235,5,0,18,7,87098760,3643,71583600,2992,29008
2236,5,0,20,5,87109200,3643,71583600,2991,29013
2237,4,0,23,2,87110100,3643,71583600,2991,29017
2238,4,0,21,4,87138360,3643,71583600,2990,29021
2239,6,0,21,4,87186840,3644,71583600,2990,29027
2240,8,0,21,4,87196380,3644,71583600,2989,29035
2241,6,0,20,5,87220260,3644,71583600,2988,29041
2242,8,0,22,3,87240660,3643,71583600,2987,29049
2243,12,0,25,0,87266640,3643,71584800,2985,29061
2244,9,0,22,3,87306420,3643,71586180,2984,29070
2245,9,0,19,6,87344160,3643,71586180,2983,29079
2246,7,0,24,1,87348000,3643,71586180,2982,29086
2247,18,10,25,0,87373440,3643,71587320,2981,29104
2248,14,16,25,0,87420660,3643,71598780,2979,29118
2249,5,18,25,0,87438420,3644,71602500,2979,29123
2250,8,18,25,0,87491880,3645,71620800,2978,29131
2251,8,21,25,0,87519060,3645,71628660,2977,29139
2252,4,21,25,0,87542040,3645,71657340,2978,29143
2253,7,16,25,0,87604740,3646,71771100,2982,29150
2254,7,7,25,0,87641100,3645,71944500,2988,29157
2255,6,0,20,5,87673740,3644,72047340,2992,29163
2256,8,0,20,5,87690960,3643,72047340,2991,29171
2257,6,0,20,5,87712560,3643,72047340,2990,29177
2258,6,0,19,6,87732180,3643,72047340,2989,29183
2259,5,0,21,4,87740880,3643,72047340,2989,29188
2260,5,0,22,3,87754380,3643,72047340,2988,29193
2261,8,2,25,0,87768360,3643,72047640,2987,29201
2262,12,3,25,0,87810540,3643,72052620,2986,29213
2263,9,0,25,0,87852360,3643,72058560,2985,29222
2264,9,3,25,0,87869640,3643,72059700,2984,29231
2265,10,8,25,0,87909420,3644,72067260,2983,29241
2266,2,0,24,1,87956640,3644,72098520,2984,29243
2267,12,0,22,3,87986760,3643,72098820,2983,29255
2268,12,2,25,0,88023180,3644,72098880,2981,29267
2269,13,8,25,0,88047960,3644,72102840,2980,29280
2270,4,4,25,0,88094880,3644,72121080,2980,29284
2271,13,11,25,0,88121520,3645,72124560,2979,29297
2272,15,20,25,0,88165680,3646,72130680,2977,29312
2273,11,28,25,0,88182900,3646,72139680,2976,29323
2274,4,26,25,0,88232220,3647,72167760,2977,29327
2275,4,21,25,0,88286040,3648,72276420,2981,29331
2276,3,12,25,0,88319160,3647,72385500,2985,29334
2277,8,6,25,0,88346580,3646,72494400,2988,29342
2278,2,0,20,5,88387740,3646,72584040,2992,29344
2279,7,0,20,5,88409100,3646,72584040,2991,29351
2280,9,0,23,2,88426140,3646,72584040,2990,29360
2281,3,0,21,4,88446420,3646,72584040,2989,29363
2282,11,0,25,0,88472220,3646,72584520,2988,29374
2283,7,0,25,0,88498740,3646,72585000,2987,29381
2284,6,0,22,3,88547820,3647,72585900,2986,29387
2285,5,0,21,4,88565100,3646,72585900,2986,29392
2286,5,0,19,6,88586520,3646,72585900,2985,29397
2287,8,0,19,6,88608420,3646,72585900,2984,29405
2288,9,0,23,2,88625940,3646,72585900,2983,29414
2289,12,1,25,0,88644900,3645,72587580,2982,29426
2290,14,10,25,0,88668060,3646,72595020,2981,29440
2291,13,17,25,0,88705500,3646,72600120,2980,29453
2292,11,21,25,0,88745340,3647,72627660,2979,29464
2293,14,25,25,0,88792920,3647,72666480,2979,29478
2294,11,30,25,0,88814400,3647,72669000,2978,29489
2295,8,31,25,0,88848420,3648,72677940,2977,29497
2296,9,34,25,0,88887840,3648,72697860,2977,29506
2297,9,37,25,0,88922700,3649,72700860,2976,29515
2298,9,40,25,0,88961340,3649,72713520,2975,29524
2299,8,37,25,0,88995480,3650,72754440,2976,29532
2300,6,33,25,0,89047680,3650,72886380,2981,29538
2301,4,30,25,0,89070540,3650,73011180,2985,29542
2302,7,26,25,0,89116080,3650,73124700,2989,29549
2303,3,8,25,0,89155860,3649,73740120,3014,29552
2304,8,0,19,6,89187840,3647,73949100,3021,29560
2305,8,0,19,6,89207700,3646,73949280,3020,29568
2306,3,0,19,6,89231400,3647,73949280,3020,29571
2307,7,0,19,6,89245200,3646,73949280,3019,29578
2308,5,0,19,6,89256240,3646,73949280,3018,29583
2309,7,0,18,7,89272500,3646,73949280,3018,29590
2310,9,0,23,2,89284200,3646,73949280,3016,29599
2311,12,0,25,0,89307720,3645,73952460,3015,29611
2312,15,3,25,0,89342520,3645,73952700,3013,29626
2313,16,13,25,0,89370420,3645,73958640,3012,29642
2314,5,14,25,0,89401020,3646,73973220,3012,29647
2315,11,18,25,0,89445660,3646,73987140,3011,29658
2316,12,24,25,0,89477820,3647,73992420,3010,29670
2317,7,27,25,0,89507460,3647,74013360,3010,29677
2318,12,31,25,0,89547960,3648,74037960,3009,29689
2319,8,31,25,0,89587380,3648,74109840,3011,29697
2320,7,31,25,0,89623680,3649,74119260,3011,29704
2321,9,31,25,0,89666400,3649,74201520,3013,29713
2322,2,25,25,0,89704320,3649,74346900,3018,29715
2323,6,19,25,0,89737380,3649,74521500,3025,29721
2324,7,4,25,0,89782200,3648,74821260,3036,29728
2325,5,0,22,3,89807580,3647,74915220,3039,29733
2326,7,0,22,3,89835600,3647,74915220,3038,29740
2327,6,0,19,6,89868840,3647,74915220,3038,29746
2328,2,0,16,9,89881980,3647,74915220,3037,29748
2329,5,0,19,6,89888160,3647,74915220,3037,29753
2330,4,0,19,6,89896560,3646,74915220,3036,29757
2331,5,0,20,5,89910900,3646,74915220,3036,29762
2332,4,0,17,8,89930640,3646,74915220,3035,29766
2333,5,0,19,6,89937180,3646,74915220,3035,29771
2334,5,0,20,5,89943900,3646,74915220,3034,29776
2335,5,0,18,7,89971560,3646,74915220,3033,29781
2336,6,0,21,4,89976180,3646,74915220,3033,29787
2337,7,0,22,3,89995080,3645,74915220,3032,29794
2338,15,6,25,0,90022980,3646,74918340,3030,29809
2339,7,7,25,0,90052140,3646,74931480,3030,29816
2340,5,0,24,1,90101040,3646,74968020,3031,29821
2341,9,0,22,3,90121380,3645,74968080,3029,29830
2342,8,2,25,0,90142140,3646,74968080,3029,29838
2343,12,6,25,0,90180060,3646,74973720,3028,29850
2344,8,4,25,0,90223380,3646,74980320,3027,29858
2345,11,2,25,0,90260460,3646,75003060,3026,29869
2346,7,0,23,2,90280140,3645,75005520,3025,29876
2347,9,0,24,1,90311280,3645,75005520,3024,29885
2348,10,0,25,0,90346260,3645,75010260,3023,29895
2349,8,0,19,6,90384960,3645,75010560,3022,29903
2350,3,0,19,6,90390000,3644,75010560,3022,29906
2351,6,0,19,6,90408000,3644,75010560,3021,29912
2352,6,0,20,5,90412680,3644,75010560,3020,29918
2353,8,0,19,6,90438480,3643,75010560,3019,29926
2354,17,6,25,0,90450300,3643,75013080,3018,29943
2355,11,12,25,0,90479520,3644,75019020,3016,29954
2356,23,29,25,0,90520800,3644,75020940,3014,29977
2357,28,40,25,0,90541200,3645,75023400,3012,30005
2358,30,40,25,0,90594780,3646,75041820,3012,30035
2359,26,40,25,0,90608940,3646,75045360,3012,30061
2360,26,40,25,0,90653760,3647,75113640,3014,30087
2361,25,40,25,0,90697800,3648,75169020,3016,30112
2362,29,39,25,0,90748740,3648,75277800,3018,30141
2363,32,39,25,0,90786180,3648,75312480,3018,30173
2364,33,40,25,0,90807120,3648,75346740,3019,30206
2365,37,38,25,0,90844140,3648,75418260,3021,30243
2366,28,40,25,0,90878040,3649,75456780,3022,30271
2367,35,39,25,0,90923580,3649,75503220,3022,30306
2368,27,40,25,0,90960600,3649,75661260,3028,30333
2369,42,40,25,0,90992580,3649,75691500,3028,30375
2370,31,40,25,0,91033200,3649,75778260,3030,30406
2371,23,40,25,0,91052220,3649,75788520,3029,30429
2372,32,40,25,0,91101960,3649,75855540,3031,30461
2373,34,40,25,0,91131360,3649,75871020,3031,30495
2374,33,40,25,0,91165380,3650,75876660,3030,30528
2375,51,40,25,0,91193700,3650,75909840,3030,30579
2376,36,39,25,0,91246260,3650,76043520,3034,30615
2377,32,40,25,0,91287180,3650,76049220,3033,30647
2378,27,40,25,0,91316760,3650,76083960,3033,30674
2379,42,40,25,0,91339440,3650,76121760,3034,30716
2380,33,40,25,0,91402260,3650,76152060,3034,30749
2381,34,40,25,0,91418880,3650,76173240,3034,30783
2382,38,40,25,0,91464840,3650,76218180,3034,30821
2383,25,40,25,0,91505640,3649,76382760,3038,30846
2384,31,39,25,0,91538280,3649,76395480,3037,30877
2385,21,40,25,0,91567260,3648,76422360,3037,30898
2386,36,40,25,0,91600380,3648,76430040,3037,30934
2387,28,40,25,0,91644660,3649,76446360,3036,30962
2388,26,40,25,0,91663680,3649,76482060,3037,30988
2389,30,40,25,0,91694880,3649,76490340,3036,31018
2390,19,39,25,0,91756080,3650,76527840,3036,31037
2391,30,40,25,0,91784100,3650,76674180,3041,31067
2392,32,40,25,0,91827300,3650,76705800,3041,31099
2393,28,40,25,0,91854720,3649,76740420,3041,31127
2394,29,40,25,0,91903260,3650,76760040,3040,31156
2395,41,40,25,0,91933440,3649,76775640,3040,31197
2396,38,40,25,0,91958460,3649,76857720,3042,31235
2397,31,39,25,0,92005920,3650,76898760,3043,31266
2398,20,39,25,0,92041320,3649,76912380,3042,31286
2399,35,40,25,0,92058120,3649,76915680,3041,31321

