Hour,Arrivals,Waiting,Treating,Available Rooms,Total Treatment Time,Average Treatment Time,Total Wait Time,Average Wait Time,Total Arrivals
1,8,0,6,19,1620,810,0,0,8
2,6,0,7,18,9720,1388,0,0,14
3,3,0,2,23,43260,2884,0,0,17
4,6,0,7,18,44340,2771,0,0,23
5,7,0,5,20,74700,2988,0,0,30
6,3,0,3,22,90420,3014,0,0,33
7,11,0,9,16,104700,2991,0,0,44
8,5,0,5,20,130800,2972,0,0,49
9,8,0,6,19,150720,2955,0,0,57
10,8,0,4,21,173040,2836,0,0,65
11,8,0,6,19,190980,2850,0,0,73
12,11,0,8,17,211680,2785,0,0,84
13,12,0,10,15,234540,2727,0,0,96
14,5,0,4,21,272640,2810,0,0,101
15,3,0,2,23,292080,2863,0,0,104
16,7,0,4,21,305820,2858,0,0,111
17,12,0,9,16,314700,2760,0,0,123
18,9,0,8,17,351180,2832,0,0,132
19,10,0,11,14,381120,2909,0,0,142
20,6,0,9,16,406860,2927,0,0,148
21,2,0,3,22,444480,3023,0,0,150
22,6,0,6,19,456660,3044,0,0,156
23,5,0,9,16,465720,3063,0,0,161
24,3,0,6,19,488040,3088,0,0,164
25,5,0,4,21,533940,3236,0,0,169
26,2,0,3,22,542220,3227,0,0,171
27,9,0,9,16,556620,3255,0,0,180
28,13,0,15,10,565980,3179,0,0,193
29,10,0,12,13,621120,3251,0,0,203
30,5,0,5,20,681420,3356,0,0,208
31,11,0,7,18,708360,3341,0,0,219
32,14,0,13,12,729900,3317,0,0,233
33,9,0,10,15,774000,3336,0,0,242
34,17,0,15,10,817200,3349,0,0,259
35,15,0,15,10,858360,3314,0,0,274
36,18,0,16,9,914040,3311,0,0,292
37,18,0,15,10,951600,3225,0,0,310
38,11,0,13,12,1014780,3294,0,0,321
39,6,0,5,20,1068000,3316,0,0,327
40,13,0,10,15,1100400,3334,0,0,340
41,11,0,14,11,1117920,3317,0,0,351
42,8,0,9,16,1171560,3347,0,0,359
43,9,0,10,15,1202820,3359,0,0,368
44,8,0,9,16,1242420,3385,0,0,376
45,13,0,13,12,1276980,3396,0,0,389
46,4,0,7,18,1316160,3409,0,0,393
47,5,0,6,19,1350180,3444,0,0,398
48,3,0,3,22,1381860,3472,0,0,401
49,10,0,6,19,1396620,3448,0,0,411
50,4,0,3,22,1414680,3433,0,0,415
51,7,0,4,21,1431240,3424,0,0,422
52,5,0,6,19,1440000,3420,0,0,427
53,6,0,4,21,1456560,3395,0,0,433
54,5,0,5,20,1473540,3403,0,0,438
55,6,0,9,16,1480620,3403,0,0,444
56,8,0,9,16,1518780,3428,0,0,452
57,7,0,6,19,1553340,3429,0,0,459
58,6,0,5,20,1574160,3422,0,0,465
59,15,0,11,14,1588320,3386,0,0,480
60,9,0,12,13,1607040,3369,0,0,489
61,9,0,10,15,1664100,3410,0,0,498
62,10,0,10,15,1689180,3391,0,0,508
63,9,0,11,14,1718340,3395,0,0,517
64,13,0,8,17,1766940,3384,0,0,530
65,9,0,10,15,1784880,3374,0,0,539
66,8,0,10,15,1827060,3402,0,0,547
67,6,0,9,16,1852740,3405,0,0,553
68,5,0,7,18,1899600,3447,0,0,558
69,5,0,7,18,1919700,3452,0,0,563
70,11,0,10,15,1941180,3441,0,0,574
71,5,0,8,17,1982880,3472,0,0,579
72,7,0,8,17,2010480,3478,0,0,586
73,2,0,1,24,2053500,3498,0,0,588
74,2,0,3,22,2053500,3498,0,0,590
75,6,0,7,18,2062140,3501,0,0,596
76,9,0,11,14,2071560,3487,0,0,605
77,8,0,12,13,2104200,3501,0,0,613
78,6,0,7,18,2155800,3522,0,0,619
79,6,0,6,19,2182320,3525,0,0,625
80,5,0,7,18,2204760,3538,0,0,630
81,15,0,11,14,2235360,3525,0,0,645
82,13,0,14,11,2262960,3513,0,0,658
83,12,0,14,11,2313720,3527,0,0,670
84,10,0,11,14,2362680,3531,0,0,680
85,7,0,7,18,2404140,3535,0,0,687
86,7,0,7,18,2427120,3532,0,0,694
87,9,0,9,16,2457060,3540,0,0,703
88,15,0,15,10,2476980,3523,0,0,718
89,6,0,12,13,2523540,3544,0,0,724
90,11,0,8,17,2580420,3549,0,0,735
91,7,0,6,19,2610360,3546,0,0,742
92,5,0,3,22,2643900,3553,0,0,747
93,8,0,6,19,2659980,3551,0,0,755
94,4,0,6,19,2674320,3551,0,0,759
95,4,0,2,23,2702520,3551,0,0,763
96,4,0,4,21,2711100,3553,0,0,767
97,5,0,5,20,2723160,3550,0,0,772
98,4,0,5,20,2740260,3554,0,0,776
99,10,0,8,17,2764800,3553,0,0,786
100,5,0,7,18,2790720,3559,0,0,791
101,7,0,5,20,2830080,3568,0,0,798
102,4,0,5,20,2846520,3571,0,0,802
103,18,0,12,13,2877360,3561,0,0,820
104,5,0,6,19,2910300,3553,0,0,825
105,6,0,7,18,2929740,3555,0,0,831
106,7,0,4,21,2969760,3560,0,0,838
107,15,0,14,11,2975760,3546,0,0,853
108,8,0,7,18,3017340,3533,0,0,861
109,10,0,9,16,3045840,3533,0,0,871
110,5,0,4,21,3083400,3536,0,0,876
111,9,0,7,18,3113520,3546,0,0,885
112,10,0,12,13,3124020,3537,0,0,895
113,10,0,10,15,3168300,3540,0,0,905
114,8,0,9,16,3197220,3536,0,0,913
115,6,0,7,18,3228060,3539,0,0,919
116,7,0,11,14,3234900,3535,0,0,926
117,8,0,8,17,3286800,3549,0,0,934
118,8,0,7,18,3321360,3552,0,0,942
119,8,0,8,17,3343020,3548,0,0,950
120,5,0,6,19,3378600,3560,0,0,955
121,5,0,4,21,3407040,3563,0,0,960
122,2,0,2,23,3425340,3568,0,0,962
123,6,0,6,19,3429240,3564,0,0,968
124,6,0,3,22,3463800,3567,0,0,974
125,4,0,4,21,3472800,3565,0,0,978
126,5,0,4,21,3484800,3559,0,0,983
127,11,0,13,12,3490680,3558,0,0,994
128,8,0,9,16,3531300,3556,0,0,1002
129,11,0,16,9,3541860,3552,0,0,1013
130,12,0,9,16,3610860,3553,0,0,1025
131,11,0,13,12,3633540,3551,0,0,1036
132,15,0,14,11,3674940,3543,0,0,1051
133,7,0,12,13,3723360,3559,0,0,1058
134,13,0,14,11,3769980,3566,0,0,1071
135,13,0,12,13,3833880,3576,0,0,1084
136,9,0,9,16,3882060,3581,0,0,1093
137,7,0,3,22,3920460,3573,0,0,1100
138,15,0,9,16,3945300,3567,0,0,1115
139,6,0,7,18,3968280,3562,0,0,1121
140,5,0,4,21,4005840,3570,0,0,1126
141,5,0,5,20,4025700,3575,0,0,1131
142,7,0,6,19,4043040,3571,0,0,1138
143,7,0,8,17,4055280,3566,0,0,1145
144,4,0,4,21,4090200,3572,0,0,1149
145,4,0,3,22,4113480,3576,0,0,1153
146,4,0,6,19,4117020,3576,0,0,1157
147,11,0,6,19,4143540,3565,0,0,1168
148,6,0,7,18,4155900,3561,0,0,1174
149,6,0,9,16,4174500,3564,0,0,1180
150,9,0,9,16,4208400,3566,0,0,1189
151,10,0,9,16,4238820,3562,0,0,1199
152,8,0,8,17,4270920,3562,0,0,1207
153,10,0,4,21,4312020,3554,0,0,1217
154,11,0,11,14,4328700,3556,0,0,1228
155,15,0,21,4,4356420,3564,0,0,1243
156,6,0,12,13,4412640,3567,0,0,1249
157,9,0,8,17,4483740,3586,0,0,1258
158,7,0,4,21,4526280,3589,0,0,1265
159,6,0,6,19,4537740,3587,0,0,1271
160,10,0,10,15,4552320,3581,0,0,1281
161,9,0,7,18,4585920,3574,0,0,1290
162,10,0,6,19,4624200,3573,0,0,1300
163,10,0,6,19,4644960,3562,0,0,1310
164,6,0,8,17,4657320,3560,0,0,1316
165,6,0,10,15,4676700,3564,0,0,1322
166,8,0,6,19,4722720,3567,0,0,1330
167,3,0,3,22,4739520,3563,0,0,1333
168,5,0,4,21,4755120,3564,0,0,1338
169,4,0,3,22,4762740,3556,0,0,1342
170,9,0,10,15,4777920,3562,0,0,1351
171,6,0,6,19,4806600,3557,0,0,1357
172,5,0,3,22,4836960,3559,0,0,1362
173,9,0,8,17,4847040,3556,0,0,1371
174,8,0,5,20,4867080,3542,0,0,1379
175,10,0,9,16,4884480,3539,0,0,1389
176,12,0,11,14,4915500,3536,0,0,1401
177,9,0,12,13,4943340,3536,0,0,1410
178,15,0,16,9,4971360,3528,0,0,1425
179,11,0,11,14,5038020,3535,0,0,1436
180,8,0,9,16,5082180,3541,0,0,1444
181,8,0,10,15,5109000,3542,0,0,1452
182,14,0,12,13,5162640,3550,0,0,1466
183,13,0,12,13,5189940,3537,0,0,1479
184,8,0,7,18,5244780,3543,0,0,1487
185,17,0,14,11,5272440,3538,0,0,1504
186,7,0,9,16,5311380,3536,0,0,1511
187,8,0,9,16,5334480,3532,0,0,1519
188,8,0,10,15,5377800,3545,0,0,1527
189,5,0,9,16,5405340,3549,0,0,1532
190,5,0,6,19,5446800,3557,0,0,1537
191,7,0,5,20,5476140,3558,0,0,1544
192,3,0,3,22,5499300,3561,0,0,1547
193,6,0,6,19,5507700,3560,0,0,1553
194,5,0,3,22,5528040,3555,0,0,1558
195,6,0,3,22,5541660,3550,0,0,1564
196,6,0,3,22,5559180,3547,0,0,1570
197,1,0,2,23,5567760,3548,0,0,1571
198,7,0,5,20,5587260,3551,0,0,1578
199,7,0,6,19,5604660,3549,0,0,1585
200,7,0,9,16,5616120,3547,0,0,1592
201,11,0,13,12,5652720,3555,0,0,1603
202,10,0,10,15,5703060,3557,0,0,1613
203,11,0,10,15,5744160,3558,0,0,1624
204,3,0,4,21,5783820,3563,0,0,1627
205,6,0,5,20,5805660,3566,0,0,1633
206,3,0,5,20,5814840,3565,0,0,1636
207,18,0,16,9,5841300,3566,0,0,1654
208,11,0,12,13,5882460,3558,0,0,1665
209,7,0,9,16,5933580,3567,0,0,1672
210,9,0,9,16,5974440,3573,0,0,1681
211,8,0,9,16,6005400,3574,0,0,1689
212,11,0,11,14,6031980,3571,0,0,1700
213,12,0,11,14,6076560,3572,0,0,1712
214,3,0,3,22,6114360,3571,0,0,1715
215,5,0,6,19,6129600,3576,0,0,1720
216,5,0,6,19,6145800,3575,0,0,1725
217,6,0,5,20,6169980,3574,0,0,1731
218,2,0,4,21,6190200,3580,0,0,1733
219,5,0,5,20,6207900,3582,0,0,1738
220,6,0,6,19,6224220,3581,0,0,1744
221,8,0,7,18,6243900,3578,0,0,1752
222,8,0,10,15,6266340,3580,0,0,1760
223,6,0,10,15,6295080,3584,0,0,1766
224,7,0,10,15,6336780,3594,0,0,1773
225,5,0,6,19,6385320,3603,0,0,1778
226,10,0,11,14,6402300,3602,0,0,1788
227,9,0,7,18,6449460,3603,0,0,1797
228,5,0,6,19,6461640,3597,0,0,1802
229,10,0,11,14,6483360,3599,0,0,1812
230,13,0,11,14,6525960,3597,0,0,1825
231,8,0,8,17,6552840,3590,0,0,1833
232,13,0,8,17,6584160,3582,0,0,1846
233,11,0,12,13,6615660,3585,0,0,1857
234,6,0,11,14,6642960,3586,0,0,1863
235,7,0,11,14,6678420,3592,0,0,1870
236,6,0,10,15,6703260,3592,0,0,1876
237,7,0,7,18,6771780,3609,0,0,1883
238,10,0,12,13,6791040,3610,0,0,1893
239,3,0,6,19,6828300,3612,0,0,1896
240,2,0,1,24,6863040,3617,0,0,1898
241,3,0,2,23,6871680,3618,0,0,1901
242,7,0,5,20,6879000,3614,0,0,1908
243,3,0,4,21,6889380,3612,0,0,1911
244,3,0,4,21,6908280,3616,0,0,1914
245,2,0,1,24,6924180,3615,0,0,1916
246,3,0,3,22,6925980,3614,0,0,1919
247,11,0,8,17,6933600,3607,0,0,1930
248,14,0,8,17,6962580,3596,0,0,1944
249,10,0,10,15,6988860,3595,0,0,1954
250,16,0,19,6,7012320,3594,0,0,1970
251,12,0,14,11,7061640,3588,0,0,1982
252,10,0,10,15,7137360,3601,0,0,1992
253,13,0,13,12,7163040,3595,0,0,2005
254,9,0,12,13,7217580,3605,0,0,2014
255,9,0,12,13,7247100,3603,0,0,2023
256,10,0,10,15,7285380,3601,0,0,2033
257,10,0,9,16,7336860,3607,0,0,2043
258,11,0,9,16,7367880,3602,0,0,2054
259,4,0,4,21,7407060,3606,0,0,2058
260,10,0,9,16,7425060,3606,0,0,2068
261,3,0,4,21,7449900,3604,0,0,2071
262,4,0,5,20,7459740,3603,0,0,2075
263,5,0,4,21,7487520,3606,0,0,2080
264,3,0,3,22,7502760,3607,0,0,2083
265,4,0,5,20,7504560,3604,0,0,2087
266,7,0,5,20,7534080,3606,0,0,2094
267,5,0,3,22,7553520,3603,0,0,2099
268,7,0,5,20,7562820,3599,0,0,2106
269,9,0,6,19,7588320,3598,0,0,2115
270,5,0,3,22,7615860,3597,0,0,2120
271,7,0,1,24,7626780,3587,0,0,2127
272,11,0,9,16,7634220,3585,0,0,2138
273,6,0,9,16,7653000,3584,0,0,2144
274,12,0,10,15,7683960,3580,0,0,2156
275,9,0,10,15,7720560,3582,0,0,2165
276,6,0,8,17,7760460,3587,0,0,2171
277,8,0,10,15,7786440,3589,0,0,2179
278,12,0,15,10,7825380,3596,0,0,2191
279,16,0,19,6,7864740,3594,0,0,2207
280,9,0,11,14,7914780,3589,0,0,2216
281,9,0,13,12,7953480,3595,0,0,2225
282,3,0,6,19,8010240,3604,0,0,2228
283,7,0,6,19,8041320,3607,0,0,2235
284,5,0,6,19,8055720,3605,0,0,2240
285,5,0,4,21,8070180,3601,0,0,2245
286,8,0,6,19,8089800,3600,0,0,2253
287,3,0,5,20,8099520,3598,0,0,2256
288,7,0,4,21,8121540,3595,0,0,2263
289,4,0,2,23,8139180,3593,0,0,2267
290,4,0,5,20,8139960,3592,0,0,2271
291,3,0,4,21,8152080,3591,0,0,2274
292,5,0,4,21,8172840,3592,0,0,2279
293,5,0,4,21,8181360,3588,0,0,2284
294,11,0,9,16,8201340,3587,0,0,2295
295,7,0,8,17,8220420,3583,0,0,2302
296,6,0,9,16,8242440,3585,0,0,2308
297,13,0,10,15,8281380,3583,0,0,2321
298,12,0,11,14,8311380,3579,0,0,2333
299,9,0,9,16,8348100,3578,0,0,2342
300,9,0,8,17,8387640,3579,0,0,2351
301,17,0,13,12,8420700,3575,0,0,2368
302,11,0,11,14,8466600,3575,0,0,2379
303,13,0,13,12,8504340,3574,0,0,2392
304,4,0,8,17,8548980,3579,0,0,2396
305,10,0,9,16,8591820,3584,0,0,2406
306,11,0,10,15,8622840,3582,0,0,2417
307,8,0,9,16,8662920,3585,0,0,2425
308,7,0,6,19,8704260,3587,0,0,2432
309,7,0,10,15,8720760,3590,0,0,2439
310,2,0,5,20,8748480,3591,0,0,2441
311,6,0,4,21,8785740,3596,0,0,2447
312,5,0,4,21,8799420,3594,0,0,2452
313,6,0,5,20,8819460,3595,0,0,2458
314,9,0,6,19,8840040,3592,0,0,2467
315,10,0,11,14,8858400,3592,0,0,2477
316,5,0,7,18,8902140,3596,0,0,2482
317,5,0,9,16,8922240,3600,0,0,2487
318,4,0,7,18,8956680,3605,0,0,2491
319,5,0,6,19,8990100,3610,0,0,2496
320,9,0,7,18,9022080,3611,0,0,2505
321,6,0,6,19,9048300,3612,0,0,2511
322,14,0,14,11,9070440,3612,0,0,2525
323,9,0,11,14,9115140,3612,0,0,2534
324,12,0,12,13,9157440,3613,0,0,2546
325,12,0,10,15,9203820,3612,0,0,2558
326,16,0,15,10,9248220,3613,0,0,2574
327,9,0,7,18,9298860,3609,0,0,2583
328,5,0,6,19,9319200,3609,0,0,2588
329,7,0,5,20,9355620,3612,0,0,2595
330,8,0,8,17,9366480,3609,0,0,2603
331,7,0,8,17,9396720,3611,0,0,2610
332,8,0,7,18,9420240,3607,0,0,2618
333,5,0,8,17,9435240,3608,0,0,2623
334,7,0,8,17,9463560,3609,0,0,2630
335,3,0,1,24,9497880,3608,0,0,2633
336,4,0,2,23,9499920,3605,0,0,2637
337,9,0,8,17,9508380,3604,0,0,2646
338,10,0,11,14,9525660,3601,0,0,2656
339,4,0,5,20,9570840,3604,0,0,2660
340,4,0,4,21,9599220,3608,0,0,2664
341,6,0,8,17,9608520,3609,0,0,2670
342,9,0,8,17,9642840,3610,0,0,2679
343,6,0,9,16,9651240,3606,0,0,2685
344,13,0,10,15,9698100,3607,0,0,2698
345,9,0,13,12,9713460,3605,0,0,2707
346,15,0,15,10,9760860,3605,0,0,2722
347,11,0,11,14,9828660,3610,0,0,2733
348,6,0,9,16,9864120,3613,0,0,2739
349,10,0,9,16,9900720,3613,0,0,2749
350,11,0,10,15,9927900,3610,0,0,2760
351,8,0,7,18,9969180,3610,0,0,2768
352,10,0,9,16,9991140,3608,0,0,2778
353,6,0,5,20,10034520,3610,0,0,2784
354,10,0,11,14,10048800,3610,0,0,2794
355,7,0,8,17,10085460,3610,0,0,2801
356,6,0,8,17,10117020,3614,0,0,2807
357,5,0,6,19,10146120,3615,0,0,2812
358,10,0,7,18,10169760,3612,0,0,2822
359,4,0,7,18,10194240,3616,0,0,2826
360,5,0,7,18,10220700,3619,0,0,2831
361,1,0,3,22,10248840,3622,0,0,2832
362,6,0,3,22,10270680,3622,0,0,2838
363,4,0,5,20,10275960,3622,0,0,2842
364,6,0,7,18,10285380,3620,0,0,2848
365,4,0,5,20,10301460,3618,0,0,2852
366,8,0,5,20,10334940,3619,0,0,2860
367,6,0,7,18,10339440,3616,0,0,2866
368,8,0,9,16,10369680,3619,0,0,2874
369,11,0,11,14,10398360,3618,0,0,2885
370,10,0,12,13,10424880,3615,0,0,2895
371,13,0,15,10,10462080,3616,0,0,2908
372,7,0,12,13,10499760,3616,0,0,2915
373,7,0,7,18,10558740,3622,0,0,2922
374,19,0,16,9,10594860,3622,0,0,2941
375,6,0,12,13,10620900,3618,0,0,2947
376,5,0,7,18,10671480,3623,0,0,2952
377,8,0,7,18,10704660,3625,0,0,2960
378,8,0,7,18,10737660,3626,0,0,2968
379,12,0,9,16,10754820,3619,0,0,2980
380,10,0,12,13,10777560,3619,0,0,2990
381,7,0,10,15,10810440,3619,0,0,2997
382,6,0,8,17,10855860,3624,0,0,3003
383,5,0,7,18,10892640,3629,0,0,3008
384,4,0,7,18,10911780,3631,0,0,3012
385,2,0,5,20,10934640,3633,0,0,3014
386,7,0,7,18,10965960,3638,0,0,3021
387,8,0,6,19,10982400,3632,0,0,3029
388,7,0,7,18,11007060,3633,0,0,3036
389,10,0,10,15,11023440,3630,0,0,3046
390,12,0,10,15,11066760,3630,0,0,3058
391,9,0,10,15,11103840,3632,0,0,3067
392,9,0,9,16,11139360,3632,0,0,3076
393,14,0,14,11,11172600,3632,0,0,3090
394,12,0,14,11,11215260,3631,0,0,3102
395,9,0,9,16,11278200,3635,0,0,3111
396,9,0,9,16,11298720,3631,0,0,3120
397,10,0,9,16,11350020,3636,0,0,3130
398,9,0,7,18,11381280,3633,0,0,3139
399,10,0,11,14,11404920,3634,0,0,3149
400,10,0,10,15,11442060,3633,0,0,3159
401,14,0,15,10,11478840,3634,0,0,3173
402,14,0,14,11,11533680,3634,0,0,3187
403,12,0,16,9,11560980,3632,0,0,3199
404,5,0,7,18,11628240,3637,0,0,3204
405,4,0,5,20,11658120,3639,0,0,3208
406,5,0,9,16,11664240,3640,0,0,3213
407,5,0,8,17,11694840,3643,0,0,3218
408,4,0,3,22,11729940,3643,0,0,3222
409,8,0,6,19,11741340,3641,0,0,3230
410,5,0,5,20,11761320,3641,0,0,3235
411,3,0,4,21,11780460,3642,0,0,3238
412,5,0,3,22,11801760,3642,0,0,3243
413,9,0,5,20,11817420,3639,0,0,3252
414,7,0,6,19,11831580,3637,0,0,3259
415,10,0,7,18,11853000,3633,0,0,3269
416,8,0,4,21,11875020,3628,0,0,3277
417,10,0,9,16,11888700,3626,0,0,3287
418,5,0,2,23,11926620,3625,0,0,3292
419,8,0,8,17,11941860,3627,0,0,3300
420,13,0,13,12,11959440,3624,0,0,3313
421,7,0,12,13,11987760,3623,0,0,3320
422,11,0,5,20,12047820,3622,0,0,3331
423,2,0,1,24,12075780,3624,0,0,3333
424,12,0,9,16,12081660,3621,0,0,3345
425,11,0,12,13,12098580,3617,0,0,3356
426,7,0,8,17,12154560,3622,0,0,3363
427,2,0,2,23,12180660,3621,0,0,3365
428,4,0,4,21,12195540,3624,0,0,3369
429,6,0,5,20,12206340,3622,0,0,3375
430,4,0,5,20,12225060,3623,0,0,3379
431,8,0,10,15,12238320,3624,0,0,3387
432,3,0,5,20,12273540,3625,0,0,3390
433,3,0,5,20,12291420,3627,0,0,3393
434,4,0,3,22,12321840,3630,0,0,3397
435,7,0,6,19,12331440,3629,0,0,3404
436,7,0,9,16,12341700,3627,0,0,3411
437,4,0,5,20,12378240,3629,0,0,3415
438,4,0,4,21,12397800,3630,0,0,3419
439,10,0,10,15,12404940,3628,0,0,3429
440,16,0,15,10,12442800,3627,0,0,3445
441,3,0,7,18,12473280,3624,0,0,3448
442,14,0,11,14,12517920,3627,0,0,3462
443,14,0,14,11,12544980,3623,0,0,3476
444,11,0,8,17,12610500,3624,0,0,3487
445,14,0,10,15,12645660,3622,0,0,3501
446,11,0,6,19,12685140,3618,0,0,3512
447,11,0,11,14,12719040,3621,0,0,3523
448,10,0,12,13,12747240,3620,0,0,3533
449,7,0,11,14,12784860,3622,0,0,3540
450,10,0,14,11,12817500,3624,0,0,3550
451,5,0,6,19,12877140,3628,0,0,3555
452,9,0,8,17,12897600,3626,0,0,3564
453,6,0,8,17,12927840,3629,0,0,3570
454,8,0,8,17,12959280,3630,0,0,3578
455,3,0,5,20,12972060,3627,0,0,3581
456,5,0,3,22,12998820,3627,0,0,3586
457,5,0,4,21,13007160,3626,0,0,3591
458,6,0,5,20,13028820,3627,0,0,3597
459,4,0,2,23,13048200,3625,0,0,3601
460,9,0,9,16,13050060,3624,0,0,3610
461,8,0,12,13,13057680,3621,0,0,3618
462,5,0,8,17,13094580,3622,0,0,3623
463,8,0,7,18,13146060,3627,0,0,3631
464,8,0,10,15,13164000,3627,0,0,3639
465,18,0,16,9,13197420,3624,0,0,3657
466,11,0,10,15,13248300,3621,0,0,3668
467,8,0,9,16,13285740,3623,0,0,3676
468,13,0,11,14,13327320,3623,0,0,3689
469,12,0,13,12,13355880,3621,0,0,3701
470,16,0,17,8,13402440,3622,0,0,3717
471,9,0,6,19,13459500,3618,0,0,3726
472,10,0,7,18,13489440,3617,0,0,3736
473,9,0,9,16,13498440,3613,0,0,3745
474,12,0,12,13,13534680,3614,0,0,3757
475,9,0,9,16,13559760,3609,0,0,3766
476,5,0,6,19,13594140,3610,0,0,3771
477,3,0,2,23,13627800,3612,0,0,3774
478,2,0,1,24,13633380,3611,0,0,3776
479,1,0,2,23,13633380,3611,0,0,3777
480,3,0,1,24,13643880,3610,0,0,3780
481,5,0,3,22,13649280,3609,0,0,3785
482,5,0,5,20,13659600,3608,0,0,3790
483,10,0,10,15,13668720,3606,0,0,3800
484,6,0,10,15,13687260,3605,0,0,3806
485,7,0,7,18,13728660,3607,0,0,3813
486,11,0,11,14,13758420,3608,0,0,3824
487,9,0,10,15,13799520,3609,0,0,3833
488,15,0,12,13,13841400,3608,0,0,3848
489,9,0,8,17,13888080,3608,0,0,3857
490,10,0,9,16,13918380,3607,0,0,3867
491,8,0,6,19,13954860,3606,0,0,3875
492,10,0,9,16,13972440,3604,0,0,3885
493,7,0,9,16,13986240,3601,0,0,3892
494,7,0,6,19,14034480,3605,0,0,3899
495,4,0,5,20,14052540,3605,0,0,3903
496,7,0,7,18,14071260,3605,0,0,3910
497,10,0,7,18,14100960,3603,0,0,3920
498,9,0,11,14,14116680,3603,0,0,3929
499,9,0,11,14,14138220,3600,0,0,3938
500,8,0,9,16,14177520,3601,0,0,3946
501,7,0,7,18,14202900,3599,0,0,3953
502,2,0,3,22,14235780,3602,0,0,3955
503,4,0,3,22,14257980,3604,0,0,3959
504,3,0,2,23,14267880,3603,0,0,3962
505,6,0,4,21,14274660,3601,0,0,3968
506,3,0,3,22,14296680,3602,0,0,3971
507,5,0,7,18,14302740,3603,0,0,3976
508,6,0,5,20,14327460,3602,0,0,3982
509,3,0,3,22,14344860,3602,0,0,3985
510,6,0,7,18,14346180,3600,0,0,3991
511,7,0,8,17,14368920,3601,0,0,3998
512,4,0,3,22,14409180,3603,0,0,4002
513,10,0,10,15,14422440,3603,0,0,4012
514,8,0,7,18,14446200,3599,0,0,4020
515,15,0,12,13,14471940,3597,0,0,4035
516,9,0,11,14,14511360,3598,0,0,4044
517,9,0,10,15,14553060,3599,0,0,4053
518,12,0,8,17,14587980,3595,0,0,4065
519,11,0,12,13,14609880,3594,0,0,4076
520,11,0,11,14,14647500,3593,0,0,4087
521,9,0,6,19,14689980,3591,0,0,4096
522,15,0,11,14,14718240,3589,0,0,4111
523,6,0,9,16,14745600,3589,0,0,4117
524,5,0,4,21,14792520,3592,0,0,4122
525,4,0,2,23,14813520,3592,0,0,4126
526,7,0,5,20,14825880,3591,0,0,4133
527,4,0,6,19,14833320,3590,0,0,4137
528,7,0,9,16,14849340,3591,0,0,4144
529,3,0,4,21,14881440,3591,0,0,4147
530,6,0,5,20,14904540,3593,0,0,4153
531,3,0,7,18,14909160,3593,0,0,4156
532,10,0,12,13,14930340,3594,0,0,4166
533,7,0,10,15,14972700,3596,0,0,4173
534,10,0,14,11,14994420,3596,0,0,4183
535,11,0,9,16,15058740,3598,0,0,4194
536,3,0,3,22,15101880,3600,0,0,4197
537,7,0,6,19,15110940,3599,0,0,4204
538,16,0,16,9,15121020,3596,0,0,4220
539,9,0,9,16,15173100,3595,0,0,4229
540,13,0,13,12,15207360,3595,0,0,4242
541,7,0,9,16,15245040,3595,0,0,4249
542,9,0,9,16,15284700,3597,0,0,4258
543,10,0,10,15,15320820,3598,0,0,4268
544,15,0,14,11,15364740,3599,0,0,4283
545,11,0,15,10,15400860,3599,0,0,4294
546,5,0,10,15,15449640,3602,0,0,4299
547,5,0,5,20,15504060,3606,0,0,4304
548,4,0,2,23,15534060,3607,0,0,4308
549,2,0,2,23,15537780,3606,0,0,4310
550,5,0,4,21,15550680,3607,0,0,4315
551,4,0,6,19,15552300,3605,0,0,4319
552,8,0,12,13,15553800,3604,0,0,4327
553,5,0,3,22,15612420,3606,0,0,4332
554,8,0,7,18,15627660,3606,0,0,4340
555,3,0,6,19,15642780,3606,0,0,4343
556,7,0,4,21,15676020,3606,0,0,4350
557,6,0,6,19,15690960,3607,0,0,4356
558,12,0,12,13,15712740,3607,0,0,4368
559,5,0,6,19,15757080,3608,0,0,4373
560,8,0,5,20,15783300,3606,0,0,4381
561,7,0,8,17,15796740,3606,0,0,4388
562,7,0,8,17,15821340,3606,0,0,4395
563,5,0,4,21,15860760,3607,0,0,4400
564,12,0,10,15,15874920,3606,0,0,4412
565,8,0,10,15,15910200,3607,0,0,4420
566,14,0,13,12,15963240,3610,0,0,4434
567,5,0,9,16,15996000,3610,0,0,4439
568,4,0,4,21,16051980,3616,0,0,4443
569,7,0,6,19,16064700,3614,0,0,4450
570,6,0,9,16,16078500,3615,0,0,4456
571,5,0,7,18,16102860,3615,0,0,4461
572,8,0,7,18,16143000,3617,0,0,4469
573,5,0,5,20,16162140,3616,0,0,4474
574,6,0,3,22,16190700,3616,0,0,4480
575,5,0,5,20,16196760,3615,0,0,4485
576,5,0,6,19,16205820,3614,0,0,4490
577,1,0,0,25,16228920,3613,0,0,4491
578,6,0,6,19,16228920,3613,0,0,4497
579,2,0,4,21,16239540,3612,0,0,4499
580,11,0,8,17,16272480,3614,0,0,4510
581,3,0,7,18,16284240,3613,0,0,4513
582,4,0,3,22,16322040,3615,0,0,4517
583,11,0,4,21,16343340,3612,0,0,4528
584,10,0,8,17,16352760,3609,0,0,4538
585,14,0,12,13,16378080,3607,0,0,4552
586,6,0,10,15,16408140,3607,0,0,4558
587,5,0,10,15,16428600,3608,0,0,4563
588,5,0,6,19,16477800,3611,0,0,4568
589,18,0,14,11,16511700,3611,0,0,4586
590,7,0,12,13,16543920,3611,0,0,4593
591,8,0,7,18,16585920,3610,0,0,4601
592,8,0,5,20,16629540,3611,0,0,4609
593,11,0,7,18,16649760,3609,0,0,4620
594,11,0,9,16,16673160,3607,0,0,4631
595,4,0,6,19,16703580,3608,0,0,4635
596,8,0,8,17,16723320,3608,0,0,4643
597,8,0,9,16,16755660,3609,0,0,4651
598,3,0,4,21,16787340,3610,0,0,4654
599,6,0,7,18,16799940,3610,0,0,4660
600,9,0,9,16,16820460,3609,0,0,4669
601,7,0,8,17,16850520,3609,0,0,4676
602,7,0,7,18,16881120,3610,0,0,4683
603,3,0,6,19,16895160,3610,0,0,4686
604,5,0,3,22,16923300,3609,0,0,4691
605,5,0,4,21,16933380,3608,0,0,4696
606,9,0,5,20,16952820,3606,0,0,4705
607,3,0,3,22,16967760,3606,0,0,4708
608,6,0,6,19,16980360,3606,0,0,4714
609,8,0,7,18,17006760,3606,0,0,4722
610,10,0,9,16,17029680,3605,0,0,4732
611,7,0,6,19,17069580,3606,0,0,4739
612,8,0,8,17,17093820,3607,0,0,4747
613,10,0,9,16,17119020,3605,0,0,4757
614,13,0,14,11,17146140,3605,0,0,4770
615,6,0,9,16,17191080,3606,0,0,4776
616,12,0,12,13,17230320,3607,0,0,4788
617,6,0,5,20,17274660,3607,0,0,4794
618,15,0,13,12,17296320,3606,0,0,4809
619,11,0,11,14,17339580,3605,0,0,4820
620,9,0,5,20,17384160,3603,0,0,4829
621,8,0,9,16,17402040,3604,0,0,4837
622,4,0,6,19,17434020,3605,0,0,4841
623,12,0,11,14,17454420,3604,0,0,4853
624,4,0,3,22,17486640,3602,0,0,4857
625,7,0,5,20,17499600,3601,0,0,4864
626,5,0,5,20,17523600,3602,0,0,4869
627,6,0,5,20,17539320,3601,0,0,4875
628,10,0,11,14,17553780,3601,0,0,4885
629,8,0,13,12,17577720,3601,0,0,4893
630,10,0,10,15,17640240,3605,0,0,4903
631,5,0,8,17,17667000,3605,0,0,4908
632,7,0,8,17,17695500,3606,0,0,4915
633,8,0,6,19,17730540,3605,0,0,4923
634,9,0,10,15,17754420,3607,0,0,4932
635,16,0,13,12,17798280,3606,0,0,4948
636,11,0,14,11,17830320,3605,0,0,4959
637,16,0,12,13,17908800,3608,0,0,4975
638,10,0,11,14,17946480,3608,0,0,4985
639,15,0,16,9,17988540,3609,0,0,5000
640,10,0,8,17,18042180,3606,0,0,5010
641,7,0,7,18,18074460,3607,0,0,5017
642,6,0,4,21,18103260,3606,0,0,5023
643,9,0,8,17,18114360,3605,0,0,5032
644,6,0,7,18,18131460,3603,0,0,5038
645,6,0,7,18,18154740,3604,0,0,5044
646,3,0,7,18,18167280,3604,0,0,5047
647,7,0,4,21,18223800,3608,0,0,5054
648,7,0,7,18,18236640,3608,0,0,5061
649,6,0,4,21,18264120,3607,0,0,5067
650,3,0,6,19,18268200,3607,0,0,5070
651,7,0,8,17,18292860,3608,0,0,5077
652,9,0,5,20,18339120,3609,0,0,5086
653,11,0,7,18,18359280,3606,0,0,5097
654,8,0,8,17,18374400,3604,0,0,5105
655,13,0,12,13,18407580,3605,0,0,5118
656,11,0,9,16,18447120,3602,0,0,5129
657,9,0,14,11,18462240,3603,0,0,5138
658,12,0,14,11,18504960,3602,0,0,5150
659,5,0,6,19,18570120,3606,0,0,5155
660,10,0,9,16,18597600,3606,0,0,5165
661,12,0,14,11,18619020,3606,0,0,5177
662,12,0,14,11,18664380,3606,0,0,5189
663,9,0,14,11,18705360,3608,0,0,5198
664,16,0,16,9,18758880,3608,0,0,5214
665,11,0,17,8,18783480,3606,0,0,5225
666,8,0,7,18,18876300,3611,0,0,5233
667,8,0,5,20,18910740,3611,0,0,5241
668,1,0,1,24,18929100,3611,0,0,5242
669,8,0,6,19,18933180,3610,0,0,5250
670,6,0,6,19,18948180,3609,0,0,5256
671,3,0,4,21,18965640,3609,0,0,5259
672,4,0,5,20,18981900,3610,0,0,5263
673,5,0,10,15,18981900,3610,0,0,5268
674,4,0,7,18,19001760,3609,0,0,5272
675,3,0,7,18,19016760,3609,0,0,5275
676,4,0,6,19,19031400,3609,0,0,5279
677,6,0,10,15,19038660,3609,0,0,5285
678,6,0,9,16,19051140,3606,0,0,5291
679,4,0,8,17,19077180,3608,0,0,5295
680,7,0,11,14,19095540,3609,0,0,5302
681,13,0,15,10,19121820,3607,0,0,5315
682,6,0,13,12,19154580,3608,0,0,5321
683,11,0,16,9,19187340,3609,0,0,5332
684,11,0,14,11,19224420,3607,0,0,5343
685,10,0,12,13,19268940,3607,0,0,5353
686,7,0,15,10,19284780,3608,0,0,5360
687,17,0,18,7,19340880,3609,0,0,5377
688,16,0,20,5,19383240,3607,0,0,5393
689,6,0,13,12,19425660,3606,0,0,5399
690,10,0,12,13,19482600,3609,0,0,5409
691,6,0,14,11,19490220,3608,0,0,5415
692,0,0,7,18,19534680,3612,0,0,5415
693,7,0,10,15,19557720,3613,0,0,5422
694,6,0,12,13,19567500,3612,0,0,5428
695,2,0,7,18,19598940,3614,0,0,5430
696,10,0,10,15,19616580,3612,0,0,5440
697,6,0,11,14,19627500,3611,0,0,5446
698,4,0,10,15,19640100,3610,0,0,5450
699,6,0,10,15,19667940,3611,0,0,5456
700,3,0,9,16,19692960,3613,0,0,5459
701,7,0,8,17,19719660,3612,0,0,5466
702,6,0,8,17,19736940,3612,0,0,5472
703,3,0,7,18,19752480,3612,0,0,5475
704,8,0,12,13,19755780,3610,0,0,5483
705,6,0,10,15,19774860,3609,0,0,5489
706,11,0,11,14,19815900,3610,0,0,5500
707,8,0,12,13,19839600,3609,0,0,5508
708,6,0,9,16,19877460,3610,0,0,5514
709,10,0,12,13,19897320,3609,0,0,5524
710,12,0,15,10,19919940,3608,0,0,5536
711,5,0,12,13,19948920,3608,0,0,5541
712,4,0,9,16,19990860,3611,0,0,5545
713,7,0,11,14,20008860,3611,0,0,5552
714,11,0,15,10,20031480,3610,0,0,5563
715,7,0,12,13,20058720,3608,0,0,5570
716,9,0,13,12,20094180,3610,0,0,5579
717,10,0,13,12,20120760,3608,0,0,5589
718,6,0,12,13,20148840,3608,0,0,5595
719,6,0,12,13,20173380,3609,0,0,5601
720,3,0,8,17,20206620,3610,0,0,5604
721,2,0,7,18,20219460,3611,0,0,5606
722,4,0,6,19,20236140,3611,0,0,5610
723,5,0,10,15,20236980,3610,0,0,5615
724,9,0,12,13,20262660,3610,0,0,5624
725,8,0,11,14,20281620,3608,0,0,5632
726,11,0,13,12,20321520,3609,0,0,5643
727,6,0,10,15,20345520,3608,0,0,5649
728,8,0,10,15,20381580,3609,0,0,5657
729,7,0,11,14,20393760,3607,0,0,5664
730,7,0,12,13,20410860,3606,0,0,5671
731,13,0,14,11,20451660,3606,0,0,5684
732,17,0,20,5,20480280,3605,0,0,5701
733,7,0,18,7,20522520,3606,0,0,5708
734,9,0,11,14,20595240,3609,0,0,5717
735,9,0,13,12,20616060,3608,0,0,5726
736,11,0,17,8,20641080,3608,0,0,5737
737,11,0,17,8,20699100,3611,0,0,5748
738,10,0,14,11,20741580,3610,0,0,5758
739,8,0,10,15,20786100,3611,0,0,5766
740,7,0,11,14,20806380,3610,0,0,5773
741,6,0,9,16,20834700,3610,0,0,5779
742,7,0,11,14,20856840,3611,0,0,5786
743,4,0,10,15,20872380,3611,0,0,5790
744,2,0,7,18,20914800,3615,0,0,5792
745,6,0,6,19,20935440,3614,0,0,5798
746,5,0,8,17,20940960,3613,0,0,5803
747,6,0,11,14,20953320,3613,0,0,5809
748,6,0,8,17,20974440,3611,0,0,5815
749,7,0,12,13,20979840,3610,0,0,5822
750,9,0,13,12,21005880,3610,0,0,5831
751,10,0,13,12,21042000,3610,0,0,5841
752,9,0,18,7,21059700,3611,0,0,5850
753,4,0,14,11,21098520,3612,0,0,5854
754,9,0,12,13,21149400,3614,0,0,5863
755,13,0,18,7,21186300,3616,0,0,5876
756,4,0,14,11,21224700,3618,0,0,5880
757,13,0,14,11,21291180,3621,0,0,5893
758,8,0,15,10,21302640,3619,0,0,5901
759,8,0,11,14,21349860,3619,0,0,5909
760,9,0,14,11,21371760,3619,0,0,5918
761,10,0,17,8,21389760,3618,0,0,5928
762,7,0,13,12,21443700,3621,0,0,5935
763,6,0,11,14,21477540,3621,0,0,5941
764,6,0,10,15,21491220,3619,0,0,5947
765,7,0,10,15,21512160,3619,0,0,5954
766,9,0,10,15,21538260,3618,0,0,5963
767,3,0,9,16,21558360,3618,0,0,5966
768,6,0,10,15,21581400,3619,0,0,5972
769,5,0,11,14,21591060,3619,0,0,5977
770,5,0,12,13,21604980,3618,0,0,5982
771,7,0,11,14,21638040,3619,0,0,5989
772,8,0,14,11,21661440,3620,0,0,5997
773,10,0,12,13,21712980,3621,0,0,6007
774,7,0,13,12,21735240,3621,0,0,6014
775,5,0,8,17,21773280,3622,0,0,6019
776,4,0,6,19,21790020,3621,0,0,6023
777,11,0,10,15,21807420,3620,0,0,6034
778,12,0,15,10,21826320,3619,0,0,6046
779,7,0,15,10,21844440,3617,0,0,6053
780,12,0,14,11,21893160,3618,0,0,6065
781,11,0,16,9,21932400,3619,0,0,6076
782,12,0,16,9,21969060,3618,0,0,6088
783,8,0,14,11,22007880,3618,0,0,6096
784,8,0,13,12,22042020,3618,0,0,6104
785,2,0,6,19,22077240,3619,0,0,6106
786,7,0,8,17,22095240,3619,0,0,6113
787,9,0,12,13,22103460,3617,0,0,6122
788,8,0,13,12,22125300,3617,0,0,6130
789,8,0,14,11,22147620,3616,0,0,6138
790,5,0,8,17,22195680,3617,0,0,6143
791,6,0,9,16,22210920,3617,0,0,6149
792,5,0,6,19,22237860,3617,0,0,6154
793,7,0,11,14,22242660,3616,0,0,6161
794,1,0,7,18,22265220,3617,0,0,6162
795,6,0,9,16,22279260,3617,0,0,6168
796,3,0,8,17,22291200,3616,0,0,6171
797,7,0,11,14,22304100,3616,0,0,6178
798,8,0,13,12,22321260,3615,0,0,6186
799,10,0,12,13,22353240,3614,0,0,6196
800,6,0,10,15,22376340,3613,0,0,6202
801,11,0,12,13,22403700,3612,0,0,6213
802,4,0,10,15,22427040,3613,0,0,6217
803,8,0,10,15,22450200,3612,0,0,6225
804,15,0,18,7,22475520,3612,0,0,6240
805,12,0,17,8,22515300,3611,0,0,6252
806,9,0,13,12,22564440,3611,0,0,6261
807,10,0,11,14,22604400,3610,0,0,6271
808,11,0,15,10,22622100,3609,0,0,6282
809,10,0,13,12,22668240,3610,0,0,6292
810,9,0,9,16,22708800,3609,0,0,6301
811,6,0,10,15,22730760,3609,0,0,6307
812,8,0,9,16,22756680,3608,0,0,6315
813,4,0,10,15,22771560,3609,0,0,6319
814,9,0,13,12,22787820,3608,0,0,6328
815,3,0,9,16,22810080,3608,0,0,6331
816,2,0,5,20,22852560,3611,0,0,6333
817,6,0,8,17,22855380,3610,0,0,6339
818,6,0,9,16,22868700,3609,0,0,6345
819,9,0,14,11,22890660,3610,0,0,6354
820,8,0,14,11,22910220,3609,0,0,6362
821,5,0,10,15,22948980,3610,0,0,6367
822,7,0,11,14,22981440,3611,0,0,6374
823,6,0,10,15,23004660,3611,0,0,6380
824,9,0,12,13,23029740,3611,0,0,6389
825,10,0,15,10,23042640,3609,0,0,6399
826,12,0,14,11,23083320,3608,0,0,6411
827,16,0,21,4,23117700,3608,0,0,6427
828,13,0,13,12,23184480,3607,0,0,6440
829,8,0,12,13,23212560,3606,0,0,6448
830,11,0,12,13,23255640,3607,0,0,6459
831,11,0,12,13,23288940,3606,0,0,6470
832,14,0,16,9,23306880,3603,0,0,6484
833,12,0,15,10,23336340,3600,0,0,6496
834,8,0,15,10,23365800,3600,0,0,6504
835,9,0,13,12,23399220,3599,0,0,6513
836,5,0,10,15,23439480,3601,0,0,6518
837,2,0,10,15,23453040,3602,0,0,6520
838,4,0,8,17,23478900,3603,0,0,6524
839,3,0,9,16,23484660,3603,0,0,6527
840,3,0,9,16,23501400,3603,0,0,6530
841,4,0,10,15,23515440,3604,0,0,6534
842,5,0,9,16,23536020,3604,0,0,6539
843,2,0,8,17,23551680,3605,0,0,6541
844,7,0,11,14,23569800,3605,0,0,6548
845,8,0,14,11,23581140,3604,0,0,6556
846,5,0,10,15,23622600,3605,0,0,6561
847,9,0,10,15,23655540,3606,0,0,6570
848,11,0,15,10,23669760,3604,0,0,6581
849,16,0,21,4,23709360,3605,0,0,6597
850,9,0,15,10,23775600,3607,0,0,6606
851,13,0,16,9,23809500,3605,0,0,6619
852,10,0,15,10,23839200,3604,0,0,6629
853,9,0,12,13,23886720,3604,0,0,6638
854,12,0,15,10,23914380,3604,0,0,6650
855,10,0,14,11,23953080,3604,0,0,6660
856,9,0,10,15,23994000,3603,0,0,6669
857,12,0,15,10,24018120,3603,0,0,6681
858,8,0,6,19,24069720,3601,0,0,6689
859,5,0,8,17,24074460,3600,0,0,6694
860,8,0,10,15,24094980,3600,0,0,6702
861,10,0,15,10,24103980,3599,0,0,6712
862,4,0,8,17,24144840,3599,0,0,6716
863,4,0,6,19,24174360,3600,0,0,6720
864,6,0,7,18,24186060,3599,0,0,6726
865,4,0,7,18,24192120,3598,0,0,6730
866,6,0,9,16,24204300,3598,0,0,6736
867,6,0,12,13,24210180,3597,0,0,6742
868,3,0,9,16,24236580,3598,0,0,6745
869,7,0,9,16,24255960,3597,0,0,6752
870,7,0,11,14,24274620,3597,0,0,6759
871,9,0,15,10,24286920,3596,0,0,6768
872,10,0,20,5,24299640,3595,0,0,6778
873,7,0,12,13,24376020,3598,0,0,6785
874,6,0,13,12,24398760,3599,0,0,6791
875,15,0,16,9,24438180,3599,0,0,6806
876,13,0,16,9,24478020,3598,0,0,6819
877,9,0,17,8,24505980,3598,0,0,6828
878,8,0,15,10,24555000,3599,0,0,6836
879,8,0,15,10,24573420,3598,0,0,6844
880,9,0,12,13,24640920,3601,0,0,6853
881,10,0,17,8,24655620,3601,0,0,6863
882,13,0,19,6,24690300,3600,0,0,6876
883,7,0,10,15,24768300,3603,0,0,6883
884,8,0,13,12,24784200,3603,0,0,6891
885,3,0,8,17,24819420,3604,0,0,6894
886,3,0,6,19,24834180,3603,0,0,6897
887,4,0,8,17,24848820,3604,0,0,6901
888,2,0,8,17,24855060,3604,0,0,6903
889,8,0,12,13,24873000,3605,0,0,6911
890,4,0,8,17,24898860,3604,0,0,6915
891,2,0,7,18,24914220,3605,0,0,6917
892,1,0,7,18,24920160,3605,0,0,6918
893,8,0,9,16,24930300,3604,0,0,6926
894,6,0,10,15,24951600,3604,0,0,6932
895,8,0,13,12,24971520,3604,0,0,6940
896,8,0,14,11,24996060,3604,0,0,6948
897,16,0,16,9,25039680,3603,0,0,6964
898,15,0,21,4,25065060,3602,0,0,6979
899,8,0,16,9,25122240,3603,0,0,6987
900,11,0,16,9,25169940,3604,0,0,6998
901,9,0,15,10,25210440,3605,0,0,7007
902,9,0,13,12,25255620,3606,0,0,7016
903,6,0,10,15,25289880,3606,0,0,7022
904,10,0,13,12,25312980,3606,0,0,7032
905,8,0,12,13,25340040,3605,0,0,7040
906,4,0,8,17,25378140,3606,0,0,7044
907,11,0,11,14,25398660,3605,0,0,7055
908,14,0,16,9,25419420,3604,0,0,7069
909,12,0,18,7,25453920,3603,0,0,7081
910,7,0,10,15,25515600,3604,0,0,7088
911,8,0,6,19,25552260,3603,0,0,7096
912,6,0,9,16,25560900,3603,0,0,7102
913,4,0,6,19,25573860,3601,0,0,7106
914,5,0,9,16,25581960,3602,0,0,7111
915,5,0,7,18,25604520,3601,0,0,7116
916,9,0,15,10,25605360,3601,0,0,7125
917,6,0,11,14,25637520,3600,0,0,7131
918,12,0,15,10,25667400,3600,0,0,7143
919,10,0,15,10,25700820,3600,0,0,7153
920,11,0,17,8,25726320,3599,0,0,7164
921,10,0,12,13,25784460,3600,0,0,7174
922,17,0,19,6,25809900,3598,0,0,7191
923,13,0,19,6,25865220,3599,0,0,7204
924,11,0,18,7,25905300,3599,0,0,7215
925,13,0,18,7,25963440,3601,0,0,7228
926,17,0,21,4,26020680,3601,0,0,7245
927,7,0,16,9,26066640,3602,0,0,7252
928,8,0,16,9,26133240,3607,0,0,7260
929,5,0,12,13,26171820,3608,0,0,7265
930,13,0,14,11,26206740,3607,0,0,7278
931,9,0,12,13,26259780,3609,0,0,7287
932,6,0,14,11,26271840,3609,0,0,7293
933,3,0,9,16,26308140,3610,0,0,7296
934,5,0,11,14,26320680,3610,0,0,7301
935,4,0,10,15,26342820,3611,0,0,7305
936,7,0,11,14,26379600,3613,0,0,7312
937,5,0,9,16,26413740,3614,0,0,7317
938,9,0,14,11,26431920,3614,0,0,7326
939,5,0,12,13,26454060,3614,0,0,7331
940,11,0,12,13,26485140,3613,0,0,7342
941,2,0,9,16,26514720,3614,0,0,7344
942,9,0,11,14,26541180,3614,0,0,7353
943,8,0,13,12,26559360,3614,0,0,7361
944,9,0,14,11,26585280,3614,0,0,7370
945,15,0,15,10,26629800,3613,0,0,7385
946,7,0,10,15,26661960,3611,0,0,7392
947,10,0,11,14,26698800,3612,0,0,7402
948,8,0,14,11,26710500,3611,0,0,7410
949,9,0,18,7,26734860,3612,0,0,7419
950,10,0,14,11,26786700,3612,0,0,7429
951,14,0,14,11,26826060,3610,0,0,7443
952,10,0,16,9,26868000,3612,0,0,7453
953,12,0,16,9,26912520,3612,0,0,7465
954,7,0,8,17,26960580,3612,0,0,7472
955,11,0,13,12,26977320,3611,0,0,7483
956,8,0,14,11,26998920,3610,0,0,7491
957,4,0,8,17,27045660,3612,0,0,7495
958,7,0,10,15,27059040,3611,0,0,7502
959,6,0,10,15,27078180,3611,0,0,7508
960,5,0,9,16,27098640,3611,0,0,7513
961,6,0,9,16,27124320,3611,0,0,7519
962,2,0,10,15,27125700,3611,0,0,7521
963,3,0,6,19,27156540,3612,0,0,7524
964,5,0,7,18,27165480,3611,0,0,7529
965,3,0,8,17,27174060,3611,0,0,7532
966,12,0,16,9,27184620,3611,0,0,7544
967,15,0,18,7,27220440,3609,0,0,7559
968,11,0,15,10,27280020,3610,0,0,7570
969,13,0,15,10,27321420,3610,0,0,7583
970,8,0,10,15,27370080,3610,0,0,7591
971,9,0,10,15,27398880,3609,0,0,7600
972,15,0,14,11,27428820,3608,0,0,7615
973,11,0,17,8,27449400,3607,0,0,7626
974,11,0,14,11,27502620,3607,0,0,7637
975,11,0,20,5,27522060,3608,0,0,7648
976,12,0,15,10,27593100,3609,0,0,7660
977,12,0,16,9,27637140,3609,0,0,7672
978,7,0,12,13,27671640,3609,0,0,7679
979,10,0,13,12,27692100,3607,0,0,7689
980,4,0,12,13,27707820,3607,0,0,7693
981,5,0,10,15,27745980,3608,0,0,7698
982,7,0,13,12,27759960,3608,0,0,7705
983,2,0,8,17,27799920,3610,0,0,7707
984,7,0,9,16,27831660,3612,0,0,7714
985,1,0,9,16,27835320,3612,0,0,7715
986,5,0,7,18,27868740,3613,0,0,7720
987,4,0,8,17,27879480,3613,0,0,7724
988,8,0,13,12,27890880,3613,0,0,7732
989,8,0,16,9,27910260,3613,0,0,7740
990,7,0,13,12,27945900,3613,0,0,7747
991,7,0,10,15,27987600,3614,0,0,7754
992,5,0,9,16,28010040,3614,0,0,7759
993,6,0,10,15,28031220,3614,0,0,7765
994,8,0,14,11,28042860,3614,0,0,7773
995,11,0,13,12,28071300,3612,0,0,7784
996,9,0,14,11,28104600,3612,0,0,7793
997,10,0,13,12,28147560,3613,0,0,7803
998,14,0,16,9,28183140,3612,0,0,7817
999,10,0,13,12,28227540,3612,0,0,7827
1000,12,0,15,10,28259820,3611,0,0,7839
1001,11,0,13,12,28302420,3611,0,0,7850
1002,7,0,16,9,28326480,3612,0,0,7857
1003,9,0,14,11,28375920,3613,0,0,7866
1004,4,0,10,15,28403220,3613,0,0,7870
1005,8,0,10,15,28433100,3613,0,0,7878
1006,9,0,16,9,28443060,3613,0,0,7887
1007,3,0,13,12,28468620,3614,0,0,7890
1008,7,0,12,13,28516560,3616,0,0,7897
1009,7,0,13,12,28540980,3616,0,0,7904
1010,5,0,10,15,28578480,3617,0,0,7909
1011,4,0,10,15,28598940,3618,0,0,7913
1012,11,0,12,13,28629120,3618,0,0,7924
1013,6,0,10,15,28654080,3617,0,0,7930
1014,1,0,5,20,28686780,3619,0,0,7931
1015,5,0,8,17,28696020,3619,0,0,7936
1016,4,0,9,16,28703520,3619,0,0,7940
1017,5,0,8,17,28723680,3618,0,0,7945
1018,9,0,11,14,28736100,3617,0,0,7954
1019,7,0,12,13,28762560,3618,0,0,7961
1020,10,0,19,6,28770540,3618,0,0,7971
1021,12,0,16,9,28812480,3616,0,0,7983
1022,11,0,12,13,28871820,3617,0,0,7994
1023,8,0,11,14,28897740,3616,0,0,8002
1024,7,0,8,17,28931820,3616,0,0,8009
1025,7,0,11,14,28953060,3616,0,0,8016
1026,7,0,11,14,28970880,3615,0,0,8023
1027,11,0,11,14,29000820,3614,0,0,8034
1028,10,0,11,14,29029020,3613,0,0,8044
1029,5,0,14,11,29037240,3613,0,0,8049
1030,3,0,9,16,29073060,3614,0,0,8052
1031,5,0,10,15,29094780,3615,0,0,8057
1032,3,0,7,18,29117580,3615,0,0,8060
1033,5,0,8,17,29127420,3615,0,0,8065
1034,5,0,10,15,29144400,3615,0,0,8070
1035,6,0,9,16,29170200,3615,0,0,8076
1036,7,0,10,15,29198580,3616,0,0,8083
1037,7,0,11,14,29226120,3617,0,0,8090
1038,8,0,12,13,29250120,3617,0,0,8098
1039,11,0,11,14,29282280,3615,0,0,8109
1040,10,0,10,15,29313240,3614,0,0,8119
1041,8,0,11,14,29330700,3613,0,0,8127
1042,9,0,14,11,29351700,3613,0,0,8136
1043,10,0,13,12,29388780,3613,0,0,8146
1044,10,0,13,12,29428020,3613,0,0,8156
1045,9,0,13,12,29460780,3613,0,0,8165
1046,7,0,8,17,29500200,3613,0,0,8172
1047,6,0,10,15,29518620,3613,0,0,8178
1048,10,0,16,9,29529720,3613,0,0,8188
1049,10,0,13,12,29579340,3613,0,0,8198
1050,8,0,15,10,29599200,3613,0,0,8206
1051,8,0,15,10,29639340,3614,0,0,8214
1052,2,0,10,15,29674680,3616,0,0,8216
1053,5,0,6,19,29715420,3617,0,0,8221
1054,3,0,7,18,29718780,3616,0,0,8224
1055,7,0,10,15,29725860,3615,0,0,8231
1056,2,0,8,17,29736180,3615,0,0,8233
1057,4,0,7,18,29758740,3615,0,0,8237
1058,4,0,7,18,29772900,3615,0,0,8241
1059,10,0,11,14,29785800,3614,0,0,8251
1060,7,0,11,14,29800200,3613,0,0,8258
1061,9,0,14,11,29815560,3612,0,0,8267
1062,8,0,11,14,29868480,3614,0,0,8275
1063,8,0,10,15,29892960,3613,0,0,8283
1064,9,0,12,13,29918760,3613,0,0,8292
1065,13,0,21,4,29937060,3613,0,0,8305
1066,9,0,17,8,29999220,3615,0,0,8314
1067,7,0,14,11,30037680,3615,0,0,8321
1068,7,0,9,16,30092820,3617,0,0,8328
1069,15,0,14,11,30127560,3617,0,0,8343
1070,10,0,13,12,30165900,3617,0,0,8353
1071,11,0,19,6,30188100,3617,0,0,8364
1072,12,0,13,12,30258000,3618,0,0,8376
1073,8,0,14,11,30288120,3618,0,0,8384
1074,5,0,11,14,30320160,3619,0,0,8389
1075,9,0,13,12,30347700,3619,0,0,8398
1076,10,0,16,9,30389280,3621,0,0,8408
1077,7,0,14,11,30418200,3620,0,0,8415
1078,5,0,8,17,30453960,3620,0,0,8420
1079,6,0,7,18,30473340,3619,0,0,8426
1080,6,0,9,16,30481020,3618,0,0,8432
1081,7,0,9,16,30496860,3617,0,0,8439
1082,8,0,12,13,30512220,3617,0,0,8447
1083,3,0,10,15,30537780,3618,0,0,8450
1084,8,0,11,14,30567300,3618,0,0,8458
1085,6,0,9,16,30588960,3617,0,0,8464
1086,5,0,11,14,30599400,3617,0,0,8469
1087,6,0,10,15,30620220,3617,0,0,8475
1088,9,0,10,15,30661560,3618,0,0,8484
1089,4,0,6,19,30684840,3617,0,0,8488
1090,11,0,12,13,30694620,3616,0,0,8499
1091,7,0,14,11,30707520,3616,0,0,8506
1092,20,0,23,2,30748200,3616,0,0,8526
1093,13,0,21,4,30792000,3614,0,0,8539
1094,9,0,14,11,30850260,3614,0,0,8548
1095,12,0,12,13,30899100,3614,0,0,8560
1096,14,0,16,9,30922080,3613,0,0,8574
1097,10,0,17,8,30957120,3613,0,0,8584
1098,10,0,12,13,31017180,3614,0,0,8594
1099,8,0,14,11,31036620,3613,0,0,8602
1100,8,0,14,11,31081500,3615,0,0,8610
1101,11,0,15,10,31103820,3614,0,0,8621
1102,7,0,13,12,31131960,3613,0,0,8628
1103,3,0,9,16,31173120,3615,0,0,8631
1104,9,0,9,16,31204020,3615,0,0,8640
1105,4,0,10,15,31208760,3614,0,0,8644
1106,4,0,11,14,31228860,3615,0,0,8648
1107,8,0,14,11,31245060,3615,0,0,8656
1108,6,0,13,12,31278840,3616,0,0,8662
1109,3,0,6,19,31330740,3618,0,0,8665
1110,3,0,7,18,31337880,3618,0,0,8668
1111,15,0,15,10,31345440,3616,0,0,8683
1112,9,0,12,13,31380900,3615,0,0,8692
1113,7,0,11,14,31410840,3615,0,0,8699
1114,7,0,10,15,31439820,3615,0,0,8706
1115,10,0,16,9,31455420,3615,0,0,8716
1116,10,0,15,10,31485180,3614,0,0,8726
1117,10,0,11,14,31531080,3613,0,0,8736
1118,7,0,11,14,31561920,3614,0,0,8743
1119,8,0,13,12,31579980,3614,0,0,8751
1120,7,0,12,13,31614900,3614,0,0,8758
1121,9,0,9,16,31641060,3612,0,0,8767
1122,7,0,10,15,31664160,3612,0,0,8774
1123,8,0,13,12,31682220,3612,0,0,8782
1124,8,0,14,11,31709340,3613,0,0,8790
1125,4,0,10,15,31738320,3613,0,0,8794
1126,2,0,6,19,31764600,3613,0,0,8796
1127,9,0,10,15,31799340,3615,0,0,8805
1128,2,0,9,16,31807620,3615,0,0,8807
1129,5,0,10,15,31831380,3616,0,0,8812
1130,4,0,8,17,31850280,3616,0,0,8816
1131,3,0,9,16,31864680,3616,0,0,8819
1132,6,0,9,16,31885620,3616,0,0,8825
1133,8,0,10,15,31903620,3615,0,0,8833
1134,6,0,11,14,31921260,3615,0,0,8839
1135,5,0,10,15,31944540,3616,0,0,8844
1136,6,0,11,14,31963920,3616,0,0,8850
1137,9,0,13,12,31986600,3615,0,0,8859
1138,15,0,20,5,32016960,3616,0,0,8874
1139,13,0,21,4,32064360,3616,0,0,8887
1140,7,0,13,12,32139060,3618,0,0,8894
1141,10,0,14,11,32179800,3619,0,0,8904
1142,13,0,17,8,32202960,3618,0,0,8917
1143,5,0,12,13,32253180,3619,0,0,8922
1144,8,0,8,17,32297700,3620,0,0,8930
1145,9,0,10,15,32307240,3618,0,0,8939
1146,5,0,11,14,32325780,3618,0,0,8944
1147,6,0,9,16,32354340,3618,0,0,8950
1148,5,0,9,16,32375340,3618,0,0,8955
1149,7,0,11,14,32390340,3618,0,0,8962
1150,8,0,13,12,32408880,3618,0,0,8970
1151,7,0,15,10,32425500,3618,0,0,8977
1152,3,0,9,16,32475060,3620,0,0,8980
1153,7,0,11,14,32484480,3619,0,0,8987
1154,5,0,8,17,32521380,3619,0,0,8992
1155,5,0,11,14,32529900,3620,0,0,8997
1156,6,0,10,15,32555100,3620,0,0,9003
1157,4,0,7,18,32580420,3620,0,0,9007
1158,8,0,12,13,32590200,3619,0,0,9015
1159,9,0,10,15,32628240,3619,0,0,9024
1160,5,0,10,15,32643540,3619,0,0,9029
1161,6,0,10,15,32664000,3619,0,0,9035
1162,14,0,15,10,32687160,3618,0,0,9049
1163,8,0,13,12,32714940,3617,0,0,9057
1164,10,0,12,13,32753880,3617,0,0,9067
1165,11,0,10,15,32792460,3616,0,0,9078
1166,14,0,13,12,32820780,3615,0,0,9092
1167,12,0,17,8,32840580,3614,0,0,9104
1168,10,0,15,10,32892540,3614,0,0,9114
1169,6,0,12,13,32933040,3615,0,0,9120
1170,10,0,9,16,32982540,3616,0,0,9130
1171,13,0,16,9,32996940,3615,0,0,9143
1172,14,0,21,4,33025320,3614,0,0,9157
1173,5,0,11,14,33094260,3616,0,0,9162
1174,5,0,9,16,33127860,3617,0,0,9167
1175,7,0,10,15,33154680,3617,0,0,9174
1176,8,0,8,17,33187140,3617,0,0,9182
1177,6,0,10,15,33200640,3617,0,0,9188
1178,8,0,12,13,33226200,3617,0,0,9196
1179,3,0,9,16,33241920,3617,0,0,9199
1180,8,0,9,16,33268560,3616,0,0,9207
1181,5,0,11,14,33274920,3616,0,0,9212
1182,5,0,13,12,33283560,3616,0,0,9217
1183,11,0,14,11,33325440,3616,0,0,9228
1184,11,0,13,12,33364260,3616,0,0,9239
1185,12,0,16,9,33409740,3617,0,0,9251
1186,7,0,15,10,33439320,3617,0,0,9258
1187,7,0,14,11,33474900,3618,0,0,9265
1188,7,0,10,15,33521760,3619,0,0,9272
1189,10,0,16,9,33541020,3619,0,0,9282
1190,12,0,18,7,33583380,3620,0,0,9294
1191,5,0,10,15,33627720,3620,0,0,9299
1192,12,0,14,11,33654420,3619,0,0,9311
1193,12,0,14,11,33689880,3619,0,0,9323
1194,9,0,14,11,33732420,3620,0,0,9332
1195,5,0,7,18,33781080,3620,0,0,9337
1196,8,0,12,13,33788700,3620,0,0,9345
1197,6,0,12,13,33805020,3619,0,0,9351
1198,3,0,10,15,33826320,3620,0,0,9354
1199,7,0,11,14,33865080,3621,0,0,9361
1200,5,0,10,15,33889260,3622,0,0,9366
1201,4,0,10,15,33897960,3621,0,0,9370
1202,4,0,8,17,33928920,3622,0,0,9374
1203,10,0,14,11,33939060,3622,0,0,9384
1204,6,0,14,11,33960840,3622,0,0,9390
1205,2,0,8,17,34002120,3623,0,0,9392
1206,11,0,11,14,34033560,3623,0,0,9403
1207,3,0,7,18,34053000,3623,0,0,9406
1208,4,0,8,17,34064400,3623,0,0,9410
1209,9,0,11,14,34081500,3622,0,0,9419
1210,12,0,13,12,34104780,3621,0,0,9431
1211,4,0,7,18,34142460,3621,0,0,9435
1212,16,0,17,8,34160340,3620,0,0,9451
1213,11,0,17,8,34181940,3619,0,0,9462
1214,14,0,21,4,34221000,3619,0,0,9476
1215,7,0,13,12,34283100,3620,0,0,9483
1216,9,0,11,14,34335600,3621,0,0,9492
1217,14,0,17,8,34361100,3621,0,0,9506
1218,10,0,16,9,34399920,3621,0,0,9516
1219,8,0,14,11,34442820,3621,0,0,9524
1220,9,0,12,13,34489680,3622,0,0,9533
1221,7,0,11,14,34513620,3621,0,0,9540
1222,4,0,6,19,34544880,3621,0,0,9544
1223,7,0,11,14,34550340,3621,0,0,9551
1224,4,0,10,15,34558500,3620,0,0,9555
1225,4,0,11,14,34579980,3621,0,0,9559
1226,5,0,11,14,34606260,3622,0,0,9564
1227,5,0,10,15,34626120,3622,0,0,9569
1228,6,0,9,16,34659420,3623,0,0,9575
1229,8,0,11,14,34679340,3622,0,0,9583
1230,7,0,12,13,34697400,3622,0,0,9590
1231,11,0,13,12,34727040,3621,0,0,9601
1232,12,0,17,8,34747860,3621,0,0,9613
1233,10,0,16,9,34787460,3621,0,0,9623
1234,6,0,14,11,34823520,3621,0,0,9629
1235,10,0,13,12,34881660,3623,0,0,9639
1236,14,0,16,9,34922220,3623,0,0,9653
1237,13,0,12,13,34970340,3622,0,0,9666
1238,8,0,13,12,35006520,3623,0,0,9674
1239,15,0,15,10,35038140,3621,0,0,9689
1240,11,0,16,9,35078460,3622,0,0,9700
1241,3,0,6,19,35136060,3623,0,0,9703
1242,11,0,13,12,35151600,3623,0,0,9714
1243,8,0,8,17,35181180,3621,0,0,9722
1244,6,0,11,14,35187060,3621,0,0,9728
1245,6,0,8,17,35215860,3620,0,0,9734
1246,5,0,8,17,35230140,3620,0,0,9739
1247,2,0,7,18,35252040,3621,0,0,9741
1248,3,0,6,19,35277840,3622,0,0,9744
1249,3,0,7,18,35279400,3622,0,0,9747
1250,4,0,8,17,35294280,3622,0,0,9751
1251,10,0,13,12,35309400,3622,0,0,9761
1252,7,0,10,15,35333700,3620,0,0,9768
1253,9,0,12,13,35357520,3620,0,0,9777
1254,4,0,9,16,35382480,3620,0,0,9781
1255,3,0,5,20,35400060,3620,0,0,9784
1256,6,0,8,17,35403000,3619,0,0,9790
1257,9,0,14,11,35408160,3618,0,0,9799
1258,8,0,11,14,35445960,3618,0,0,9807
1259,13,0,14,11,35475300,3617,0,0,9820
1260,10,0,14,11,35507760,3617,0,0,9830
1261,17,0,20,5,35548320,3617,0,0,9847
1262,6,0,15,10,35592060,3617,0,0,9853
1263,13,0,14,11,35647560,3618,0,0,9866
1264,5,0,13,12,35668620,3618,0,0,9871
1265,5,0,9,16,35711400,3619,0,0,9876
1266,10,0,16,9,35724600,3619,0,0,9886
1267,9,0,13,12,35759640,3618,0,0,9895
1268,3,0,7,18,35797320,3619,0,0,9898
1269,6,0,9,16,35814600,3619,0,0,9904
1270,11,0,13,12,35826660,3618,0,0,9915
1271,10,0,14,11,35859420,3618,0,0,9925
1272,6,0,14,11,35884920,3618,0,0,9931
1273,2,0,9,16,35916840,3619,0,0,9933
1274,5,0,7,18,35943780,3619,0,0,9938
1275,4,0,9,16,35961660,3620,0,0,9942
1276,5,0,7,18,35979120,3619,0,0,9947
1277,6,0,9,16,35991120,3619,0,0,9953
1278,7,0,11,14,36006000,3619,0,0,9960
1279,8,0,11,14,36028020,3618,0,0,9968
1280,7,0,10,15,36057660,3618,0,0,9975
1281,11,0,13,12,36081360,3617,0,0,9986
1282,10,0,11,14,36115920,3617,0,0,9996
1283,7,0,10,15,36135240,3616,0,0,10003
1284,11,0,12,13,36161040,3615,0,0,10014
1285,6,0,9,16,36194400,3615,0,0,10020
1286,5,0,9,16,36205560,3614,0,0,10025
1287,2,0,6,19,36227100,3615,0,0,10027
1288,10,0,13,12,36231300,3614,0,0,10037
1289,9,0,14,11,36256560,3614,0,0,10046
1290,7,0,9,16,36298440,3613,0,0,10053
1291,9,0,10,15,36318900,3613,0,0,10062
1292,6,0,11,14,36335460,3612,0,0,10068
1293,9,0,14,11,36349140,3612,0,0,10077
1294,7,0,12,13,36396900,3613,0,0,10084
1295,3,0,9,16,36417120,3613,0,0,10087
1296,8,0,11,14,36447540,3614,0,0,10095
1297,4,0,7,18,36477420,3614,0,0,10099
1298,6,0,10,15,36490800,3614,0,0,10105
1299,6,0,12,13,36501600,3614,0,0,10111
1300,7,0,10,15,36525660,3613,0,0,10118
1301,7,0,11,14,36555900,3614,0,0,10125
1302,4,0,8,17,36584460,3614,0,0,10129
1303,8,0,12,13,36597180,3614,0,0,10137
1304,4,0,8,17,36624000,3614,0,0,10141
1305,7,0,11,14,36640020,3614,0,0,10148
1306,9,0,12,13,36657420,3613,0,0,10157
1307,9,0,13,12,36695640,3614,0,0,10166
1308,12,0,19,6,36713280,3613,0,0,10178
1309,11,0,19,6,36751680,3613,0,0,10189
1310,14,0,16,9,36805440,3612,0,0,10203
1311,6,0,10,15,36860400,3614,0,0,10209
1312,10,0,12,13,36897360,3614,0,0,10219
1313,10,0,16,9,36915840,3614,0,0,10229
1314,13,0,16,9,36952500,3613,0,0,10242
1315,3,0,13,12,36971100,3613,0,0,10245
1316,8,0,13,12,37002660,3613,0,0,10253
1317,6,0,5,20,37047960,3613,0,0,10259
1318,0,0,4,21,37054380,3613,0,0,10259
1319,6,0,9,16,37057140,3613,0,0,10265
1320,5,0,10,15,37063740,3612,0,0,10270
1321,5,0,9,16,37089540,3612,0,0,10275
1322,3,0,9,16,37098480,3612,0,0,10278
1323,7,0,14,11,37106280,3612,0,0,10285
1324,7,0,15,10,37122360,3612,0,0,10292
1325,7,0,13,12,37166580,3613,0,0,10299
1326,10,0,12,13,37201080,3612,0,0,10309
1327,4,0,10,15,37227960,3613,0,0,10313
1328,9,0,13,12,37250400,3613,0,0,10322
1329,8,0,13,12,37282860,3613,0,0,10330
1330,6,0,13,12,37299960,3613,0,0,10336
1331,10,0,14,11,37340940,3614,0,0,10346
1332,10,0,14,11,37369380,3613,0,0,10356
1333,5,0,9,16,37412820,3614,0,0,10361
1334,11,0,14,11,37432500,3613,0,0,10372
1335,16,0,19,6,37462800,3612,0,0,10388
1336,10,0,14,11,37510800,3612,0,0,10398
1337,7,0,12,13,37557660,3613,0,0,10405
1338,12,0,17,8,37587480,3614,0,0,10417
1339,9,0,16,9,37616520,3613,0,0,10426
1340,11,0,16,9,37660200,3613,0,0,10437
1341,7,0,12,13,37705140,3614,0,0,10444
1342,2,0,7,18,37750620,3616,0,0,10446
1343,7,0,11,14,37758060,3615,0,0,10453
1344,3,0,13,12,37759200,3615,0,0,10456
1345,6,0,17,8,37763280,3615,0,0,10462
1346,1,0,14,11,37774860,3615,0,0,10463
1347,9,0,21,4,37788540,3615,0,0,10472
1348,6,0,19,6,37809960,3615,0,0,10478
1349,6,0,16,9,37845540,3615,0,0,10484
1350,7,0,18,7,37861560,3615,0,0,10491
1351,9,0,19,6,37882080,3614,0,0,10500
1352,10,0,21,4,37902960,3613,0,0,10510
1353,11,0,23,2,37917180,3611,0,0,10521
1354,9,0,23,2,37963380,3613,0,0,10530
1355,6,0,18,7,38010840,3613,0,0,10536
1356,14,0,25,0,38025060,3612,600,0,10550
1357,17,5,25,0,38071620,3613,5760,0,10567
1358,8,2,25,0,38122500,3614,27780,2,10575
1359,9,0,22,3,38161920,3613,35640,3,10584
1360,13,0,23,2,38189460,3611,35640,3,10597
1361,11,0,23,2,38222640,3611,35640,3,10608
1362,13,0,25,0,38272260,3611,35640,3,10621
1363,7,0,21,4,38308680,3611,35640,3,10628
1364,6,0,21,4,38340780,3612,35640,3,10634
1365,10,1,25,0,38365560,3613,36300,3,10644
1366,6,0,17,8,38421960,3613,37320,3,10650
1367,4,0,18,7,38433060,3613,37320,3,10654
1368,6,0,18,7,38471880,3615,37320,3,10660
1369,6,0,17,8,38490780,3614,37320,3,10666
1370,5,0,16,9,38506680,3613,37320,3,10671
1371,2,0,15,10,38518560,3614,37320,3,10673
1372,4,0,15,10,38534760,3614,37320,3,10677
1373,6,0,17,8,38543100,3613,37320,3,10683
1374,7,0,19,6,38560860,3613,37320,3,10690
1375,5,0,18,7,38578260,3613,37320,3,10695
1376,9,0,20,5,38593080,3612,37320,3,10704
1377,9,0,21,4,38632020,3613,37320,3,10713
1378,6,0,19,6,38661900,3613,37320,3,10719
1379,12,0,22,3,38698860,3613,37320,3,10731
1380,15,2,25,0,38720700,3612,38100,3,10746
1381,15,5,25,0,38773200,3613,44940,4,10761
1382,9,1,25,0,38814660,3612,71160,6,10770
1383,8,0,22,3,38858940,3612,72600,6,10778
1384,14,1,25,0,38896200,3612,74040,6,10792
1385,11,7,25,0,38921640,3613,77520,7,10803
1386,9,6,25,0,38979660,3615,97560,9,10812
1387,3,0,15,10,39044760,3615,111600,10,10815
1388,8,0,19,6,39059520,3615,111600,10,10823
1389,12,0,23,2,39083520,3614,111900,10,10835
1390,11,0,23,2,39113040,3613,111900,10,10846
1391,6,0,19,6,39154620,3614,111900,10,10852
1392,5,0,15,10,39187080,3614,111900,10,10857
1393,6,0,17,8,39199200,3614,111900,10,10863
1394,7,0,20,5,39214500,3614,111900,10,10870
1395,8,0,22,3,39239040,3614,111900,10,10878
1396,5,0,18,7,39274380,3614,111900,10,10883
1397,2,0,14,11,39302400,3615,111900,10,10885
1398,6,0,17,8,39306840,3614,111900,10,10891
1399,7,0,17,8,39330240,3614,111900,10,10898
1400,6,0,18,7,39348240,3614,111900,10,10904
1401,8,0,19,6,39373260,3614,111900,10,10912
1402,10,0,23,2,39387900,3613,111900,10,10922
1403,9,0,22,3,39420540,3613,112440,10,10931
1404,9,0,21,4,39470220,3614,112440,10,10940
1405,12,0,24,1,39504660,3614,114060,10,10952
1406,13,1,25,0,39535260,3614,114240,10,10965
1407,11,0,24,1,39589140,3614,116220,10,10976
1408,10,0,21,4,39638340,3614,118860,10,10986
1409,5,0,16,9,39684120,3615,118860,10,10991
1410,11,0,24,1,39696000,3615,118860,10,11002
1411,9,0,23,2,39725400,3615,118860,10,11011
1412,9,0,20,5,39771120,3615,118860,10,11020
1413,5,0,18,7,39794400,3615,118860,10,11025
1414,3,0,17,8,39823980,3616,118860,10,11028
1415,5,0,17,8,39835560,3616,118860,10,11033
1416,6,0,16,9,39867480,3616,118860,10,11039
1417,3,0,16,9,39876180,3616,118860,10,11042
1418,5,0,15,10,39898020,3616,118860,10,11047
1419,7,0,19,6,39906000,3616,118860,10,11054
1420,7,0,20,5,39919740,3615,118860,10,11061
1421,5,0,18,7,39947160,3615,118860,10,11066
1422,7,0,19,6,39978720,3616,118860,10,11073
1423,5,0,17,8,40002300,3616,118860,10,11078
1424,10,0,20,5,40023360,3616,118860,10,11088
1425,15,0,25,0,40051320,3615,118860,10,11103
1426,18,5,25,0,40088760,3614,122460,11,11121
1427,16,11,25,0,40125840,3614,128460,11,11137
1428,13,16,25,0,40165920,3615,136260,12,11150
1429,5,6,25,0,40225860,3616,189600,16,11155
1430,13,4,25,0,40265940,3614,230640,20,11168
1431,6,0,21,4,40312800,3614,263580,23,11174
1432,9,0,21,4,40355400,3615,263580,23,11183
1433,17,1,25,0,40389360,3614,264900,23,11200
1434,6,0,21,4,40423920,3614,266340,23,11206
1435,15,0,25,0,40477080,3615,268560,23,11221
1436,8,0,21,4,40512180,3614,269040,23,11229
1437,3,0,19,6,40536120,3615,269040,23,11232
1438,4,0,17,8,40564500,3615,269040,23,11236
1439,5,0,15,10,40593960,3616,269040,23,11241
1440,7,0,18,7,40600560,3615,269040,23,11248
1441,6,0,15,10,40624440,3614,269040,23,11254
1442,3,0,14,11,40641000,3614,269040,23,11257
1443,4,0,17,8,40645740,3614,269040,23,11261
1444,7,0,18,7,40655820,3613,269040,23,11268
1445,6,0,21,4,40679160,3614,269040,23,11274
1446,4,0,18,7,40698600,3614,269040,23,11278
1447,8,0,17,8,40735860,3614,269040,23,11286
1448,12,0,24,1,40748880,3614,269040,23,11298
1449,12,2,25,0,40778340,3614,269820,23,11310
1450,13,1,25,0,40838100,3614,282960,24,11323
1451,9,0,24,1,40864080,3613,282960,24,11332
1452,14,3,25,0,40895880,3613,283680,25,11346
1453,16,5,25,0,40959720,3614,289320,25,11362
1454,8,0,24,1,41000280,3613,305040,26,11370
1455,15,1,25,0,41048460,3613,305340,26,11385
1456,9,0,24,1,41084220,3613,305640,26,11394
1457,6,0,22,3,41118060,3613,305640,26,11400
1458,3,0,17,8,41141640,3613,305640,26,11403
1459,5,0,16,9,41169420,3613,305640,26,11408
1460,3,0,14,11,41188080,3613,305640,26,11411
1461,6,0,16,9,41194920,3613,305640,26,11417
1462,3,0,15,10,41206380,3613,305640,26,11420
1463,9,0,20,5,41218500,3612,305640,26,11429
1464,3,0,16,9,41252040,3613,305640,26,11432
1465,5,0,14,11,41279400,3613,305640,26,11437
1466,3,0,15,10,41282820,3613,305640,26,11440
1467,6,0,15,10,41295060,3612,305640,26,11446
1468,3,0,14,11,41309040,3612,305640,26,11449
1469,7,0,17,8,41314860,3611,305640,26,11456
1470,8,0,20,5,41334000,3611,305640,26,11464
1471,10,0,20,5,41365680,3611,305640,26,11474
1472,6,0,19,6,41388840,3611,305640,26,11480
1473,3,0,17,8,41415600,3612,305640,26,11483
1474,6,0,17,8,41440800,3612,305640,26,11489
1475,14,3,25,0,41453580,3612,305880,26,11503
1476,19,14,25,0,41483820,3612,313320,27,11522
1477,8,15,25,0,41532120,3614,325800,28,11530
1478,10,13,25,0,41590920,3615,358080,31,11540
1479,7,5,25,0,41645820,3616,443100,38,11547
1480,11,0,20,5,41691300,3613,495480,42,11558
1481,11,0,20,5,41721480,3612,495480,42,11569
1482,11,1,25,0,41735280,3612,496020,42,11580
1483,11,0,25,0,41780820,3612,496380,42,11591
1484,6,0,19,6,41836560,3613,496380,42,11597
1485,12,0,18,7,41878380,3613,496380,42,11609
1486,8,0,20,5,41897640,3612,496380,42,11617
1487,6,0,16,9,41931300,3612,496380,42,11623
1488,2,0,17,8,41937300,3612,496380,42,11625
1489,9,0,20,5,41973660,3614,496380,42,11634
1490,9,0,21,4,41992800,3613,496380,42,11643
1491,8,0,20,5,42020280,3612,496380,42,11651
1492,5,0,18,7,42056700,3613,496380,42,11656
1493,9,0,20,5,42070560,3612,496380,42,11665
1494,13,0,19,6,42114840,3612,496380,42,11678
1495,8,0,23,2,42121920,3611,496380,42,11686
1496,12,0,23,2,42171300,3612,496800,42,11698
1497,8,0,22,3,42203220,3612,496800,42,11706
1498,12,0,22,3,42236820,3611,497280,42,11718
1499,8,0,20,5,42278640,3611,497280,42,11726
1500,11,0,22,3,42310080,3611,497280,42,11737
1501,4,0,18,7,42326160,3610,497280,42,11741
1502,9,0,20,5,42355020,3610,497280,42,11750
1503,13,2,25,0,42361320,3609,497280,42,11763
1504,16,8,25,0,42409080,3610,500700,42,11779
1505,7,3,25,0,42455400,3610,522660,44,11786
1506,10,0,20,5,42509220,3609,529560,44,11796
1507,6,0,18,7,42536460,3609,529560,44,11802
1508,11,0,24,1,42555780,3609,529560,44,11813
1509,7,0,23,2,42586380,3609,529560,44,11820
1510,8,0,20,5,42632640,3610,529560,44,11828
1511,4,0,20,5,42655920,3611,529560,44,11832
1512,8,0,19,6,42691980,3611,529560,44,11840
1513,5,0,17,8,42720300,3611,529560,44,11845
1514,3,0,17,8,42736500,3612,529560,44,11848
1515,7,0,16,9,42758880,3611,529560,44,11855
1516,6,0,17,8,42770820,3611,529560,44,11861
1517,11,0,21,4,42791040,3610,529560,44,11872
1518,8,0,20,5,42817740,3610,529560,44,11880
1519,6,0,17,8,42854820,3610,529560,44,11886
1520,10,0,19,6,42875400,3609,529560,44,11896
1521,1,0,17,8,42887880,3610,529560,44,11897
1522,7,0,20,5,42904980,3610,529560,44,11904
1523,11,1,25,0,42927780,3610,530460,44,11915
1524,6,0,22,3,42974100,3611,534600,44,11921
1525,9,0,23,2,43020420,3613,534600,44,11930
1526,5,0,18,7,43054500,3612,534600,44,11935
1527,6,0,18,7,43081980,3613,534600,44,11941
1528,15,0,22,3,43110480,3612,534600,44,11956
1529,14,5,25,0,43136880,3612,537720,44,11970
1530,7,4,25,0,43183440,3614,551760,46,11977
1531,11,2,25,0,43236600,3614,567360,47,11988
1532,11,0,20,5,43287120,3613,581340,48,11999
1533,8,0,19,6,43311600,3612,581340,48,12007
1534,1,0,17,8,43319220,3612,581340,48,12008
1535,4,0,18,7,43336380,3613,581340,48,12012
1536,5,0,16,9,43353360,3612,581340,48,12017
1537,6,0,16,9,43369320,3612,581340,48,12023
1538,2,0,17,8,43370100,3611,581340,48,12025
1539,3,0,15,10,43396920,3612,581340,48,12028
1540,9,0,20,5,43404960,3611,581340,48,12037
1541,8,0,19,6,43430280,3611,581340,48,12045
1542,8,0,20,5,43452000,3611,581340,48,12053
1543,6,0,22,3,43470600,3611,581340,48,12059
1544,10,0,21,4,43514520,3611,581340,48,12069
1545,7,0,22,3,43540380,3612,581340,48,12076
1546,14,0,24,1,43582020,3611,581340,48,12090
1547,11,0,24,1,43624020,3612,581340,48,12101
1548,10,0,25,0,43659000,3612,581520,48,12111
1549,18,10,25,0,43699020,3613,587640,48,12129
1550,8,14,25,0,43726320,3614,594840,49,12137
1551,18,24,25,0,43778880,3616,614640,50,12155
1552,13,25,25,0,43857960,3619,629700,51,12168
1553,11,31,25,0,43883040,3619,639720,52,12179
1554,12,31,25,0,43946580,3621,666840,54,12191
1555,5,24,25,0,43998720,3622,785340,64,12196
1556,8,8,25,0,44055660,3619,1055820,86,12204
1557,8,0,20,5,44091120,3616,1192620,97,12212
1558,6,0,19,6,44117340,3616,1192620,97,12218
1559,5,0,17,8,44134800,3615,1192620,97,12223
1560,6,0,16,9,44160840,3615,1192620,97,12229
1561,5,0,17,8,44174160,3615,1192620,97,12234
1562,3,0,16,9,44185080,3615,1192620,97,12237
1563,3,0,15,10,44200680,3615,1192620,97,12240
1564,6,0,18,7,44210880,3615,1192620,97,12246
1565,6,0,18,7,44232480,3615,1192620,97,12252
1566,9,0,19,6,44254680,3614,1192620,97,12261
1567,11,1,25,0,44266800,3614,1192620,97,12272
1568,10,0,22,3,44311860,3614,1194660,97,12282
1569,9,0,22,3,44341320,3614,1194660,97,12291
1570,15,3,25,0,44376840,3614,1198200,97,12306
1571,10,0,23,2,44426460,3613,1208340,98,12316
1572,6,0,22,3,44460420,3614,1208400,98,12322
1573,8,0,19,6,44514840,3615,1208400,98,12330
1574,13,0,23,2,44537400,3615,1208400,97,12343
1575,14,0,22,3,44583120,3614,1208400,97,12357
1576,10,0,22,3,44618640,3614,1208400,97,12367
1577,6,0,16,9,44662200,3614,1208400,97,12373
1578,12,0,25,0,44678580,3614,1208400,97,12385
1579,9,0,23,2,44700480,3613,1208400,97,12394
1580,12,0,24,1,44731440,3612,1208400,97,12406
1581,5,0,19,6,44782860,3613,1208400,97,12411
1582,14,0,25,0,44803320,3613,1208400,97,12425
1583,2,0,19,6,44846460,3614,1208400,97,12427
1584,3,0,15,10,44880660,3615,1208400,97,12430
1585,8,0,20,5,44893560,3615,1208400,97,12438
1586,5,0,18,7,44916720,3615,1208400,97,12443
1587,8,0,21,4,44942820,3615,1208400,97,12451
1588,6,0,21,4,44963100,3615,1208400,97,12457
1589,9,0,18,7,45002100,3615,1208400,96,12466
1590,7,0,20,5,45029040,3615,1208400,96,12473
1591,11,0,24,1,45049500,3615,1208400,96,12484
1592,14,0,24,1,45089880,3614,1208400,96,12498
1593,8,0,23,2,45116460,3614,1209060,96,12506
1594,8,0,21,4,45162120,3614,1210440,96,12514
1595,13,1,25,0,45196320,3615,1212660,96,12527
1596,8,0,21,4,45249660,3615,1213140,96,12535
1597,14,1,25,0,45282840,3615,1213140,96,12549
1598,15,3,25,0,45326880,3615,1221840,97,12564
1599,6,0,18,7,45370380,3614,1229700,97,12570
1600,10,0,20,5,45399600,3614,1229700,97,12580
1601,15,3,25,0,45427860,3614,1230840,97,12595
1602,10,0,22,3,45485700,3614,1232220,97,12605
1603,9,0,21,4,45521640,3614,1232220,97,12614
1604,6,0,17,8,45562800,3615,1232220,97,12620
1605,7,0,17,8,45585660,3615,1232220,97,12627
1606,7,0,21,4,45597540,3615,1232220,97,12634
1607,6,0,19,6,45626580,3615,1232220,97,12640
1608,9,0,21,4,45648840,3614,1232220,97,12649
1609,7,0,19,6,45684420,3615,1232220,97,12656
1610,8,0,17,8,45721260,3615,1232220,97,12664
1611,6,0,20,5,45731460,3615,1232220,97,12670
1612,5,0,19,6,45763620,3615,1232220,97,12675
1613,10,0,19,6,45799980,3615,1232220,97,12685
1614,10,0,20,5,45821640,3615,1232220,97,12695
1615,4,0,18,7,45847440,3615,1232220,97,12699
1616,7,0,20,5,45877020,3616,1232220,96,12706
1617,7,0,16,9,45919680,3616,1232220,96,12713
1618,3,0,15,10,45929220,3616,1232220,96,12716
1619,13,0,20,5,45953400,3615,1232340,96,12729
1620,11,0,21,4,45980940,3615,1232340,96,12740
1621,11,0,22,3,46006560,3614,1232340,96,12751
1622,12,2,25,0,46039980,3614,1232340,96,12763
1623,10,6,25,0,46072500,3615,1237800,96,12773
1624,11,7,25,0,46132320,3617,1248540,97,12784
1625,5,0,25,0,46180140,3617,1288260,100,12789
1626,7,0,21,4,46227900,3618,1288260,100,12796
1627,6,0,20,5,46265100,3619,1288260,100,12802
1628,12,0,24,1,46297500,3619,1288260,100,12814
1629,8,0,24,1,46329060,3620,1288440,100,12822
1630,8,0,22,3,46362660,3619,1288860,100,12830
1631,5,0,18,7,46418520,3621,1288860,100,12835
1632,4,0,18,7,46430460,3621,1288860,100,12839
1633,3,0,16,9,46452780,3621,1288860,100,12842
1634,5,0,14,11,46471920,3621,1288860,100,12847
1635,3,0,15,10,46485780,3621,1288860,100,12850
1636,7,0,16,9,46498200,3621,1288860,100,12857
1637,4,0,17,8,46504320,3620,1288860,100,12861
1638,9,0,20,5,46524180,3620,1288860,100,12870
1639,11,0,20,5,46548360,3619,1288860,100,12881
1640,17,3,25,0,46576740,3619,1289460,99,12898
1641,11,6,25,0,46616580,3619,1295460,100,12909
1642,7,4,25,0,46672500,3621,1315500,101,12916
1643,4,0,19,6,46732860,3622,1340520,103,12920
1644,17,3,25,0,46752120,3621,1341600,103,12937
1645,8,0,25,0,46798740,3622,1347720,104,12945
1646,10,0,23,2,46842000,3622,1348260,104,12955
1647,16,9,25,0,46861920,3622,1352400,104,12971
1648,11,2,25,0,46931160,3622,1377000,106,12982
1649,8,3,25,0,46952580,3622,1380840,106,12990
1650,8,0,19,6,47036460,3624,1390440,106,12998
1651,6,0,20,5,47057400,3624,1390440,106,13004
1652,5,0,19,6,47087040,3624,1390440,106,13009
1653,11,0,23,2,47104020,3624,1390440,106,13020
1654,3,0,18,7,47146320,3625,1390440,106,13023
1655,2,0,15,10,47174460,3626,1390440,106,13025
1656,3,0,17,8,47175540,3625,1390440,106,13028
1657,5,0,16,9,47202600,3626,1390440,106,13033
1658,4,0,15,10,47221860,3626,1390440,106,13037
1659,5,0,17,8,47230380,3626,1390440,106,13042
1660,7,0,20,5,47240340,3625,1390440,106,13049
1661,5,0,20,5,47266860,3626,1390440,106,13054
1662,6,0,19,6,47294400,3626,1390440,106,13060
1663,7,0,19,6,47325060,3626,1390440,106,13067
1664,9,0,21,4,47351100,3627,1390440,106,13076
1665,14,0,22,3,47388180,3626,1390740,106,13090
1666,8,0,20,5,47422740,3626,1390740,106,13098
1667,18,1,25,0,47460480,3625,1391940,106,13116
1668,11,4,25,0,47491620,3625,1394340,106,13127
1669,6,2,25,0,47536440,3627,1413120,107,13133
1670,17,1,25,0,47583720,3625,1417380,107,13150
1671,12,0,23,2,47643960,3626,1418220,107,13162
1672,11,1,25,0,47670360,3625,1419000,107,13173
1673,12,1,25,0,47723580,3626,1420560,107,13185
1674,12,5,25,0,47759220,3627,1426500,108,13197
1675,8,1,25,0,47817540,3628,1439940,109,13205
1676,5,0,20,5,47856720,3628,1439940,109,13210
1677,9,0,20,5,47891280,3628,1439940,108,13219
1678,5,0,20,5,47917320,3629,1439940,108,13224
1679,7,0,17,8,47954100,3629,1439940,108,13231
1680,10,0,23,2,47963760,3628,1439940,108,13241
1681,9,0,22,3,48002880,3628,1439940,108,13250
1682,9,0,23,2,48029880,3628,1439940,108,13259
1683,8,0,21,4,48060840,3628,1439940,108,13267
1684,6,0,17,8,48108540,3629,1439940,108,13273
1685,5,0,17,8,48131460,3629,1439940,108,13278
1686,8,0,17,8,48152100,3628,1439940,108,13286
1687,5,0,16,9,48171660,3628,1439940,108,13291
1688,7,0,20,5,48183600,3628,1439940,108,13298
1689,10,0,21,4,48217680,3628,1439940,108,13308
1690,6,0,21,4,48239700,3628,1439940,108,13314
1691,10,0,18,7,48283740,3628,1439940,108,13324
1692,5,0,15,10,48309840,3628,1439940,108,13329
1693,8,0,16,9,48318720,3627,1439940,107,13337
1694,11,0,23,2,48344820,3628,1439940,107,13348
1695,15,4,25,0,48370320,3627,1443600,108,13363
1696,11,8,25,0,48408660,3628,1450500,108,13374
1697,13,9,25,0,48465840,3629,1465620,109,13387
1698,6,0,19,6,48524460,3628,1516800,113,13393
1699,11,0,22,3,48541140,3627,1516800,113,13404
1700,7,0,17,8,48589320,3627,1516800,113,13411
1701,6,0,18,7,48603180,3627,1516800,113,13417
1702,8,0,17,8,48625740,3626,1516800,112,13425
1703,5,0,18,7,48642780,3626,1516800,112,13430
1704,2,0,15,10,48662160,3626,1516800,112,13432
1705,7,0,18,7,48676500,3626,1516800,112,13439
1706,3,0,16,9,48690000,3626,1516800,112,13442
1707,4,0,17,8,48703500,3626,1516800,112,13446
1708,6,0,19,6,48724440,3627,1516800,112,13452
1709,8,0,18,7,48753060,3626,1516800,112,13460
1710,5,0,17,8,48768120,3626,1516800,112,13465
1711,6,0,16,9,48791580,3626,1516800,112,13471
1712,8,0,21,4,48795360,3625,1516800,112,13479
1713,7,0,17,8,48827880,3625,1516800,112,13486
1714,8,0,18,7,48847500,3624,1516800,112,13494
1715,7,0,21,4,48863520,3624,1516800,112,13501
1716,16,0,25,0,48910800,3625,1522740,112,13517
1717,7,2,25,0,48926220,3624,1527540,112,13524
1718,12,4,25,0,48977880,3626,1534320,113,13536
1719,11,6,25,0,49018860,3626,1540080,113,13547
1720,8,0,23,2,49081380,3627,1559580,115,13555
1721,5,0,20,5,49122360,3627,1559580,115,13560
1722,7,0,19,6,49154340,3628,1559580,114,13567
1723,8,0,21,4,49177620,3628,1559580,114,13575
1724,9,0,20,5,49204980,3627,1559580,114,13584
1725,5,0,15,10,49240560,3627,1559580,114,13589
1726,6,0,16,9,49249380,3626,1559580,114,13595
1727,4,0,15,10,49263000,3626,1559580,114,13599
1728,2,0,13,12,49275420,3626,1559580,114,13601
1729,4,0,14,11,49279440,3625,1559580,114,13605
1730,4,0,15,10,49281960,3625,1559580,114,13609
1731,7,0,19,6,49290300,3625,1559580,114,13616
1732,5,0,16,9,49320600,3625,1559580,114,13621
1733,5,0,15,10,49330380,3624,1559580,114,13626
1734,13,0,19,6,49344180,3622,1559580,114,13639
1735,4,0,18,7,49358220,3622,1559580,114,13643
1736,4,0,16,9,49385640,3623,1559580,114,13647
1737,10,0,22,3,49391700,3622,1559580,114,13657
1738,13,0,24,1,49427520,3622,1561380,114,13670
1739,14,6,25,0,49450200,3621,1561560,114,13684
1740,16,11,25,0,49517340,3623,1570380,114,13700
1741,9,13,25,0,49551660,3624,1585860,115,13709
1742,12,17,25,0,49590780,3625,1592040,116,13721
1743,14,6,25,0,49672020,3624,1695420,123,13735
1744,15,6,25,0,49701240,3622,1725420,125,13750
1745,17,15,25,0,49732980,3623,1729380,125,13767
1746,7,13,25,0,49791060,3624,1746660,126,13774
1747,5,10,25,0,49830240,3625,1776840,128,13779
1748,3,0,19,6,49880100,3624,1886220,136,13782
1749,9,0,19,6,49925040,3625,1886220,136,13791
1750,6,0,23,2,49932000,3625,1886220,136,13797
1751,8,0,21,4,49981380,3626,1886220,136,13805
1752,4,0,20,5,50006520,3626,1886220,136,13809
1753,6,0,16,9,50047020,3626,1886220,136,13815
1754,4,0,20,5,50047020,3626,1886220,136,13819
1755,4,0,19,6,50075880,3627,1886220,136,13823
1756,2,0,18,7,50084280,3627,1886220,136,13825
1757,7,0,16,9,50128800,3628,1886220,136,13832
1758,5,0,19,6,50135460,3628,1886220,136,13837
1759,4,0,16,9,50170560,3628,1886220,136,13841
1760,14,1,25,0,50185380,3628,1886220,136,13855
1761,9,0,21,4,50226000,3628,1889400,136,13864
1762,10,0,21,4,50253060,3627,1889400,136,13874
1763,10,0,19,6,50300100,3627,1889400,136,13884
1764,4,0,17,8,50328420,3628,1889400,136,13888
1765,8,0,19,6,50343540,3627,1889400,135,13896
1766,3,0,16,9,50369580,3628,1889400,135,13899
1767,14,0,23,2,50393040,3628,1889760,135,13913
1768,13,2,25,0,50428440,3628,1892160,135,13926
1769,12,1,25,0,50475180,3628,1895460,136,13938
1770,7,0,21,4,50527020,3628,1898460,136,13945
1771,12,0,24,1,50556420,3628,1898460,136,13957
1772,15,4,25,0,50604300,3629,1904700,136,13972
1773,10,0,20,5,50656560,3628,1922040,137,13982
1774,12,0,21,4,50686980,3627,1922040,137,13994
1775,4,0,17,8,50718120,3627,1922040,137,13998
1776,5,0,17,8,50739600,3627,1922040,137,14003
1777,4,0,16,9,50752560,3627,1922040,137,14007
1778,7,0,18,7,50782620,3628,1922040,137,14014
1779,7,0,18,7,50807460,3628,1922040,137,14021
1780,2,0,18,7,50816700,3628,1922040,137,14023
1781,9,0,17,8,50855880,3628,1922040,136,14032
1782,8,0,19,6,50866200,3627,1922040,136,14040
1783,8,0,19,6,50890560,3627,1922040,136,14048
1784,8,0,20,5,50918640,3627,1922040,136,14056
1785,9,0,24,1,50944380,3628,1922040,136,14065
1786,8,0,18,7,50989140,3627,1923600,136,14073
1787,12,0,24,1,51009300,3627,1923900,136,14085
1788,9,0,22,3,51052740,3627,1923900,136,14094
1789,16,2,25,0,51083040,3627,1924440,136,14110
1790,4,0,18,7,51135060,3627,1926600,136,14114
1791,10,0,20,5,51164700,3627,1926600,136,14124
1792,8,0,20,5,51185520,3627,1926600,136,14132
1793,12,0,22,3,51217380,3626,1926600,136,14144
1794,6,0,19,6,51245640,3626,1926600,136,14150
1795,2,0,14,11,51276720,3626,1926600,136,14152
1796,9,0,19,6,51291840,3626,1926600,136,14161
1797,6,0,17,8,51316560,3626,1926600,135,14167
1798,7,0,15,10,51340920,3626,1926600,135,14174
1799,5,0,19,6,51344880,3626,1926600,135,14179
1800,7,0,19,6,51380220,3626,1926600,135,14186
1801,9,0,23,2,51394320,3626,1926600,135,14195
1802,5,0,20,5,51430620,3626,1926600,135,14200
1803,7,0,21,4,51456720,3627,1926600,135,14207
1804,5,0,19,6,51488940,3627,1926600,135,14212
1805,6,0,17,8,51531420,3628,1926600,135,14218
1806,6,0,18,7,51545640,3628,1926600,135,14224
1807,4,0,15,10,51567960,3628,1926600,135,14228
1808,8,0,17,8,51581400,3627,1926600,135,14236
1809,7,0,20,5,51589980,3627,1926600,135,14243
1810,8,0,20,5,51616080,3627,1926600,135,14251
1811,7,0,22,3,51642060,3627,1926600,135,14258
1812,14,0,23,2,51676500,3626,1926660,134,14272
1813,11,0,24,1,51716460,3626,1926780,134,14283
1814,8,0,21,4,51755520,3626,1927620,134,14291
1815,9,0,20,5,51792300,3626,1927620,134,14300
1816,6,0,18,7,51831660,3627,1927620,134,14306
1817,8,0,22,3,51844500,3627,1927620,134,14314
1818,12,0,24,1,51897900,3628,1928880,134,14326
1819,7,0,22,3,51931080,3628,1928880,134,14333
1820,5,0,21,4,51951540,3628,1928880,134,14338
1821,8,0,18,7,52003740,3629,1928880,134,14346
1822,3,0,14,11,52027620,3629,1928880,134,14349
1823,3,0,14,11,52041300,3629,1928880,134,14352
1824,10,0,22,3,52043400,3629,1928880,134,14362
1825,3,0,16,9,52073880,3629,1928880,134,14365
1826,3,0,15,10,52092180,3629,1928880,134,14368
1827,2,0,14,11,52108980,3629,1928880,134,14370
1828,15,0,25,0,52115460,3629,1928880,134,14385
1829,10,3,25,0,52133100,3628,1930080,134,14395
1830,10,0,22,3,52202100,3629,1942020,134,14405
1831,10,0,21,4,52231740,3628,1942020,134,14415
1832,6,0,22,3,52247400,3628,1942020,134,14421
1833,8,0,22,3,52290840,3629,1942020,134,14429
1834,13,0,22,3,52324500,3628,1943760,134,14442
1835,8,0,21,4,52366920,3629,1943760,134,14450
1836,13,0,23,2,52389900,3628,1943760,134,14463
1837,10,0,24,1,52429440,3628,1943760,134,14473
1838,10,0,19,6,52486200,3628,1943760,134,14483
1839,9,0,18,7,52510440,3627,1943760,134,14492
1840,9,0,22,3,52518240,3627,1943760,134,14501
1841,12,1,25,0,52552680,3627,1947420,134,14513
1842,5,0,19,6,52593900,3627,1947540,134,14518
1843,8,0,22,3,52620660,3628,1947540,134,14526
1844,6,0,18,7,52667040,3628,1947540,134,14532
1845,4,0,18,7,52680660,3628,1947540,133,14536
1846,4,0,16,9,52702020,3628,1947540,133,14540
1847,3,0,15,10,52717260,3628,1947540,133,14543
1848,4,0,15,10,52729020,3628,1947540,133,14547
1849,3,0,15,10,52737960,3628,1947540,133,14550
1850,4,0,16,9,52748940,3628,1947540,133,14554
1851,8,0,18,7,52758360,3627,1947540,133,14562
1852,3,0,16,9,52770840,3627,1947540,133,14565
1853,7,0,17,8,52788420,3626,1947540,133,14572
1854,4,0,18,7,52807680,3627,1947540,133,14576
1855,8,0,18,7,52838640,3627,1947540,133,14584
1856,8,0,20,5,52858620,3627,1947540,133,14592
1857,11,0,22,3,52890960,3627,1947540,133,14603
1858,9,0,21,4,52920960,3626,1947540,133,14612
1859,8,0,22,3,52950060,3627,1947540,133,14620
1860,6,0,19,6,52981920,3627,1947540,133,14626
1861,9,0,20,5,53018220,3627,1947540,133,14635
1862,7,0,19,6,53051340,3627,1947540,133,14642
1863,9,0,21,4,53074020,3627,1947540,132,14651
1864,8,0,20,5,53115120,3628,1947540,132,14659
1865,10,0,22,3,53136780,3627,1947540,132,14669
1866,10,0,23,2,53156100,3626,1947540,132,14679
1867,6,0,19,6,53185920,3626,1947540,132,14685
1868,5,0,14,11,53240460,3627,1947540,132,14690
1869,4,0,15,10,53247300,3627,1947540,132,14694
1870,5,0,20,5,53247300,3627,1947540,132,14699
1871,9,0,21,4,53276220,3627,1947540,132,14708
1872,5,0,20,5,53302800,3627,1947540,132,14713
1873,5,0,17,8,53339700,3628,1947540,132,14718
1874,6,0,19,6,53353080,3628,1947540,132,14724
1875,5,0,17,8,53376000,3628,1947540,132,14729
1876,3,0,14,11,53397480,3628,1947540,132,14732
1877,8,0,18,7,53405220,3627,1947540,132,14740
1878,6,0,21,4,53418360,3627,1947540,132,14746
1879,4,0,18,7,53448360,3628,1947540,132,14750
1880,9,0,19,6,53472840,3627,1947540,131,14759
1881,7,0,21,4,53498820,3628,1947540,131,14766
1882,14,0,20,5,53540460,3627,1947540,131,14780
1883,6,0,19,6,53560080,3627,1947540,131,14786
1884,11,0,21,4,53590440,3626,1947540,131,14797
1885,10,0,24,1,53623920,3627,1947540,131,14807
1886,9,0,18,7,53660760,3626,1947540,131,14816
1887,13,2,25,0,53678760,3626,1947960,131,14829
1888,12,0,23,2,53732220,3626,1949220,131,14841
1889,12,0,25,0,53765940,3625,1949220,131,14853
1890,8,0,24,1,53807280,3626,1949520,131,14861
1891,4,0,19,6,53843220,3626,1949520,131,14865
1892,6,0,18,7,53876400,3627,1949520,131,14871
1893,13,0,20,5,53903460,3626,1949520,130,14884
1894,7,0,17,8,53932200,3625,1949520,130,14891
1895,6,0,17,8,53943720,3625,1949520,130,14897
1896,6,0,17,8,53964780,3625,1949520,130,14903
1897,3,0,18,7,53973360,3625,1949520,130,14906
1898,4,0,18,7,53991300,3625,1949520,130,14910
1899,4,0,17,8,54012480,3625,1949520,130,14914
1900,5,0,16,9,54030480,3625,1949520,130,14919
1901,6,0,16,9,54058740,3625,1949520,130,14925
1902,10,0,20,5,54073320,3625,1949520,130,14935
1903,12,0,22,3,54093840,3624,1949520,130,14947
1904,9,0,20,5,54134460,3624,1949520,130,14956
1905,7,0,20,5,54154440,3624,1949520,130,14963
1906,8,0,19,6,54184620,3623,1949520,130,14971
1907,17,0,25,0,54215340,3623,1950900,130,14988
1908,10,0,22,3,54258000,3622,1950900,130,14998
1909,12,0,24,1,54294600,3623,1950900,129,15010
1910,8,0,23,2,54327900,3623,1950900,129,15018
1911,7,0,21,4,54373620,3623,1950900,129,15025
1912,8,0,21,4,54390480,3623,1950900,129,15033
1913,11,0,20,5,54442140,3623,1950900,129,15044
1914,11,0,20,5,54467460,3622,1950900,129,15055
1915,9,0,19,6,54505260,3622,1950900,129,15064
1916,13,0,21,4,54529320,3621,1950900,129,15077
1917,8,0,24,1,54543900,3621,1950900,129,15085
1918,5,0,18,7,54586260,3621,1950900,129,15090
1919,1,0,12,13,54609840,3621,1950900,129,15091
1920,11,0,22,3,54610500,3621,1950900,129,15102
1921,9,0,20,5,54630300,3620,1950900,129,15111
1922,6,0,18,7,54658560,3620,1950900,129,15117
1923,4,0,17,8,54678300,3620,1950900,129,15121
1924,7,0,20,5,54690360,3619,1950900,128,15128
1925,5,0,15,10,54720600,3619,1950900,128,15133
1926,6,0,15,10,54732420,3618,1950900,128,15139
1927,14,0,25,0,54740880,3618,1950900,128,15153
1928,10,2,25,0,54772500,3618,1954620,128,15163
1929,12,0,25,0,54841200,3619,1962360,129,15175
1930,8,0,21,4,54873060,3619,1962360,129,15183
1931,22,7,25,0,54919200,3619,1965780,129,15205
1932,9,8,25,0,54964140,3620,1974780,129,15214
1933,18,14,25,0,55006620,3620,1981920,130,15232
1934,16,18,25,0,55060980,3621,1989540,130,15248
1935,11,13,25,0,55107840,3620,2036880,133,15259
1936,12,9,25,0,55141980,3618,2122740,139,15271
1937,14,6,25,0,55201920,3618,2202660,144,15285
1938,8,0,24,1,55240020,3617,2236320,146,15293
1939,4,0,14,11,55282860,3617,2236380,146,15297
1940,7,0,18,7,55306860,3618,2236380,146,15304
1941,10,0,20,5,55328520,3617,2236380,146,15314
1942,3,0,16,9,55365120,3618,2236380,146,15317
1943,6,0,16,9,55380120,3617,2236380,145,15323
1944,3,0,14,11,55396080,3617,2236380,145,15326
1945,6,0,16,9,55410660,3617,2236380,145,15332
1946,6,0,16,9,55416960,3616,2236380,145,15338
1947,5,0,18,7,55429080,3616,2236380,145,15343
1948,12,0,21,4,55455600,3616,2236380,145,15355
1949,14,2,25,0,55475880,3615,2237100,145,15369
1950,9,0,23,2,55525320,3616,2239800,145,15378
1951,7,0,21,4,55559400,3616,2239800,145,15385
1952,6,0,21,4,55594020,3617,2239800,145,15391
1953,10,0,23,2,55634460,3617,2239800,145,15401
1954,9,0,21,4,55657800,3616,2239800,145,15410
1955,11,0,21,4,55696680,3616,2239800,145,15421
1956,7,0,19,6,55733640,3616,2239800,145,15428
1957,14,0,23,2,55761180,3616,2239800,145,15442
1958,9,1,25,0,55781820,3616,2243160,145,15451
1959,13,4,25,0,55835580,3617,2250300,145,15464
1960,11,6,25,0,55877520,3618,2268900,146,15475
1961,8,0,20,5,55945560,3618,2290440,147,15483
1962,3,0,15,10,55971540,3617,2290440,147,15486
1963,11,0,20,5,55982940,3617,2290440,147,15497
1964,6,0,17,8,56011980,3616,2290440,147,15503
1965,8,0,17,8,56033280,3616,2290440,147,15511
1966,6,0,19,6,56044380,3616,2290440,147,15517
1967,4,0,14,11,56075520,3616,2290440,147,15521
1968,8,0,21,4,56082120,3616,2290440,147,15529
1969,6,0,18,7,56105640,3615,2290440,147,15535
1970,7,0,19,6,56118540,3615,2290440,147,15542
1971,5,0,17,8,56139300,3614,2290440,147,15547
1972,6,0,19,6,56152380,3614,2290440,147,15553
1973,4,0,18,7,56176620,3615,2290440,147,15557
1974,5,0,18,7,56195280,3615,2290440,147,15562
1975,9,0,23,2,56219520,3615,2290440,147,15571
1976,10,0,22,3,56256600,3615,2290740,147,15581
1977,4,0,21,4,56279460,3616,2290740,146,15585
1978,9,0,21,4,56323080,3616,2290740,146,15594
1979,16,6,25,0,56345940,3616,2291100,146,15610
1980,10,0,22,3,56401320,3615,2301480,147,15620
1981,12,0,22,3,56426280,3614,2301480,147,15632
1982,12,0,21,4,56466660,3614,2301840,147,15644
1983,9,0,22,3,56492160,3614,2301840,147,15653
1984,14,0,22,3,56529780,3613,2301960,146,15667
1985,8,0,24,1,56542620,3612,2301960,146,15675
1986,9,0,22,3,56602920,3614,2302560,146,15684
1987,7,0,22,3,56632200,3614,2302560,146,15691
1988,5,0,21,4,56666760,3615,2302560,146,15696
1989,3,0,15,10,56709360,3615,2302560,146,15699
1990,4,0,17,8,56710380,3615,2302560,146,15703
1991,7,0,18,7,56736360,3615,2302560,146,15710
1992,1,0,16,9,56751240,3615,2302560,146,15711
1993,5,0,16,9,56779560,3616,2302560,146,15716
1994,6,0,17,8,56790900,3616,2302560,146,15722
1995,8,0,18,7,56814780,3616,2302560,146,15730
1996,1,0,17,8,56825400,3616,2302560,146,15731
1997,7,0,21,4,56835660,3616,2302560,146,15738
1998,11,0,24,1,56881260,3617,2302560,146,15749
1999,6,0,19,6,56925720,3617,2304660,146,15755
2000,9,0,19,6,56964540,3617,2304660,146,15764
2001,7,0,20,5,56969160,3616,2304660,146,15771
2002,6,0,16,9,57011400,3617,2304660,146,15777
2003,12,0,23,2,57028800,3617,2304660,145,15789
2004,15,3,25,0,57058800,3616,2306100,145,15804
2005,14,0,23,2,57110400,3615,2309460,146,15818
2006,8,0,22,3,57140580,3615,2309460,145,15826
2007,9,0,22,3,57174240,3615,2309820,145,15835
2008,13,1,25,0,57212340,3615,2316420,146,15848
2009,10,1,25,0,57253860,3616,2329440,146,15858
2010,11,0,24,1,57306060,3616,2330040,146,15869
2011,7,0,20,5,57353880,3617,2330340,146,15876
2012,8,0,18,7,57391740,3617,2330340,146,15884
2013,6,0,18,7,57409140,3617,2330340,146,15890
2014,6,0,17,8,57432600,3616,2330340,146,15896
2015,4,0,17,8,57444360,3616,2330340,146,15900
2016,3,0,16,9,57470040,3617,2330340,146,15903
2017,5,0,19,6,57472260,3617,2330340,146,15908
2018,6,0,22,3,57481860,3617,2330340,146,15914
2019,3,0,19,6,57502860,3616,2330340,146,15917
2020,5,0,19,6,57521520,3617,2330340,146,15922
2021,7,0,23,2,57531900,3616,2330340,146,15929
2022,7,0,22,3,57563100,3617,2330340,146,15936
2023,9,0,23,2,57586980,3616,2330340,146,15945
2024,8,1,25,0,57613320,3617,2334720,146,15953
2025,7,0,24,1,57655080,3617,2338920,146,15960
2026,7,0,24,1,57673380,3617,2340000,146,15967
2027,9,0,23,2,57724080,3618,2340540,146,15976
2028,10,0,25,0,57744480,3617,2341260,146,15986
2029,11,2,25,0,57777720,3617,2341380,146,15997
2030,10,7,25,0,57804960,3618,2349360,146,16007
2031,12,10,25,0,57846900,3619,2362620,147,16019
2032,5,9,25,0,57874200,3619,2368380,147,16024
2033,11,14,25,0,57911280,3620,2377080,148,16035
2034,11,17,25,0,57949980,3620,2389320,148,16046
2035,6,16,25,0,57984480,3621,2414340,150,16052
2036,9,11,25,0,58028040,3621,2480400,154,16061
2037,10,0,23,2,58076760,3618,2642400,164,16071
2038,5,0,21,4,58092360,3618,2642400,164,16076
2039,0,0,18,7,58111860,3618,2642400,164,16076
2040,6,0,19,6,58119780,3618,2642400,164,16082
2041,5,0,18,7,58143540,3618,2642400,164,16087
2042,10,0,24,1,58158840,3618,2642520,164,16097
2043,6,0,23,2,58187280,3618,2642820,164,16103
2044,5,0,21,4,58215000,3618,2642820,164,16108
2045,4,0,17,8,58249500,3619,2642820,164,16112
2046,9,0,24,1,58256040,3619,2643360,163,16121
2047,6,0,22,3,58276200,3618,2643360,163,16127
2048,9,0,23,2,58313160,3619,2643360,163,16136
2049,11,0,24,1,58348920,3618,2645940,163,16147
2050,10,3,25,0,58368300,3618,2648940,163,16157
2051,15,10,25,0,58411800,3619,2655540,164,16172
2052,10,10,25,0,58446060,3619,2662740,164,16182
2053,10,8,25,0,58485300,3619,2686380,165,16192
2054,4,0,23,2,58524420,3618,2765340,170,16196
2055,8,0,20,5,58559280,3618,2765340,170,16204
2056,13,3,25,0,58575060,3618,2766240,170,16217
2057,10,7,25,0,58597500,3618,2771820,170,16227
2058,7,0,22,3,58652280,3617,2792340,172,16234
2059,5,0,18,7,58679100,3617,2792340,171,16239
2060,7,0,20,5,58698960,3617,2792340,171,16246
2061,9,0,24,1,58710480,3617,2792340,171,16255
2062,6,0,22,3,58730280,3616,2792760,171,16261
2063,5,0,19,6,58756800,3616,2792760,171,16266
2064,2,0,17,8,58773300,3616,2792760,171,16268
2065,5,0,19,6,58779960,3616,2792760,171,16273
2066,3,0,18,7,58794960,3616,2792760,171,16276
2067,5,0,20,5,58809780,3616,2792760,171,16281
2068,4,0,21,4,58823460,3616,2792760,171,16285
2069,7,0,19,6,58852980,3616,2792760,171,16292
2070,12,3,25,0,58858740,3616,2792940,171,16304
2071,8,4,25,0,58893600,3616,2797380,171,16312
2072,13,11,25,0,58922040,3617,2800980,171,16325
2073,11,17,25,0,58955580,3618,2815140,172,16336
2074,6,15,25,0,59005620,3619,2827140,172,16342
2075,8,16,25,0,59034900,3619,2859480,174,16350
2076,12,20,25,0,59079540,3620,2878080,175,16362
2077,10,22,25,0,59110740,3620,2893260,176,16372
2078,15,31,25,0,59137920,3621,2899560,177,16387
2079,16,40,25,0,59170800,3622,2904780,177,16403
2080,11,40,25,0,59216640,3623,2923740,178,16414
2081,8,36,25,0,59259000,3624,2967180,180,16422
2082,6,35,25,0,59285220,3624,3001680,182,16428
2083,11,35,25,0,59332200,3625,3065220,186,16439
2084,8,38,25,0,59354160,3625,3069600,186,16447
2085,7,37,25,0,59402520,3626,3084900,187,16454
2086,11,37,25,0,59430060,3625,3219840,195,16465
2087,7,31,25,0,59472840,3625,3287160,199,16472
2088,4,22,25,0,59509200,3625,3692940,224,16476
2089,7,17,25,0,59543940,3624,3896880,236,16483
2090,6,7,25,0,59592000,3623,4409520,267,16489
2091,4,0,21,4,59618400,3622,4615320,280,16493
2092,7,0,19,6,59643780,3621,4615320,279,16500
2093,3,0,17,8,59662080,3621,4615320,279,16503
2094,7,0,21,4,59664660,3621,4615320,279,16510
2095,9,0,21,4,59689860,3620,4616280,279,16519
2096,8,0,24,1,59708700,3620,4616280,279,16527
2097,8,0,24,1,59734080,3620,4616280,279,16535
2098,8,1,25,0,59770380,3621,4617720,279,16543
2099,10,1,25,0,59811480,3621,4624500,279,16553
2100,11,0,22,3,59854560,3621,4624560,279,16564
2101,11,3,25,0,59869560,3620,4628280,279,16575
2102,10,4,25,0,59910060,3621,4639380,279,16585
2103,9,9,25,0,59935080,3622,4645080,280,16594
2104,10,13,25,0,59977740,3623,4655880,280,16604
2105,11,18,25,0,60004740,3623,4675320,281,16615
2106,3,8,25,0,60066540,3624,4775160,287,16618
2107,8,0,20,5,60102600,3622,4844280,291,16626
2108,7,0,23,2,60115080,3622,4844280,291,16633
2109,1,0,18,7,60139260,3622,4844280,291,16634
2110,9,0,23,2,60156960,3622,4844280,291,16643
2111,10,1,25,0,60175620,3621,4844280,291,16653
2112,6,0,17,8,60222720,3621,4844460,291,16659
2113,11,0,25,0,60232320,3621,4844460,290,16670
2114,3,0,20,5,60254220,3621,4844460,290,16673
2115,4,0,18,7,60274740,3620,4844460,290,16677
2116,3,0,16,9,60290520,3620,4844460,290,16680
2117,4,0,18,7,60294180,3620,4844460,290,16684
2118,6,0,22,3,60298020,3620,4844460,290,16690
2119,5,0,22,3,60312480,3620,4844460,290,16695
2120,9,0,23,2,60339900,3620,4844460,290,16704
2121,9,1,25,0,60363600,3620,4844460,290,16713
2122,5,0,20,5,60406800,3620,4844580,290,16718
2123,7,0,23,2,60427620,3620,4844580,289,16725
2124,5,0,20,5,60439740,3619,4844580,289,16730
2125,8,0,22,3,60470520,3620,4844580,289,16738
2126,13,6,25,0,60477180,3619,4844580,289,16751
2127,11,8,25,0,60527880,3620,4859520,290,16762
2128,4,0,22,3,60559980,3619,4895220,292,16766
2129,4,0,19,6,60595920,3620,4895220,292,16770
2130,5,0,20,5,60609780,3620,4895220,292,16775
2131,10,1,25,0,60619080,3619,4895220,291,16785
2132,11,5,25,0,60646680,3620,4899780,291,16796
2133,7,8,25,0,60669960,3620,4906860,292,16803
2134,5,2,25,0,60722280,3621,4939560,294,16808
2135,5,0,20,5,60760680,3621,4958760,295,16813
2136,8,0,23,2,60778140,3620,4958760,295,16821
2137,10,0,25,0,60812100,3621,4959060,294,16831
2138,4,0,21,4,60836160,3620,4959060,294,16835
2139,8,0,23,2,60862020,3621,4959060,294,16843
2140,5,0,24,1,60878100,3621,4959060,294,16848
2141,8,0,23,2,60912660,3621,4959060,294,16856
2142,8,0,24,1,60939660,3621,4960020,294,16864
2143,8,0,23,2,60971160,3621,4960020,294,16872
2144,9,0,24,1,61007700,3621,4960020,294,16881
2145,6,0,24,1,61025340,3621,4960320,293,16887
2146,10,1,25,0,61058760,3621,4960980,293,16897
2147,16,10,25,0,61086720,3622,4965360,293,16913
2148,11,14,25,0,61127880,3623,4969800,293,16924
2149,11,19,25,0,61161720,3623,4972920,293,16935
2150,6,20,25,0,61188120,3624,4993080,294,16941
2151,14,23,25,0,61250280,3625,5006880,295,16955
2152,10,26,25,0,61276320,3625,5048880,297,16965
2153,6,24,25,0,61306440,3625,5096700,300,16971
2154,6,17,25,0,61348440,3625,5209500,307,16977
2155,5,7,25,0,61375680,3623,5429340,319,16982
2156,7,0,21,4,61425240,3622,5540760,326,16989
2157,6,0,19,6,61440180,3622,5540760,326,16995
2158,3,0,19,6,61448640,3621,5540760,326,16998
2159,0,0,16,9,61465560,3622,5540760,326,16998
2160,3,0,18,7,61474980,3622,5540760,326,17001
2161,11,1,25,0,61481940,3622,5540760,325,17012
2162,6,0,24,1,61498860,3621,5541960,325,17018
2163,13,4,25,0,61544160,3622,5543940,325,17031
2164,7,6,25,0,61567020,3622,5550300,326,17038
2165,6,2,25,0,61610220,3623,5574960,327,17044
2166,3,0,19,6,61649160,3623,5585580,327,17047
2167,5,0,20,5,61662960,3623,5585580,327,17052
2168,11,1,25,0,61677240,3622,5585700,327,17063
2169,7,0,24,1,61709100,3622,5586900,327,17070
2170,14,0,22,3,61756800,3622,5588520,327,17084
2171,12,0,24,1,61781280,3621,5588520,327,17096
2172,12,2,25,0,61803720,3621,5590800,327,17108
2173,10,0,25,0,61837560,3620,5599500,327,17118
2174,7,0,25,0,61852020,3619,5599980,327,17125
2175,10,1,25,0,61901160,3620,5607300,327,17135
2176,10,5,25,0,61911180,3620,5609340,327,17145
2177,5,0,20,5,61984380,3621,5620680,327,17150
2178,13,1,25,0,62003520,3620,5620680,327,17163
2179,4,0,21,4,62033040,3620,5624940,327,17167
2180,5,0,20,5,62058060,3620,5624940,327,17172
2181,8,0,24,1,62074980,3621,5624940,327,17180
2182,6,0,23,2,62092080,3620,5624940,327,17186
2183,2,0,18,7,62126580,3621,5624940,327,17188
2184,3,0,19,6,62141640,3621,5624940,327,17191
2185,3,0,18,7,62166780,3622,5624940,327,17194
2186,5,0,22,3,62174220,3622,5624940,327,17199
2187,5,0,19,6,62200560,3622,5624940,327,17204
2188,9,0,22,3,62218500,3621,5624940,327,17213
2189,10,0,23,2,62240040,3621,5624940,326,17223
2190,4,0,22,3,62266260,3621,5624940,326,17227
2191,11,3,25,0,62289120,3622,5626140,326,17238
2192,7,4,25,0,62323740,3622,5634060,326,17245
2193,7,0,21,4,62380500,3622,5644260,327,17252
2194,13,6,25,0,62388420,3622,5644260,327,17265
2195,11,9,25,0,62437860,3623,5657460,327,17276
2196,7,9,25,0,62471100,3624,5679120,328,17283
2197,12,12,25,0,62504040,3624,5687940,329,17295
2198,8,11,25,0,62539440,3624,5713920,330,17303
2199,4,0,22,3,62592360,3623,5812920,336,17307
2200,11,0,25,0,62610900,3623,5813640,335,17318
2201,9,2,25,0,62650560,3624,5817900,336,17327
2202,10,2,25,0,62676420,3623,5823600,336,17337
2203,6,0,24,1,62713740,3623,5835000,336,17343
2204,10,0,23,2,62746800,3623,5835000,336,17353
2205,4,0,20,5,62778960,3623,5835000,336,17357
2206,7,0,22,3,62799660,3623,5835000,336,17364
2207,5,0,21,4,62815740,3623,5835000,336,17369
2208,4,0,19,6,62841540,3623,5835000,336,17373
2209,6,0,20,5,62855400,3623,5835000,336,17379
2210,3,0,19,6,62867640,3623,5835000,335,17382
2211,0,0,16,9,62887260,3623,5835000,335,17382
2212,10,0,22,3,62894220,3623,5835000,335,17392
2213,5,0,20,5,62912820,3623,5835000,335,17397
2214,10,0,22,3,62944200,3623,5835000,335,17407
2215,8,0,23,2,62958960,3622,5835180,335,17415
2216,2,0,19,6,62990220,3623,5835180,335,17417
2217,9,0,23,2,63012900,3623,5835180,335,17426
2218,5,0,20,5,63034500,3623,5835180,335,17431
2219,9,0,24,1,63062760,3623,5835180,334,17440
2220,15,9,25,0,63088500,3624,5837880,334,17455
2221,9,12,25,0,63117180,3624,5844540,334,17464
2222,6,11,25,0,63162540,3625,5859660,335,17470
2223,15,20,25,0,63186600,3625,5865720,335,17485
2224,12,24,25,0,63229200,3626,5876340,336,17497
2225,10,24,25,0,63269640,3626,5902800,337,17507
2226,6,21,25,0,63293580,3626,5936760,339,17513
2227,5,12,25,0,63343980,3626,6077760,347,17518
2228,7,2,25,0,63388560,3625,6282720,358,17525
2229,14,5,25,0,63409500,3624,6317880,360,17539
2230,10,0,23,2,63457800,3623,6326820,360,17549
2231,6,0,25,0,63471000,3623,6327180,360,17555
2232,6,0,21,4,63512520,3623,6327180,360,17561
2233,7,0,19,6,63537660,3623,6327180,360,17568
2234,4,0,18,7,63555240,3623,6327180,360,17572
2235,8,0,20,5,63567780,3622,6327180,360,17580
2236,8,0,22,3,63579540,3622,6327180,360,17588
2237,3,0,18,7,63602640,3622,6327180,359,17591
2238,4,0,17,8,63621480,3622,6327180,359,17595
2239,5,0,21,4,63628140,3622,6327180,359,17600
2240,8,0,25,0,63644820,3622,6327180,359,17608
2241,12,5,25,0,63672780,3622,6331860,359,17620
2242,6,4,25,0,63708600,3623,6343440,360,17626
2243,10,0,22,3,63761160,3622,6367200,361,17636
2244,11,0,23,2,63790200,3622,6369000,361,17647
2245,14,3,25,0,63819600,3621,6369300,360,17661
2246,7,0,25,0,63838260,3621,6370440,360,17668
2247,6,0,23,2,63876060,3621,6376200,361,17674
2248,7,0,24,1,63908400,3622,6376200,360,17681
2249,6,0,22,3,63935460,3621,6376200,360,17687
2250,10,0,23,2,63967680,3621,6376200,360,17697
2251,9,0,25,0,63990300,3621,6380460,360,17706
2252,7,1,25,0,64018740,3622,6382860,360,17713
2253,11,1,25,0,64062300,3622,6386100,360,17724
2254,4,0,23,2,64094580,3622,6393960,360,17728
2255,7,0,22,3,64131480,3623,6393960,360,17735
2256,4,0,21,4,64145460,3623,6393960,360,17739
2257,3,0,18,7,64178460,3623,6393960,360,17742
2258,4,0,20,5,64189200,3623,6393960,360,17746
2259,5,0,23,2,64200360,3624,6393960,360,17751
2260,6,0,21,4,64228500,3624,6393960,360,17757
2261,5,0,20,5,64250160,3624,6393960,360,17762
2262,4,0,19,6,64264020,3623,6393960,360,17766
2263,6,0,19,6,64288620,3623,6393960,360,17772
2264,4,0,19,6,64305660,3624,6393960,359,17776
2265,7,0,23,2,64319340,3624,6393960,359,17783
2266,7,0,24,1,64343820,3624,6395280,359,17790
2267,11,0,23,2,64395600,3624,6396660,359,17801
2268,9,1,25,0,64409940,3624,6397320,359,17810
2269,12,7,25,0,64432860,3624,6398880,359,17822
2270,6,6,25,0,64469280,3625,6406320,359,17828
2271,8,3,25,0,64503360,3624,6439500,361,17836
2272,12,5,25,0,64551420,3625,6458340,362,17848
2273,12,10,25,0,64585320,3625,6462360,362,17860
2274,6,10,25,0,64617360,3626,6473760,362,17866
2275,14,19,25,0,64647120,3627,6478620,362,17880
2276,13,26,25,0,64694340,3628,6487440,362,17893
2277,4,24,25,0,64731780,3629,6505560,363,17897
2278,4,20,25,0,64768560,3629,6561120,366,17901
2279,4,14,25,0,64810980,3630,6669360,372,17905
2280,5,0,22,3,64858440,3628,6903960,385,17910
2281,9,0,24,1,64875660,3627,6903960,385,17919
2282,6,0,20,5,64906560,3627,6903960,385,17925
2283,5,0,21,4,64921440,3627,6903960,385,17930
2284,6,0,20,5,64946940,3627,6903960,385,17936
2285,6,0,22,3,64968300,3628,6903960,385,17942
2286,9,1,25,0,64988700,3628,6906180,385,17951
2287,7,0,25,0,65020800,3628,6908700,384,17958
2288,9,0,25,0,65059680,3628,6908880,384,17967
2289,5,0,21,4,65095800,3628,6908880,384,17972
2290,13,1,25,0,65123340,3628,6910800,384,17985
2291,6,0,25,0,65140620,3628,6914460,384,17991
2292,7,0,21,4,65196120,3629,6914460,384,17998
2293,10,0,25,0,65214720,3629,6916440,384,18008
2294,14,7,25,0,65250060,3629,6923220,384,18022
2295,10,9,25,0,65287380,3630,6930060,384,18032
2296,9,4,25,0,65332320,3629,6967140,386,18041
2297,7,0,23,2,65349720,3628,6999120,388,18048
2298,6,0,22,3,65386740,3628,6999120,387,18054
2299,7,0,21,4,65414280,3628,6999120,387,18061
2300,6,0,19,6,65442540,3628,6999120,387,18067
2301,8,0,23,2,65450460,3628,6999120,387,18075
2302,2,0,20,5,65477580,3628,6999120,387,18077
2303,6,0,19,6,65507220,3629,6999120,387,18083
2304,4,0,17,8,65512560,3628,6999120,387,18087
2305,7,0,21,4,65521740,3628,6999120,387,18094
2306,4,0,22,3,65533560,3628,6999120,387,18098
2307,5,0,21,4,65563560,3628,6999120,386,18103
2308,6,0,21,4,65581680,3628,6999120,386,18109
2309,9,0,23,2,65597160,3627,6999120,386,18118
2310,11,1,25,0,65621460,3627,6999780,386,18129
2311,6,0,25,0,65646240,3627,7007520,386,18135
2312,8,0,24,1,65673540,3627,7008420,386,18143
2313,15,7,25,0,65708400,3627,7010280,386,18158
2314,13,13,25,0,65742780,3628,7018140,386,18171
2315,7,11,25,0,65787120,3628,7028640,386,18178
2316,9,10,25,0,65818080,3628,7043100,387,18187
2317,14,9,25,0,65867580,3628,7081560,389,18201
2318,7,6,25,0,65899800,3628,7099980,390,18208
2319,13,3,25,0,65936640,3626,7202280,395,18221
2320,12,9,25,0,65962560,3627,7207860,395,18233
2321,11,17,25,0,65985180,3627,7214220,395,18244
2322,6,15,25,0,66041040,3629,7249560,397,18250
2323,8,7,25,0,66088560,3628,7341780,402,18258
2324,4,0,20,5,66116220,3626,7379580,404,18262
2325,10,0,22,3,66141180,3626,7379580,404,18272
2326,6,0,20,5,66163740,3626,7379580,404,18278
2327,4,0,19,6,66176160,3626,7379580,403,18282
2328,6,0,21,4,66188520,3625,7379580,403,18288
2329,5,0,20,5,66214140,3626,7379580,403,18293
2330,3,0,20,5,66220320,3625,7379580,403,18296
2331,7,0,20,5,66247860,3626,7380000,403,18303
2332,9,0,22,3,66270420,3625,7380000,403,18312
2333,6,0,24,1,66285960,3625,7380000,403,18318
2334,6,0,23,2,66309900,3625,7380000,403,18324
2335,9,1,25,0,66335460,3626,7380480,402,18333
2336,6,2,25,0,66361320,3626,7386660,403,18339
2337,7,1,25,0,66408180,3627,7390860,403,18346
2338,8,2,25,0,66447000,3628,7396620,403,18354
2339,18,15,25,0,66479520,3628,7398000,402,18372
2340,9,20,25,0,66499680,3629,7415040,403,18381
2341,5,14,25,0,66559500,3630,7441020,404,18386
2342,13,15,25,0,66600300,3630,7493640,407,18399
2343,8,13,25,0,66632100,3629,7523700,409,18407
2344,19,20,25,0,66674820,3629,7540560,409,18426
2345,5,19,25,0,66695640,3629,7549740,409,18431
2346,10,18,25,0,66737820,3630,7598160,412,18441
2347,8,15,25,0,66767220,3629,7675860,416,18449
2348,10,9,25,0,66815280,3628,7799580,422,18459
2349,4,0,22,3,66837780,3626,7960500,431,18463
2350,2,0,18,7,66864660,3627,7960500,431,18465
2351,7,0,20,5,66880560,3627,7960500,431,18472
2352,6,0,18,7,66906660,3626,7960500,431,18478
2353,6,0,21,4,66916980,3626,7960500,430,18484
2354,3,0,17,8,66940500,3626,7960500,430,18487
2355,3,0,16,9,66951060,3626,7960500,430,18490
2356,6,0,21,4,66955800,3626,7960500,430,18496
2357,5,0,20,5,66971700,3626,7960500,430,18501
2358,6,0,22,3,66993840,3626,7960500,430,18507
2359,8,0,25,0,67014120,3626,7960980,430,18515
2360,12,1,25,0,67050960,3626,7961580,430,18527
2361,12,6,25,0,67083300,3627,7965900,429,18539
2362,9,9,25,0,67117560,3627,7978020,430,18548
2363,10,9,25,0,67162200,3628,7986240,430,18558
2364,11,11,25,0,67196640,3628,8001600,431,18569
2365,18,22,25,0,67220640,3628,8005920,431,18587
2366,10,29,25,0,67245180,3628,8016300,431,18597
2367,12,36,25,0,67279920,3629,8037960,432,18609
2368,9,40,25,0,67317780,3630,8061840,433,18618
2369,10,40,25,0,67364100,3632,8085600,434,18628
2370,3,34,25,0,67408440,3632,8151900,437,18631
2371,2,28,25,0,67449540,3633,8264700,443,18633
2372,5,14,25,0,67485840,3631,8687760,466,18638
2373,4,0,21,4,67515120,3629,8969940,481,18642
2374,6,0,23,2,67542300,3629,8969940,481,18648
2375,7,0,22,3,67569060,3629,8969940,481,18655
2376,2,0,19,6,67589100,3629,8969940,481,18657
2377,4,0,20,5,67608840,3630,8969940,481,18661
2378,8,0,21,4,67628340,3629,8969940,480,18669
2379,12,0,23,2,67647480,3628,8969940,480,18681
2380,6,0,22,3,67665360,3628,8969940,480,18687
2381,6,0,21,4,67709400,3629,8969940,480,18693
2382,1,0,16,9,67733280,3629,8969940,480,18694
2383,7,0,19,6,67745760,3629,8969940,480,18701
2384,5,0,20,5,67753740,3629,8969940,479,18706
2385,4,0,20,5,67770180,3629,8969940,479,18710
2386,8,0,22,3,67787520,3629,8969940,479,18718
2387,14,6,25,0,67806960,3629,8972820,479,18732
2388,13,14,25,0,67832100,3629,8977080,479,18745
2389,19,24,25,0,67885440,3630,8987160,479,18764
2390,9,29,25,0,67905720,3630,8991900,479,18773
2391,13,34,25,0,67952880,3631,9013740,480,18786
2392,5,32,25,0,67991580,3632,9043380,481,18791
2393,12,37,25,0,68027580,3633,9080640,483,18803
2394,8,35,25,0,68064780,3633,9097980,484,18811
2395,3,31,25,0,68097000,3633,9185760,488,18814
2396,6,26,25,0,68139660,3633,9347700,497,18820
2397,2,1,25,0,68190660,3631,9899940,526,18822
2398,5,0,18,7,68206320,3629,9921420,527,18827
2399,4,0,19,6,68214000,3629,9921420,527,18831

