Hour,Arrivals,Waiting,Treating,Available Rooms,Total Treatment Time,Average Treatment Time,Total Wait Time,Average Wait Time,Total Arrivals
1,4,0,4,21,0,0,0,0,4
2,6,0,7,18,11640,3880,0,0,10
3,2,0,5,20,30900,4414,0,0,12
4,7,0,7,18,53580,4465,0,0,19
5,5,0,5,20,73440,3865,0,0,24
6,9,0,10,15,93900,4082,0,0,33
7,11,0,10,15,134160,3945,0,0,44
8,11,0,17,8,149460,3933,0,0,55
9,9,0,14,11,205080,4101,0,0,64
10,16,0,19,6,254700,4175,0,0,80
11,9,0,17,8,304800,4233,0,0,89
12,14,0,14,11,382140,4293,0,0,103
13,9,0,12,13,440100,4401,0,0,112
14,9,0,13,12,477720,4423,0,0,121
15,7,0,12,13,526140,4535,0,0,128
16,15,0,17,8,584580,4639,0,0,143
17,8,0,14,11,631980,4612,0,0,151
18,4,0,7,18,689880,4661,0,0,155
19,1,0,3,22,712260,4655,0,0,156
20,7,0,7,18,728160,4667,0,0,163
21,3,0,7,18,738780,4646,0,0,166
22,5,0,5,20,775260,4670,0,0,171
23,6,0,7,18,790560,4650,0,0,177
24,4,0,5,20,813840,4624,0,0,181
25,7,0,8,17,835500,4641,0,0,188
26,5,0,10,15,851640,4653,0,0,193
27,6,0,8,17,893460,4677,0,0,199
28,6,0,10,15,906900,4650,0,0,205
29,9,0,10,15,956100,4686,0,0,214
30,14,0,16,9,992160,4680,0,0,228
31,7,0,10,15,1046220,4649,0,0,235
32,5,0,9,16,1077660,4665,0,0,240
33,16,0,17,8,1117260,4674,0,0,256
34,13,0,18,7,1168560,4655,0,0,269
35,14,0,18,7,1232100,4649,0,0,283
36,14,0,18,7,1293420,4635,0,0,297
37,8,0,15,10,1353540,4667,0,0,305
38,11,0,11,14,1420080,4656,0,0,316
39,9,0,11,14,1463820,4661,0,0,325
40,17,0,23,2,1481100,4642,0,0,342
41,8,0,19,6,1542660,4660,0,0,350
42,10,0,17,8,1617540,4715,0,0,360
43,7,0,17,8,1658940,4739,0,0,367
44,7,0,8,17,1740360,4755,0,0,374
45,8,0,12,13,1757520,4750,0,0,382
46,6,0,9,16,1808760,4772,0,0,388
47,8,0,10,15,1846080,4782,0,0,396
48,9,0,9,16,1891920,4777,0,0,405
49,5,0,10,15,1907580,4768,0,0,410
50,5,0,6,19,1955580,4781,0,0,415
51,8,0,10,15,1978740,4791,0,0,423
52,3,0,9,16,1995120,4784,0,0,426
53,6,0,8,17,2032260,4793,0,0,432
54,5,0,5,20,2064420,4778,0,0,437
55,7,0,9,16,2080200,4782,0,0,444
56,10,0,9,16,2116560,4756,0,0,454
57,12,0,16,9,2135100,4744,0,0,466
58,8,0,16,9,2185200,4771,0,0,474
59,10,0,13,12,2250000,4777,0,0,484
60,7,0,9,16,2305560,4783,0,0,491
61,10,0,11,14,2344860,4785,0,0,501
62,11,0,15,10,2378400,4785,0,0,512
63,12,0,16,9,2422380,4768,0,0,524
64,18,0,22,3,2472840,4755,0,0,542
65,6,0,12,13,2543760,4745,0,0,548
66,6,0,7,18,2608860,4769,0,0,554
67,11,0,13,12,2637240,4777,0,0,565
68,11,0,16,9,2668920,4765,0,0,576
69,5,0,11,14,2722140,4775,0,0,581
70,8,0,10,15,2761200,4768,0,0,589
71,4,0,4,21,2798940,4752,0,0,593
72,8,0,7,18,2818860,4745,0,0,601
73,3,0,7,18,2829360,4739,0,0,604
74,7,0,7,18,2864160,4741,0,0,611
75,3,0,7,18,2875380,4737,0,0,614
76,6,0,6,19,2912400,4743,0,0,620
77,10,0,11,14,2935020,4741,0,0,630
78,7,0,11,14,2970240,4744,0,0,637
79,5,0,10,15,2999400,4745,0,0,642
80,9,0,6,19,3057540,4740,0,0,651
81,7,0,10,15,3067500,4733,0,0,658
82,8,0,11,14,3100500,4733,0,0,666
83,9,0,12,13,3142860,4740,0,0,675
84,6,0,11,14,3182760,4750,0,0,681
85,12,0,13,12,3227040,4745,0,0,693
86,9,0,13,12,3254700,4723,0,0,702
87,7,0,10,15,3301680,4723,0,0,709
88,8,0,10,15,3344580,4730,0,0,717
89,8,0,10,15,3377400,4723,0,0,725
90,4,0,4,21,3420180,4717,0,0,729
91,7,0,10,15,3422880,4714,0,0,736
92,4,0,7,18,3458940,4718,0,0,740
93,5,0,7,18,3484980,4722,0,0,745
94,2,0,4,21,3513660,4729,0,0,747
95,3,0,4,21,3529620,4731,0,0,750
96,6,0,7,18,3544020,4731,0,0,756
97,8,0,10,15,3564060,4726,0,0,764
98,3,0,7,18,3593520,4728,0,0,767
99,6,0,9,16,3617760,4735,0,0,773
100,2,0,4,21,3651840,4736,0,0,775
101,6,0,8,17,3664980,4741,0,0,781
102,6,0,8,17,3688020,4734,0,0,787
103,8,0,11,14,3718380,4742,0,0,795
104,7,0,9,16,3763320,4745,0,0,802
105,9,0,12,13,3792240,4746,0,0,811
106,7,0,7,18,3846480,4742,0,0,818
107,8,0,7,18,3874860,4731,0,0,826
108,6,0,11,14,3885540,4732,0,0,832
109,5,0,7,18,3928980,4733,0,0,837
110,12,0,13,12,3954180,4729,0,0,849
111,8,0,14,11,3981300,4722,0,0,857
112,7,0,12,13,4027080,4726,0,0,864
113,7,0,10,15,4083420,4742,0,0,871
114,8,0,13,12,4108380,4744,0,0,879
115,13,0,14,11,4163760,4742,0,0,892
116,10,0,13,12,4209300,4734,0,0,902
117,7,0,11,14,4249980,4732,0,0,909
118,4,0,7,18,4292340,4737,0,0,913
119,5,0,8,17,4315680,4742,0,0,918
120,6,0,7,18,4353900,4747,0,0,924
121,4,0,7,18,4377180,4752,0,0,928
122,7,0,9,16,4399380,4750,0,0,935
123,6,0,10,15,4429500,4757,0,0,941
124,3,0,7,18,4462200,4762,0,0,944
125,7,0,8,17,4494780,4766,0,0,951
126,3,0,5,20,4518420,4761,0,0,954
127,10,0,11,14,4544700,4768,0,0,964
128,8,0,11,14,4575360,4761,0,0,972
129,10,0,15,10,4609020,4766,0,0,982
130,12,0,15,10,4664160,4764,0,0,994
131,6,0,13,12,4707660,4769,0,0,1000
132,9,0,12,13,4757460,4771,0,0,1009
133,9,0,12,13,4801080,4772,0,0,1018
134,11,0,14,11,4843920,4772,0,0,1029
135,10,0,11,14,4899540,4766,0,0,1039
136,14,0,14,11,4946100,4760,0,0,1053
137,8,0,15,10,4979820,4760,0,0,1061
138,5,0,7,18,5042040,4761,0,0,1066
139,8,0,9,16,5080020,4769,0,0,1074
140,11,0,16,9,5095380,4766,0,0,1085
141,7,0,14,11,5138580,4766,0,0,1092
142,10,0,13,12,5204820,4779,0,0,1102
143,6,0,12,13,5236500,4777,0,0,1108
144,2,0,5,20,5287320,4784,0,0,1110
145,6,0,6,19,5313240,4786,0,0,1116
146,6,0,8,17,5328660,4783,0,0,1122
147,7,0,10,15,5361780,4791,0,0,1129
148,9,0,11,14,5403060,4794,0,0,1138
149,5,0,11,14,5430720,4797,0,0,1143
150,10,0,12,13,5474580,4798,0,0,1153
151,6,0,11,14,5513220,4802,0,0,1159
152,5,0,9,16,5550420,4805,0,0,1164
153,8,0,10,15,5579520,4801,0,0,1172
154,4,0,7,18,5615760,4803,0,0,1176
155,12,0,16,9,5632740,4806,0,0,1188
156,9,0,10,15,5700360,4802,0,0,1197
157,7,0,11,14,5734440,4806,0,0,1204
158,12,0,14,11,5777220,4806,0,0,1216
159,12,0,18,7,5816520,4807,0,0,1228
160,6,0,11,14,5884680,4811,0,0,1234
161,7,0,9,16,5934000,4816,0,0,1241
162,6,0,10,15,5960460,4818,0,0,1247
163,9,0,11,14,5995800,4815,0,0,1256
164,7,0,9,16,6038700,4815,0,0,1263
165,6,0,11,14,6061020,4817,0,0,1269
166,9,0,12,13,6108120,4824,0,0,1278
167,5,0,10,15,6150300,4831,0,0,1283
168,5,0,8,17,6192600,4837,0,0,1288
169,4,0,5,20,6227100,4838,0,0,1292
170,5,0,6,19,6243720,4836,0,0,1297
171,5,0,8,17,6261840,4839,0,0,1302
172,10,0,10,15,6290820,4831,0,0,1312
173,10,0,14,11,6316860,4829,0,0,1322
174,7,0,9,16,6361140,4819,0,0,1329
175,6,0,8,17,6400680,4823,0,0,1335
176,4,0,5,20,6423960,4815,0,0,1339
177,5,0,6,19,6442920,4815,0,0,1344
178,11,0,10,15,6474960,4814,0,0,1355
179,12,0,16,9,6494280,4807,0,0,1367
180,9,0,14,11,6548880,4808,0,0,1376
181,17,0,21,4,6601980,4811,0,0,1393
182,11,0,22,3,6638880,4803,0,0,1404
183,10,0,15,10,6722100,4804,0,0,1414
184,11,0,13,12,6795660,4812,0,0,1425
185,17,0,21,4,6833880,4809,0,0,1442
186,4,0,13,12,6892260,4809,0,0,1446
187,6,0,9,16,6946680,4814,0,0,1452
188,7,0,9,16,6985920,4817,0,0,1459
189,8,0,10,15,7016160,4815,0,0,1467
190,8,0,13,12,7038120,4814,0,0,1475
191,5,0,7,18,7095180,4816,0,0,1480
192,6,0,7,18,7122960,4816,0,0,1486
193,2,0,3,22,7150980,4815,0,0,1488
194,3,0,4,21,7164960,4818,0,0,1491
195,7,0,8,17,7177020,4816,0,0,1498
196,4,0,7,18,7201500,4817,0,0,1502
197,5,0,8,17,7223340,4818,0,0,1507
198,7,0,9,16,7252140,4818,0,0,1514
199,13,0,15,10,7286220,4818,0,0,1527
200,8,0,12,13,7343340,4821,0,0,1535
201,9,0,12,13,7385640,4820,0,0,1544
202,6,0,11,14,7423020,4823,0,0,1550
203,14,0,16,9,7463940,4821,0,0,1564
204,10,0,17,8,7511880,4824,0,0,1574
205,11,0,17,8,7572420,4829,0,0,1585
206,9,0,13,12,7648560,4837,0,0,1594
207,7,0,8,17,7699380,4833,0,0,1601
208,7,0,10,15,7723920,4833,0,0,1608
209,12,0,15,10,7757040,4833,0,0,1620
210,11,0,15,10,7816680,4837,0,0,1631
211,6,0,6,19,7882200,4832,0,0,1637
212,9,0,11,14,7899180,4831,0,0,1646
213,8,0,12,13,7931100,4830,0,0,1654
214,6,0,10,15,7968360,4829,0,0,1660
215,2,0,6,19,8006400,4834,0,0,1662
216,7,0,8,17,8038560,4839,0,0,1669
217,4,0,7,18,8060940,4838,0,0,1673
218,6,0,8,17,8087100,4839,0,0,1679
219,4,0,5,20,8112900,4834,0,0,1683
220,8,0,8,17,8135220,4833,0,0,1691
221,6,0,7,18,8171880,4835,0,0,1697
222,7,0,9,16,8190780,4832,0,0,1704
223,5,0,3,22,8234100,4826,0,0,1709
224,5,0,7,18,8236560,4825,0,0,1714
225,6,0,9,16,8258640,4826,0,0,1720
226,9,0,12,13,8295720,4831,0,0,1729
227,5,0,7,18,8343840,4831,0,0,1734
228,8,0,10,15,8370480,4832,0,0,1742
229,12,0,13,12,8408820,4829,0,0,1754
230,6,0,16,9,8425440,4831,0,0,1760
231,9,0,12,13,8500440,4838,0,0,1769
232,10,0,12,13,8543160,4834,0,0,1779
233,8,0,10,15,8593140,4835,0,0,1787
234,8,0,13,12,8614140,4833,0,0,1795
235,10,0,13,12,8669940,4838,0,0,1805
236,7,0,12,13,8708160,4837,0,0,1812
237,12,0,15,10,8752920,4838,0,0,1824
238,12,0,20,5,8786400,4838,0,0,1836
239,4,0,10,15,8856180,4839,0,0,1840
240,8,0,10,15,8911620,4848,0,0,1848
241,5,0,10,15,8935080,4848,0,0,1853
242,7,0,8,17,8981640,4849,0,0,1860
243,8,0,10,15,9012360,4850,0,0,1868
244,9,0,11,14,9053220,4851,0,0,1877
245,9,0,11,14,9094380,4850,0,0,1886
246,5,0,9,16,9121740,4846,0,0,1891
247,9,0,10,15,9162840,4848,0,0,1900
248,10,0,12,13,9201420,4847,0,0,1910
249,7,0,14,11,9218160,4844,0,0,1917
250,14,0,18,7,9274020,4847,0,0,1931
251,11,0,14,11,9339360,4844,0,0,1942
252,9,0,15,10,9375480,4842,0,0,1951
253,6,0,9,16,9434700,4843,0,0,1957
254,6,0,9,16,9463860,4843,0,0,1963
255,9,0,8,17,9516840,4845,0,0,1972
256,11,0,12,13,9546120,4843,0,0,1983
257,4,0,8,17,9576420,4839,0,0,1987
258,10,0,13,12,9603900,4840,0,0,1997
259,5,0,12,13,9640320,4844,0,0,2002
260,8,0,7,18,9698280,4841,0,0,2010
261,4,0,8,17,9714480,4842,0,0,2014
262,7,0,8,17,9748680,4842,0,0,2021
263,6,0,6,19,9779580,4838,0,0,2027
264,2,0,4,21,9799800,4839,0,0,2029
265,5,0,5,20,9819840,4839,0,0,2034
266,3,0,7,18,9826140,4840,0,0,2037
267,8,0,10,15,9858420,4844,0,0,2045
268,5,0,9,16,9877920,4839,0,0,2050
269,2,0,6,19,9907380,4842,0,0,2052
270,9,0,8,17,9951360,4847,0,0,2061
271,12,0,15,10,9968520,4843,0,0,2073
272,8,0,9,16,10021260,4836,0,0,2081
273,9,0,11,14,10046700,4832,0,0,2090
274,5,0,8,17,10085820,4832,0,0,2095
275,8,0,10,15,10118040,4834,0,0,2103
276,14,0,15,10,10155240,4831,0,0,2117
277,10,0,15,10,10199160,4829,0,0,2127
278,8,0,5,20,10270620,4821,0,0,2135
279,9,0,9,16,10293960,4821,0,0,2144
280,7,0,11,14,10314720,4819,0,0,2151
281,9,0,13,12,10357500,4824,0,0,2160
282,9,0,13,12,10399800,4823,0,0,2169
283,8,0,9,16,10465680,4827,0,0,2177
284,6,0,8,17,10498740,4827,0,0,2183
285,12,0,16,9,10523520,4829,0,0,2195
286,8,0,14,11,10576140,4831,0,0,2203
287,6,0,10,15,10631280,4834,0,0,2209
288,2,0,6,19,10665180,4836,0,0,2211
289,3,0,3,22,10693620,4836,0,0,2214
290,8,0,10,15,10697580,4836,0,0,2222
291,7,0,13,12,10716660,4836,0,0,2229
292,6,0,9,16,10769700,4838,0,0,2235
293,6,0,10,15,10806480,4843,0,0,2241
294,9,0,12,13,10837860,4842,0,0,2250
295,7,0,8,17,10887000,4840,0,0,2257
296,8,0,12,13,10909020,4841,0,0,2265
297,5,0,9,16,10946340,4841,0,0,2270
298,11,0,13,12,10980420,4841,0,0,2281
299,7,0,9,16,11026560,4838,0,0,2288
300,17,0,20,5,11047680,4834,0,0,2305
301,11,0,15,10,11124720,4834,0,0,2316
302,7,0,11,14,11178660,4835,0,0,2323
303,18,0,19,6,11219280,4831,0,0,2341
304,9,0,22,3,11248440,4831,0,0,2350
305,4,0,10,15,11342520,4838,0,0,2354
306,10,0,13,12,11390520,4844,0,0,2364
307,7,0,8,17,11443020,4842,0,0,2371
308,10,0,13,12,11467440,4842,0,0,2381
309,6,0,10,15,11509920,4842,0,0,2387
310,4,0,4,21,11558100,4842,0,0,2391
311,8,0,9,16,11567640,4840,0,0,2399
312,7,0,10,15,11601720,4842,0,0,2406
313,4,0,4,21,11646480,4840,0,0,2410
314,6,0,4,21,11663940,4835,0,0,2416
315,2,0,4,21,11671080,4834,0,0,2418
316,3,0,3,22,11694060,4836,0,0,2421
317,7,0,8,17,11704380,4836,0,0,2428
318,5,0,8,17,11725080,4835,0,0,2433
319,13,0,16,9,11755860,4837,0,0,2446
320,5,0,11,14,11800920,4836,0,0,2451
321,6,0,10,15,11842440,4839,0,0,2457
322,11,0,13,12,11879880,4839,0,0,2468
323,11,0,16,9,11919240,4839,0,0,2479
324,6,0,11,14,11970360,4838,0,0,2485
325,4,0,5,20,12034140,4844,0,0,2489
326,13,0,14,11,12051900,4844,0,0,2502
327,17,0,22,3,12082980,4838,0,0,2519
328,12,0,15,10,12179580,4840,0,0,2531
329,12,0,17,8,12218820,4837,0,0,2543
330,10,0,15,10,12280320,4838,0,0,2553
331,8,0,9,16,12349740,4839,0,0,2561
332,5,0,10,15,12366600,4838,0,0,2566
333,4,0,7,18,12404880,4839,0,0,2570
334,4,0,5,20,12432840,4839,0,0,2574
335,5,0,7,18,12452160,4841,0,0,2579
336,4,0,6,19,12474300,4840,0,0,2583
337,4,0,4,21,12496260,4837,0,0,2587
338,9,0,11,14,12505200,4837,0,0,2596
339,5,0,7,18,12538260,4833,0,0,2601
340,8,0,10,15,12565980,4834,0,0,2609
341,6,0,10,15,12599100,4836,0,0,2615
342,7,0,9,16,12636000,4835,0,0,2622
343,5,0,7,18,12671460,4836,0,0,2627
344,8,0,8,17,12699120,4834,0,0,2635
345,6,0,7,18,12726780,4831,0,0,2641
346,7,0,6,19,12757980,4828,0,0,2648
347,5,0,6,19,12784620,4829,0,0,2653
348,15,0,15,10,12799500,4824,0,0,2668
349,14,0,18,7,12851520,4824,0,0,2682
350,8,0,14,11,12908820,4823,0,0,2690
351,17,0,17,8,12970800,4821,0,0,2707
352,7,0,17,8,13003500,4821,0,0,2714
353,7,0,10,15,13086840,4827,0,0,2721
354,6,0,7,18,13130100,4827,0,0,2727
355,12,0,14,11,13148100,4824,0,0,2739
356,10,0,15,10,13184100,4822,0,0,2749
357,6,0,8,17,13245960,4821,0,0,2755
358,5,0,5,20,13288500,4823,0,0,2760
359,10,0,10,15,13306620,4821,0,0,2770
360,7,0,9,16,13338120,4818,0,0,2777
361,5,0,5,20,13374720,4816,0,0,2782
362,8,0,8,17,13397700,4815,0,0,2790
363,4,0,4,21,13426560,4812,0,0,2794
364,4,0,4,21,13445100,4812,0,0,2798
365,7,0,8,17,13455180,4810,0,0,2805
366,7,0,9,16,13482600,4810,0,0,2812
367,9,0,9,16,13520220,4808,0,0,2821
368,10,0,13,12,13548660,4807,0,0,2831
369,8,0,12,13,13592460,4808,0,0,2839
370,12,0,16,9,13631640,4808,0,0,2851
371,10,0,15,10,13683060,4807,0,0,2861
372,12,0,16,9,13741800,4809,0,0,2873
373,10,0,14,11,13798020,4809,0,0,2883
374,7,0,10,15,13858860,4812,0,0,2890
375,10,0,12,13,13887480,4808,0,0,2900
376,10,0,11,14,13937760,4807,0,0,2910
377,14,0,16,9,13987440,4809,0,0,2924
378,12,0,21,4,14018340,4809,0,0,2936
379,7,0,16,9,14078220,4809,0,0,2943
380,5,0,7,18,14160360,4814,0,0,2948
381,3,0,4,21,14185620,4813,0,0,2951
382,5,0,4,21,14210820,4813,0,0,2956
383,8,0,9,16,14227380,4814,0,0,2964
384,2,0,5,20,14252040,4813,0,0,2966
385,6,0,6,19,14281620,4815,0,0,2972
386,4,0,6,19,14295960,4813,0,0,2976
387,6,0,9,16,14302200,4810,0,0,2982
388,2,0,4,21,14347080,4814,0,0,2984
389,7,0,8,17,14364780,4815,0,0,2991
390,5,0,8,17,14382120,4813,0,0,2996
391,8,0,9,16,14412840,4812,0,0,3004
392,6,0,11,14,14430300,4811,0,0,3010
393,9,0,10,15,14482500,4813,0,0,3019
394,4,0,8,17,14504640,4810,0,0,3023
395,13,0,15,10,14539560,4812,0,0,3036
396,10,0,14,11,14588880,4811,0,0,3046
397,11,0,12,13,14636880,4806,0,0,3057
398,10,0,13,12,14682780,4807,0,0,3067
399,16,0,17,8,14741880,4808,0,0,3083
400,3,0,7,18,14797800,4806,0,0,3086
401,13,0,13,12,14832660,4806,0,0,3099
402,5,0,10,15,14869680,4805,0,0,3104
403,6,0,7,18,14914980,4806,0,0,3110
404,5,0,6,19,14943960,4806,0,0,3115
405,8,0,9,16,14967540,4806,0,0,3123
406,9,0,12,13,14988480,4804,0,0,3132
407,4,0,7,18,15032220,4804,0,0,3136
408,4,0,4,21,15067920,4804,0,0,3140
409,4,0,7,18,15072840,4804,0,0,3144
410,4,0,5,20,15108060,4806,0,0,3148
411,5,0,7,18,15123840,4807,0,0,3153
412,4,0,5,20,15146640,4805,0,0,3157
413,8,0,10,15,15157080,4804,0,0,3165
414,7,0,11,14,15185400,4803,0,0,3172
415,9,0,14,11,15214500,4804,0,0,3181
416,10,0,17,8,15253980,4805,0,0,3191
417,10,0,14,11,15314040,4805,0,0,3201
418,9,0,11,14,15383220,4808,0,0,3210
419,11,0,11,14,15432900,4807,0,0,3221
420,15,0,18,7,15459660,4804,0,0,3236
421,10,0,16,9,15515400,4803,0,0,3246
422,15,0,16,9,15586260,4803,0,0,3261
423,11,0,19,6,15616620,4800,0,0,3272
424,12,0,23,2,15661080,4802,0,0,3284
425,10,0,15,10,15760080,4806,0,0,3294
426,8,0,11,14,15825300,4808,0,0,3302
427,13,0,14,11,15882600,4811,0,0,3315
428,4,0,9,16,15920640,4809,0,0,3319
429,3,0,4,21,15962160,4810,0,0,3322
430,5,0,5,20,15985260,4811,0,0,3327
431,4,0,5,20,16000380,4810,0,0,3331
432,8,0,6,19,16033920,4810,0,0,3339
433,6,0,10,15,16044720,4811,0,0,3345
434,6,0,10,15,16071420,4810,0,0,3351
435,6,0,7,18,16117200,4811,0,0,3357
436,4,0,3,22,16147980,4808,0,0,3361
437,7,0,7,18,16159200,4807,0,0,3368
438,3,0,8,17,16172100,4808,0,0,3371
439,11,0,11,14,16207740,4807,0,0,3382
440,8,0,10,15,16236240,4803,0,0,3390
441,20,0,23,2,16272000,4804,0,0,3410
442,14,0,21,4,16345800,4803,2220,0,3424
443,15,0,21,4,16421040,4804,2220,0,3439
444,10,0,15,10,16504260,4806,2220,0,3449
445,11,0,14,11,16560060,4805,2220,0,3460
446,9,0,12,13,16619760,4807,2220,0,3469
447,12,0,14,11,16664520,4806,2220,0,3481
448,4,0,6,19,16721760,4806,2220,0,3485
449,9,0,11,14,16748520,4808,2220,0,3494
450,12,0,18,7,16773420,4808,2220,0,3506
451,7,0,14,11,16831380,4810,2220,0,3513
452,4,0,7,18,16899720,4814,2220,0,3517
453,6,0,8,17,16927560,4815,2220,0,3523
454,3,0,5,20,16956480,4815,2220,0,3526
455,6,0,6,19,16980840,4815,2220,0,3532
456,3,0,6,19,16993020,4815,2220,0,3535
457,10,0,11,14,17012520,4813,2220,0,3545
458,6,0,9,16,17044860,4812,2220,0,3551
459,5,0,6,19,17089380,4813,2220,0,3556
460,8,0,10,15,17108940,4813,2220,0,3564
461,5,0,8,17,17142960,4814,2220,0,3569
462,6,0,8,17,17168760,4813,2220,0,3575
463,6,0,6,19,17202480,4811,2220,0,3581
464,12,0,11,14,17224080,4808,2220,0,3593
465,8,0,11,14,17257380,4807,2220,0,3601
466,6,0,9,16,17298360,4807,2220,0,3607
467,9,0,11,14,17338920,4809,2220,0,3616
468,12,0,14,11,17371920,4806,2220,0,3628
469,8,0,14,11,17411700,4807,2220,0,3636
470,12,0,19,6,17448180,4807,2220,0,3648
471,7,0,15,10,17507340,4809,2820,0,3655
472,14,0,19,6,17567820,4813,2820,0,3669
473,14,0,21,4,17629800,4814,2820,0,3683
474,6,0,10,15,17714820,4815,2820,0,3689
475,6,0,10,15,17743080,4814,2820,0,3695
476,9,0,9,16,17795700,4816,2820,0,3704
477,2,0,5,20,17828220,4817,2820,0,3706
478,6,0,4,21,17857440,4815,2820,0,3712
479,5,0,7,18,17862720,4814,2820,0,3717
480,6,0,8,17,17883840,4813,2820,0,3723
481,2,0,3,22,17913900,4812,2820,0,3725
482,3,0,5,20,17921760,4813,2820,0,3728
483,7,0,7,18,17948940,4814,2820,0,3735
484,5,0,8,17,17967000,4814,2820,0,3740
485,4,0,5,20,17999820,4814,2820,0,3744
486,8,0,9,16,18014040,4812,2820,0,3752
487,6,0,8,17,18048540,4812,2820,0,3758
488,7,0,8,17,18081240,4812,2820,0,3765
489,6,0,11,14,18095280,4812,2820,0,3771
490,16,0,17,8,18139200,4811,2820,0,3787
491,19,0,25,0,18188820,4810,3420,0,3806
492,7,0,20,5,18252240,4812,3480,0,3813
493,15,0,19,6,18345720,4816,3480,0,3828
494,17,0,19,6,18406440,4810,3480,0,3845
495,14,0,23,2,18458700,4811,3480,0,3859
496,15,1,25,0,18523020,4813,5040,1,3874
497,5,0,10,15,18638820,4817,5100,1,3879
498,6,0,8,17,18677040,4817,5100,1,3885
499,6,0,7,18,18703500,4815,5100,1,3891
500,7,0,8,17,18736020,4816,5100,1,3898
501,6,0,9,16,18756780,4815,5100,1,3904
502,8,0,12,13,18779100,4815,5100,1,3912
503,10,0,14,11,18824640,4816,5100,1,3922
504,7,0,8,17,18883020,4815,5100,1,3929
505,2,0,6,19,18902280,4815,5100,1,3931
506,5,0,6,19,18933060,4817,5100,1,3936
507,5,0,6,19,18957660,4817,5100,1,3941
508,6,0,8,17,18979800,4818,5100,1,3947
509,5,0,8,17,19004040,4818,5100,1,3952
510,8,0,6,19,19040940,4815,5100,1,3960
511,11,0,10,15,19067460,4813,5100,1,3971
512,10,0,12,13,19102380,4812,5100,1,3981
513,7,0,10,15,19144860,4812,5100,1,3988
514,5,0,6,19,19198080,4815,5100,1,3993
515,6,0,8,17,19219200,4815,5100,1,3999
516,5,0,8,17,19244340,4815,5100,1,4004
517,11,0,11,14,19272480,4813,5100,1,4015
518,19,0,20,5,19306080,4809,5100,1,4034
519,15,0,23,2,19360500,4808,5100,1,4049
520,10,0,19,6,19430460,4809,5100,1,4059
521,8,0,13,12,19501320,4810,5100,1,4067
522,11,0,13,12,19554600,4810,5100,1,4078
523,10,0,13,12,19603320,4810,5100,1,4088
524,9,0,11,14,19657740,4810,5100,1,4097
525,10,0,16,9,19685100,4811,5100,1,4107
526,7,0,15,10,19738200,4815,5100,1,4114
527,1,0,8,17,19784220,4817,5100,1,4115
528,2,0,2,23,19840740,4821,5100,1,4117
529,9,0,10,15,19841580,4820,5100,1,4126
530,4,0,6,19,19877940,4820,5100,1,4130
531,2,0,6,19,19891560,4821,5100,1,4132
532,6,0,6,19,19927920,4822,5100,1,4138
533,8,0,8,17,19955400,4822,5100,1,4146
534,8,0,10,15,19979640,4821,5100,1,4154
535,1,0,6,19,20006520,4822,5100,1,4155
536,11,0,9,16,20047620,4822,5100,1,4166
537,8,0,10,15,20065620,4818,5100,1,4174
538,13,0,15,10,20100780,4818,5100,1,4187
539,6,0,9,16,20155020,4817,5100,1,4193
540,5,0,10,15,20177940,4818,5100,1,4198
541,14,0,16,9,20221080,4819,5100,1,4212
542,12,0,20,5,20256000,4818,5100,1,4224
543,10,0,14,11,20338260,4819,5100,1,4234
544,6,0,9,16,20386380,4818,5100,1,4240
545,9,0,12,13,20411640,4817,5100,1,4249
546,8,0,11,14,20448960,4816,5100,1,4257
547,6,0,7,18,20502480,4817,5100,1,4263
548,4,0,6,19,20527260,4817,5100,1,4267
549,9,0,11,14,20545020,4817,5100,1,4276
550,6,0,9,16,20582340,4816,5100,1,4282
551,4,0,3,22,20626980,4816,5100,1,4286
552,8,0,9,16,20636820,4816,5100,1,4294
553,4,0,7,18,20664540,4815,5100,1,4298
554,5,0,6,19,20690520,4815,5100,1,4303
555,1,0,2,23,20711040,4814,5100,1,4304
556,7,0,6,19,20722200,4813,5100,1,4311
557,9,0,10,15,20741460,4812,5100,1,4320
558,5,0,9,16,20765040,4811,5100,1,4325
559,11,0,10,15,20807040,4809,5100,1,4336
560,9,0,12,13,20832600,4807,5100,1,4345
561,9,0,12,13,20887440,4810,5100,1,4354
562,10,0,11,14,20930880,4808,5100,1,4364
563,6,0,8,17,20965800,4806,5100,1,4370
564,10,0,11,14,20996700,4805,5100,1,4380
565,15,0,20,5,21021540,4804,5100,1,4395
566,11,0,17,8,21084120,4803,5100,1,4406
567,10,0,12,13,21163020,4805,5100,1,4416
568,12,0,10,15,21233040,4806,5100,1,4428
569,9,0,13,12,21258840,4805,5100,1,4437
570,5,0,8,17,21301860,4804,5100,1,4442
571,9,0,11,14,21329820,4804,5100,1,4451
572,9,0,12,13,21358860,4801,5100,1,4460
573,9,0,12,13,21405120,4802,5100,1,4469
574,8,0,12,13,21443700,4802,5100,1,4477
575,5,0,9,16,21489720,4804,5100,1,4482
576,5,0,6,19,21528180,4804,5100,1,4487
577,3,0,8,17,21533580,4804,5100,1,4490
578,5,0,4,21,21586320,4806,5100,1,4495
579,4,0,5,20,21597780,4805,5100,1,4499
580,6,0,5,20,21619320,4804,5100,1,4505
581,4,0,6,19,21633900,4804,5100,1,4509
582,8,0,10,15,21650220,4803,5100,1,4517
583,12,0,14,11,21672840,4800,5100,1,4529
584,14,0,16,9,21734640,4801,5100,1,4543
585,10,0,15,10,21776520,4798,5100,1,4553
586,8,0,13,12,21833820,4800,5100,1,4561
587,12,0,12,13,21895560,4800,5100,1,4573
588,10,0,16,9,21921300,4799,5100,1,4583
589,10,0,13,12,21974700,4797,5100,1,4593
590,14,0,15,10,22036920,4798,5100,1,4607
591,8,0,16,9,22069320,4798,5100,1,4615
592,14,0,15,10,22145220,4799,5100,1,4629
593,16,0,22,3,22178340,4797,5100,1,4645
594,7,0,12,13,22263480,4798,5100,1,4652
595,5,0,6,19,22319880,4798,5100,1,4657
596,10,0,12,13,22341480,4799,5100,1,4667
597,5,0,9,16,22379220,4799,5100,1,4672
598,6,0,7,18,22420620,4799,5100,1,4678
599,2,0,2,23,22455420,4800,5100,1,4680
600,5,0,6,19,22461420,4800,5100,1,4685
601,2,0,4,21,22478580,4800,5100,1,4687
602,5,0,5,20,22495620,4799,5100,1,4692
603,6,0,4,21,22520340,4797,5100,1,4698
604,8,0,8,17,22535940,4796,5100,1,4706
605,5,0,4,21,22575180,4796,5100,1,4711
606,9,0,8,17,22585800,4793,5100,1,4720
607,10,0,12,13,22612560,4792,5100,1,4730
608,3,0,6,19,22645260,4790,5100,1,4733
609,12,0,12,13,22663440,4788,5100,1,4745
610,4,0,5,20,22718640,4788,5100,1,4749
611,13,0,15,10,22731420,4788,5100,1,4762
612,14,0,21,4,22763160,4787,5100,1,4776
613,16,0,21,4,22846800,4788,5640,1,4792
614,11,0,17,8,22923420,4789,5640,1,4803
615,11,0,16,9,22985280,4790,5640,1,4814
616,11,0,13,12,23057460,4791,5640,1,4825
617,5,0,8,17,23108400,4792,5640,1,4830
618,11,0,15,10,23131200,4793,5640,1,4841
619,7,0,11,14,23181360,4792,5640,1,4848
620,10,0,13,12,23218140,4792,5640,1,4858
621,2,0,2,23,23279880,4792,5640,1,4860
622,5,0,7,18,23279880,4792,5640,1,4865
623,6,0,7,18,23307060,4791,5640,1,4871
624,7,0,10,15,23328480,4792,5640,1,4878
625,6,0,9,16,23358720,4791,5640,1,4884
626,7,0,9,16,23387820,4790,5640,1,4891
627,3,0,6,19,23420100,4791,5640,1,4894
628,7,0,8,17,23445120,4791,5640,1,4901
629,7,0,7,18,23472060,4789,5640,1,4908
630,3,0,4,21,23504640,4790,5640,1,4911
631,7,0,8,17,23517060,4789,5640,1,4918
632,8,0,13,12,23527620,4788,5640,1,4926
633,11,0,16,9,23568180,4789,5640,1,4937
634,12,0,16,9,23626200,4789,5640,1,4949
635,6,0,12,13,23670540,4788,5640,1,4955
636,4,0,7,18,23727060,4791,5640,1,4959
637,17,0,17,8,23756580,4790,5640,1,4976
638,6,0,16,9,23791200,4790,5640,1,4982
639,7,0,8,17,23864640,4791,5640,1,4989
640,10,0,11,14,23904600,4792,5640,1,4999
641,11,0,14,11,23942400,4792,5640,1,5010
642,8,0,14,11,23976840,4791,5640,1,5018
643,9,0,14,11,24025380,4792,5640,1,5027
644,9,0,13,12,24082620,4794,5640,1,5036
645,10,0,11,14,24143400,4795,5640,1,5046
646,4,0,11,14,24163380,4795,5640,1,5050
647,7,0,7,18,24227760,4797,5640,1,5057
648,6,0,9,16,24240420,4796,5640,1,5063
649,6,0,9,16,24269160,4796,5640,1,5069
650,5,0,6,19,24303060,4795,5640,1,5074
651,8,0,7,18,24332160,4794,5640,1,5082
652,5,0,9,16,24347640,4794,5640,1,5087
653,10,0,12,13,24378360,4794,5640,1,5097
654,9,0,9,16,24427860,4792,5640,1,5106
655,8,0,13,12,24444420,4792,5640,1,5114
656,7,0,10,15,24495960,4792,5640,1,5121
657,7,0,11,14,24519720,4791,5640,1,5128
658,7,0,11,14,24552960,4791,5640,1,5135
659,11,0,12,13,24605820,4792,5640,1,5146
660,9,0,12,13,24639300,4790,5640,1,5155
661,7,0,11,14,24673080,4789,5640,1,5162
662,13,0,17,8,24704280,4789,5640,1,5175
663,9,0,14,11,24764580,4790,5640,1,5184
664,6,0,12,13,24810540,4791,5640,1,5190
665,12,0,15,10,24868620,4794,5640,1,5202
666,7,0,12,13,24905400,4792,5640,1,5209
667,5,0,7,18,24953640,4792,5640,1,5214
668,8,0,9,16,24982500,4792,5640,1,5222
669,6,0,9,16,25008060,4791,5640,1,5228
670,7,0,9,16,25041120,4791,5640,1,5235
671,4,0,6,19,25071360,4791,5640,1,5239
672,4,0,6,19,25087620,4790,5640,1,5243
673,3,0,7,18,25091640,4789,5640,1,5246
674,3,0,9,16,25097100,4789,5640,1,5249
675,3,0,10,15,25108740,4789,5640,1,5252
676,9,0,12,13,25130520,4787,5640,1,5261
677,7,0,17,8,25133400,4786,5640,1,5268
678,8,0,14,11,25183440,4785,5640,1,5276
679,13,0,16,9,25220040,4782,5640,1,5289
680,9,0,18,7,25251960,4782,5640,1,5298
681,7,0,16,9,25296720,4782,5640,1,5305
682,7,0,12,13,25345920,4782,5640,1,5312
683,12,0,19,6,25358880,4780,5640,1,5324
684,12,0,22,3,25401060,4780,5640,1,5336
685,8,0,17,8,25461960,4779,5640,1,5344
686,13,0,16,9,25531620,4780,5640,1,5357
687,19,0,23,2,25573620,4777,5760,1,5376
688,8,0,22,3,25620960,4778,5760,1,5384
689,9,0,16,9,25698840,4779,5760,1,5393
690,10,0,19,6,25735680,4780,5760,1,5403
691,15,0,23,2,25777980,4778,5760,1,5418
692,6,0,19,6,25833600,4779,5760,1,5424
693,11,0,17,8,25893600,4779,5760,1,5435
694,8,0,17,8,25938720,4780,5760,1,5443
695,2,0,12,13,25972140,4780,5760,1,5445
696,12,0,17,8,26007300,4780,5760,1,5457
697,7,0,17,8,26043600,4781,5760,1,5464
698,3,0,11,14,26089500,4781,5760,1,5467
699,6,0,10,15,26122080,4781,5760,1,5473
700,6,0,14,11,26131560,4781,5760,1,5479
701,5,0,12,13,26168280,4782,5760,1,5484
702,8,0,14,11,26198760,4782,5760,1,5492
703,5,0,15,10,26218200,4782,5760,1,5497
704,14,0,21,4,26261760,4783,5760,1,5511
705,13,0,22,3,26313000,4782,5760,1,5524
706,11,0,20,5,26369400,4781,5760,1,5535
707,8,0,16,9,26425860,4781,5760,1,5543
708,19,0,25,0,26470920,4780,7980,1,5562
709,19,5,25,0,26537220,4780,20280,3,5581
710,4,0,19,6,26617140,4782,37140,6,5585
711,5,0,12,13,26670420,4781,37140,6,5590
712,6,0,14,11,26696400,4782,37140,6,5596
713,11,0,17,8,26729220,4781,37140,6,5607
714,6,0,15,10,26770500,4782,37140,6,5613
715,9,0,14,11,26820060,4782,37140,6,5622
716,2,0,13,12,26834880,4782,37140,6,5624
717,6,0,12,13,26874300,4783,37140,6,5630
718,12,0,16,9,26902560,4781,37140,6,5642
719,6,0,13,12,26951340,4782,37140,6,5648
720,6,0,15,10,26978220,4784,37140,6,5654
721,3,0,10,15,27027180,4786,37140,6,5657
722,3,0,12,13,27034860,4786,37140,6,5660
723,3,0,7,18,27074100,4786,37140,6,5663
724,8,0,13,12,27080220,4786,37140,6,5671
725,3,0,11,14,27105780,4786,37140,6,5674
726,1,0,7,18,27138000,4787,37140,6,5675
727,7,0,12,13,27146040,4787,37140,6,5682
728,7,0,14,11,27162000,4786,37140,6,5689
729,4,0,13,12,27187260,4786,37140,6,5693
730,11,0,16,9,27224040,4786,37140,6,5704
731,9,0,15,10,27274800,4786,37140,6,5713
732,9,0,14,11,27312420,4784,37140,6,5722
733,17,0,22,3,27344940,4783,37140,6,5739
734,6,0,16,9,27393060,4781,37140,6,5745
735,9,0,17,8,27430200,4781,37140,6,5754
736,8,0,17,8,27469140,4781,37140,6,5762
737,10,0,15,10,27522540,4780,37140,6,5772
738,6,0,14,11,27548700,4779,37140,6,5778
739,10,0,15,10,27593820,4779,37140,6,5788
740,2,0,10,15,27624480,4779,37140,6,5790
741,5,0,10,15,27648600,4779,37140,6,5795
742,7,0,12,13,27668220,4778,37140,6,5802
743,4,0,12,13,27682800,4777,37140,6,5806
744,7,0,10,15,27726600,4777,37140,6,5813
745,5,0,11,14,27738420,4776,37140,6,5818
746,3,0,10,15,27761100,4777,37140,6,5821
747,5,0,11,14,27786120,4778,37140,6,5826
748,8,0,14,11,27807060,4777,37140,6,5834
749,4,0,13,12,27830760,4777,37140,6,5838
750,2,0,9,16,27873060,4780,37140,6,5840
751,7,0,13,12,27885720,4779,37140,6,5847
752,10,0,17,8,27906180,4778,37140,6,5857
753,8,0,16,9,27946380,4777,37140,6,5865
754,20,3,25,0,27978480,4776,37380,6,5885
755,9,0,22,3,28046280,4776,45600,7,5894
756,11,0,19,6,28117080,4776,45600,7,5905
757,15,0,25,0,28163940,4777,45600,7,5920
758,11,0,23,2,28235520,4779,47100,7,5931
759,13,0,21,4,28304100,4778,47100,7,5944
760,7,0,17,8,28355520,4778,47100,7,5951
761,6,0,14,11,28407480,4779,47100,7,5957
762,8,0,11,14,28446720,4777,47100,7,5965
763,7,0,14,11,28462080,4777,47100,7,5972
764,4,0,13,12,28490280,4777,47100,7,5976
765,6,0,13,12,28523880,4778,47100,7,5982
766,7,0,15,10,28555740,4780,47100,7,5989
767,5,0,16,9,28569960,4779,47100,7,5994
768,6,0,12,13,28622340,4779,47100,7,6000
769,2,0,9,16,28649160,4780,47100,7,6002
770,4,0,10,15,28667460,4781,47100,7,6006
771,3,0,9,16,28688640,4781,47100,7,6009
772,6,0,9,16,28711140,4780,47100,7,6015
773,3,0,11,14,28717140,4780,47100,7,6018
774,9,0,16,9,28736220,4780,47100,7,6027
775,6,0,15,10,28769160,4780,47100,7,6033
776,5,0,13,12,28807800,4781,47100,7,6038
777,6,0,12,13,28848660,4782,47100,7,6044
778,7,0,13,12,28875960,4782,47100,7,6051
779,8,0,10,15,28922100,4781,47100,7,6059
780,14,0,20,5,28941180,4781,47100,7,6073
781,6,0,16,9,28989660,4781,47100,7,6079
782,6,0,12,13,29029440,4780,47100,7,6085
783,4,0,8,17,29079060,4781,47100,7,6089
784,10,0,14,11,29086860,4780,47100,7,6099
785,9,0,19,6,29104980,4779,47100,7,6108
786,8,0,14,11,29170800,4780,47100,7,6116
787,4,0,13,12,29191380,4779,47100,7,6120
788,7,0,14,11,29218980,4779,47100,7,6127
789,3,0,13,12,29240580,4780,47100,7,6130
790,5,0,12,13,29276760,4781,47100,7,6135
791,4,0,10,15,29303880,4781,47100,7,6139
792,8,0,16,9,29315640,4781,47100,7,6147
793,7,0,14,11,29352060,4780,47100,7,6154
794,8,0,18,7,29375160,4781,47100,7,6162
795,5,0,15,10,29419320,4782,47100,7,6167
796,6,0,12,13,29473140,4783,47100,7,6173
797,6,0,12,13,29501580,4783,47100,7,6179
798,8,0,14,11,29528040,4783,47100,7,6187
799,6,0,13,12,29561400,4783,47100,7,6193
800,10,0,17,8,29585340,4782,47100,7,6203
801,9,0,18,7,29624280,4782,47100,7,6212
802,14,0,23,2,29668800,4782,47100,7,6226
803,12,0,22,3,29733120,4783,47700,7,6238
804,9,0,16,9,29811960,4784,47700,7,6247
805,7,0,17,8,29846520,4785,47700,7,6254
806,7,0,15,10,29897640,4786,47700,7,6261
807,8,0,19,6,29912700,4786,47700,7,6269
808,18,2,25,0,29969940,4787,47760,7,6287
809,13,1,25,0,30050100,4789,62760,9,6300
810,8,0,19,6,30123120,4789,63780,10,6308
811,7,0,15,10,30180060,4790,63780,10,6315
812,5,0,12,13,30215940,4790,63780,10,6320
813,3,0,10,15,30246780,4791,63780,10,6323
814,1,0,7,18,30270660,4791,63780,10,6324
815,1,0,6,19,30282480,4792,63780,10,6325
816,9,0,15,10,30282480,4792,63780,10,6334
817,7,0,16,9,30306600,4791,63780,10,6341
818,3,0,10,15,30349140,4791,63780,10,6344
819,9,0,14,11,30369720,4790,63780,10,6353
820,5,0,15,10,30390060,4791,63780,10,6358
821,9,0,15,10,30442680,4792,63780,10,6367
822,10,0,17,8,30474900,4791,63780,10,6377
823,8,0,12,13,30526020,4789,63780,9,6385
824,12,0,19,6,30544140,4788,63780,9,6397
825,12,0,20,5,30591720,4788,63780,9,6409
826,10,0,19,6,30643320,4788,63780,9,6419
827,9,0,20,5,30690840,4789,63780,9,6428
828,9,0,16,9,30758460,4790,63780,9,6437
829,4,0,13,12,30789060,4789,63780,9,6441
830,12,0,16,9,30835320,4790,63780,9,6453
831,12,0,22,3,30862560,4790,63780,9,6465
832,5,0,17,8,30911160,4790,63780,9,6470
833,11,0,17,8,30969360,4791,63780,9,6481
834,6,0,16,9,31000620,4790,63780,9,6487
835,7,0,13,12,31048380,4790,63780,9,6494
836,5,0,13,12,31075200,4791,63780,9,6499
837,4,0,10,15,31102020,4790,63780,9,6503
838,5,0,10,15,31130640,4790,63780,9,6508
839,7,0,13,12,31148940,4790,63780,9,6515
840,3,0,11,14,31165080,4789,63780,9,6518
841,7,0,11,14,31200240,4789,63780,9,6525
842,6,0,12,13,31221960,4789,63780,9,6531
843,11,0,17,8,31251900,4789,63780,9,6542
844,7,0,16,9,31285680,4788,63780,9,6549
845,4,0,13,12,31318620,4788,63780,9,6553
846,5,0,11,14,31370460,4791,63780,9,6558
847,8,0,15,10,31386600,4791,63780,9,6566
848,10,0,16,9,31422180,4789,63780,9,6576
849,6,0,14,11,31458360,4789,63780,9,6582
850,14,0,20,5,31496040,4789,63780,9,6596
851,6,0,16,9,31541700,4789,63780,9,6602
852,12,0,21,4,31578300,4789,63780,9,6614
853,15,1,25,0,31626300,4789,63840,9,6629
854,17,5,25,0,31694820,4790,70500,10,6646
855,7,0,25,0,31761180,4791,87540,13,6653
856,4,0,13,12,31842900,4792,87600,13,6657
857,12,0,15,10,31892220,4792,87600,13,6669
858,7,0,17,8,31912920,4792,87600,13,6676
859,10,0,16,9,31970040,4793,87600,13,6686
860,10,0,19,6,32005980,4793,87600,13,6696
861,9,0,18,7,32053560,4793,87600,13,6705
862,9,0,18,7,32092020,4792,87600,13,6714
863,10,0,18,7,32138100,4792,87600,13,6724
864,6,0,14,11,32189640,4792,87600,13,6730
865,5,0,12,13,32230320,4794,87600,13,6735
866,7,0,15,10,32256660,4795,87600,12,6742
867,4,0,16,9,32277360,4796,87600,12,6746
868,10,0,15,10,32330940,4796,87600,12,6756
869,10,0,23,2,32342280,4796,87600,12,6766
870,4,0,15,10,32409720,4797,87600,12,6770
871,6,0,11,14,32457420,4797,87600,12,6776
872,7,0,14,11,32479140,4798,87600,12,6783
873,12,0,20,5,32494080,4796,87600,12,6795
874,10,0,20,5,32555160,4798,87600,12,6805
875,13,0,23,2,32605020,4798,87600,12,6818
876,10,0,24,1,32657460,4799,88140,12,6828
877,17,0,25,0,32734140,4799,88140,12,6845
878,4,0,14,11,32808240,4800,88140,12,6849
879,11,0,16,9,32858520,4801,88140,12,6860
880,10,0,16,9,32900880,4800,88140,12,6870
881,13,0,21,4,32930880,4799,88140,12,6883
882,14,0,24,1,32995200,4800,88140,12,6897
883,6,0,18,7,33041400,4799,88140,12,6903
884,3,0,11,14,33101580,4800,88140,12,6906
885,4,0,12,13,33127560,4802,88140,12,6910
886,8,0,15,10,33146520,4801,88140,12,6918
887,3,0,9,16,33194640,4802,88140,12,6921
888,7,0,13,12,33209640,4802,88140,12,6928
889,5,0,12,13,33236340,4802,88140,12,6933
890,5,0,15,10,33239820,4801,88140,12,6938
891,5,0,12,13,33295860,4803,88140,12,6943
892,5,0,12,13,33320520,4803,88140,12,6948
893,4,0,13,12,33329100,4803,88140,12,6952
894,8,0,12,13,33373020,4803,88140,12,6960
895,8,0,14,11,33399240,4802,88140,12,6968
896,11,0,18,7,33422580,4801,88140,12,6979
897,8,0,14,11,33471840,4800,88140,12,6987
898,8,0,19,6,33486360,4800,88140,12,6995
899,8,0,16,9,33543600,4800,88140,12,7003
900,13,0,19,6,33588720,4800,88140,12,7016
901,10,0,23,2,33626880,4801,88140,12,7026
902,10,0,22,3,33679500,4801,88140,12,7036
903,7,0,14,11,33756360,4802,88140,12,7043
904,10,0,17,8,33790680,4802,88140,12,7053
905,13,0,23,2,33818220,4801,88140,12,7066
906,9,0,20,5,33876960,4801,88140,12,7075
907,7,0,16,9,33943260,4803,88140,12,7082
908,15,0,19,6,33995460,4802,88140,12,7097
909,9,0,17,8,34038480,4801,88140,12,7106
910,2,0,12,13,34076640,4802,88140,12,7108
911,3,0,10,15,34104720,4802,88140,12,7111
912,9,0,16,9,34119840,4802,88140,12,7120
913,8,0,16,9,34151880,4802,88140,12,7128
914,5,0,15,10,34185660,4802,88140,12,7133
915,8,0,17,8,34221720,4803,88140,12,7141
916,2,0,9,16,34270440,4803,88140,12,7143
917,3,0,9,16,34282980,4803,88140,12,7146
918,10,0,14,11,34298820,4802,88140,12,7156
919,9,0,17,8,34329120,4802,88140,12,7165
920,12,0,20,5,34372020,4802,88140,12,7177
921,7,0,19,6,34410780,4802,88140,12,7184
922,9,0,17,8,34472880,4803,88140,12,7193
923,10,0,17,8,34533120,4805,88140,12,7203
924,15,0,22,3,34568880,4803,88140,12,7218
925,13,0,19,6,34635360,4802,88140,12,7231
926,10,0,18,7,34684560,4801,88140,12,7241
927,8,0,18,7,34727280,4802,88140,12,7249
928,14,0,23,2,34774320,4803,88140,12,7263
929,11,0,24,1,34822080,4803,88140,12,7274
930,10,0,23,2,34887780,4804,88140,12,7284
931,7,0,22,3,34929480,4805,88440,12,7291
932,3,0,12,13,35008740,4807,88440,12,7294
933,7,0,12,13,35043420,4807,88440,12,7301
934,7,0,13,12,35076960,4808,88440,12,7308
935,3,0,12,13,35093940,4808,88440,12,7311
936,2,0,9,16,35126100,4809,88440,12,7313
937,5,0,9,16,35145960,4808,88440,12,7318
938,3,0,9,16,35160900,4808,88440,12,7321
939,3,0,9,16,35173260,4808,88440,12,7324
940,5,0,11,14,35191080,4808,88440,12,7329
941,4,0,12,13,35209080,4809,88440,12,7333
942,7,0,15,10,35229240,4809,88440,12,7340
943,4,0,10,15,35276160,4809,88440,12,7344
944,12,0,19,6,35291220,4810,88440,12,7356
945,14,0,22,3,35337780,4809,88440,12,7370
946,9,0,20,5,35392080,4809,88440,11,7379
947,9,0,20,5,35441820,4810,88440,11,7388
948,5,0,13,12,35494380,4809,88440,11,7393
949,9,0,16,9,35523120,4809,88440,11,7402
950,12,0,19,6,35566140,4809,88440,11,7414
951,16,3,25,0,35594580,4808,88920,11,7430
952,8,0,24,1,35662200,4810,97260,13,7438
953,13,0,22,3,35741640,4811,97260,13,7451
954,11,0,16,9,35811240,4809,97260,13,7462
955,3,0,12,13,35841840,4809,97260,13,7465
956,10,0,17,8,35870400,4809,97260,13,7475
957,4,0,15,10,35900700,4809,97260,13,7479
958,3,0,9,16,35953800,4811,97260,12,7482
959,5,0,11,14,35966340,4810,97260,12,7487
960,2,0,11,14,35977560,4811,97260,12,7489
961,1,0,8,17,36000120,4811,97260,12,7490
962,8,0,15,10,36003180,4811,97260,12,7498
963,6,0,13,12,36057000,4813,97260,12,7504
964,6,0,12,13,36082080,4812,97260,12,7510
965,5,0,12,13,36110040,4812,97260,12,7515
966,6,0,12,13,36131880,4811,97260,12,7521
967,7,0,17,8,36140340,4811,97260,12,7528
968,10,0,18,7,36177120,4810,97260,12,7538
969,8,0,13,12,36241140,4810,97260,12,7546
970,10,0,15,10,36272640,4810,97260,12,7556
971,5,0,16,9,36294240,4810,97260,12,7561
972,14,0,20,5,36340920,4810,97260,12,7575
973,7,0,17,8,36395100,4810,97260,12,7582
974,15,0,21,4,36452640,4811,97260,12,7597
975,12,0,24,1,36487020,4810,97260,12,7609
976,14,0,22,3,36559140,4809,97260,12,7623
977,9,0,20,5,36617220,4810,97260,12,7632
978,5,0,12,13,36679560,4810,97260,12,7637
979,9,0,14,11,36721620,4811,97260,12,7646
980,13,0,23,2,36732240,4810,97260,12,7659
981,9,0,21,4,36777000,4809,97920,12,7668
982,6,0,11,14,36859740,4810,97920,12,7674
983,3,0,11,14,36877440,4810,97920,12,7677
984,5,0,11,14,36904500,4810,97920,12,7682
985,5,0,13,12,36918420,4810,97920,12,7687
986,7,0,14,11,36951660,4811,97920,12,7694
987,4,0,10,15,36978960,4809,97920,12,7698
988,6,0,12,13,37001340,4810,97920,12,7704
989,10,0,18,7,37019160,4810,97920,12,7714
990,7,0,16,9,37060800,4809,97920,12,7721
991,5,0,13,12,37104180,4810,97920,12,7726
992,10,0,17,8,37134360,4810,97920,12,7736
993,4,0,10,15,37177320,4809,97920,12,7740
994,12,0,16,9,37204800,4809,97920,12,7752
995,14,0,25,0,37220520,4808,97920,12,7766
996,11,0,21,4,37293240,4808,98160,12,7777
997,9,0,19,6,37358580,4809,98160,12,7786
998,4,0,16,9,37401120,4811,98160,12,7790
999,5,0,14,11,37441020,4811,98160,12,7795
1000,13,0,22,3,37476840,4813,98160,12,7808
1001,7,0,18,7,37526340,4812,98160,12,7815
1002,11,0,20,5,37572540,4813,98160,12,7826
1003,11,0,25,0,37603560,4813,98160,12,7837
1004,10,0,21,4,37682760,4815,98160,12,7847
1005,4,0,14,11,37738740,4815,98160,12,7851
1006,8,0,14,11,37781700,4816,98160,12,7859
1007,4,0,15,10,37804320,4817,98160,12,7863
1008,3,0,8,17,37852860,4817,98160,12,7866
1009,4,0,11,14,37855320,4816,98160,12,7870
1010,4,0,9,16,37879560,4816,98160,12,7874
1011,5,0,10,15,37896120,4815,98160,12,7879
1012,3,0,8,17,37923540,4816,98160,12,7882
1013,6,0,13,12,37924860,4815,98160,12,7888
1014,4,0,11,14,37960020,4816,98160,12,7892
1015,8,0,16,9,37977240,4817,98160,12,7900
1016,9,0,18,7,38011200,4817,98160,12,7909
1017,11,0,15,10,38067000,4815,98160,12,7920
1018,3,0,14,11,38085120,4815,98160,12,7923
1019,13,0,17,8,38137680,4815,98160,12,7936
1020,11,0,22,3,38158380,4814,98160,12,7947
1021,8,0,16,9,38234700,4816,98160,12,7955
1022,14,0,23,2,38270580,4816,98160,12,7969
1023,6,0,18,7,38318940,4815,98160,12,7975
1024,12,0,18,7,38387460,4817,98160,12,7987
1025,6,0,11,14,38444460,4816,98160,12,7993
1026,6,0,12,13,38471280,4816,98160,12,7999
1027,7,0,16,9,38491140,4817,98160,12,8006
1028,10,0,19,6,38519220,4816,98160,12,8016
1029,8,0,16,9,38583900,4818,98160,12,8024
1030,7,0,14,11,38634900,4819,98160,12,8031
1031,6,0,15,10,38656560,4818,98160,12,8037
1032,4,0,12,13,38691420,4818,98160,12,8041
1033,7,0,14,11,38722740,4819,98160,12,8048
1034,6,0,14,11,38752800,4820,98160,12,8054
1035,2,0,9,16,38788980,4820,98160,12,8056
1036,3,0,10,15,38800200,4820,98160,12,8059
1037,2,0,8,17,38823780,4821,98160,12,8061
1038,9,0,13,12,38834100,4819,98160,12,8070
1039,6,0,14,11,38852400,4819,98160,12,8076
1040,12,0,19,6,38879460,4818,98160,12,8088
1041,10,0,22,3,38914560,4818,98160,12,8098
1042,7,0,14,11,38989320,4818,98160,12,8105
1043,6,0,13,12,39032700,4820,98160,12,8111
1044,8,0,17,8,39051300,4819,98160,12,8119
1045,15,0,24,1,39088680,4819,98160,12,8134
1046,11,0,24,1,39146280,4820,98160,12,8145
1047,9,0,19,6,39214260,4820,98160,12,8154
1048,9,0,16,9,39280920,4821,98160,12,8163
1049,9,0,18,7,39307800,4820,98160,12,8172
1050,10,0,18,7,39362160,4821,98160,11,8182
1051,3,0,14,11,39399600,4821,98160,11,8185
1052,7,0,13,12,39451800,4823,98160,11,8192
1053,4,0,9,16,39486600,4823,98160,11,8196
1054,6,0,12,13,39496200,4822,98160,11,8202
1055,2,0,10,15,39520860,4823,98160,11,8204
1056,8,0,13,12,39550680,4823,98160,11,8212
1057,6,0,13,12,39575280,4823,98160,11,8218
1058,7,0,14,11,39603660,4823,98160,11,8225
1059,4,0,13,12,39628020,4823,98160,11,8229
1060,14,0,19,6,39661980,4822,98160,11,8243
1061,9,0,19,6,39702120,4822,98160,11,8252
1062,4,0,15,10,39748680,4823,98160,11,8256
1063,12,0,17,8,39797040,4823,98160,11,8268
1064,12,0,19,6,39837780,4822,98160,11,8280
1065,11,0,21,4,39890100,4823,98160,11,8291
1066,13,0,22,3,39954240,4824,98220,11,8304
1067,11,0,21,4,40018320,4824,98220,11,8315
1068,7,0,13,12,40092660,4825,98220,11,8322
1069,16,0,20,5,40118460,4823,98220,11,8338
1070,5,0,14,11,40179780,4824,98220,11,8343
1071,12,0,19,6,40216320,4824,98220,11,8355
1072,9,0,18,7,40260300,4823,98220,11,8364
1073,9,0,19,6,40295880,4823,98220,11,8373
1074,7,0,16,9,40344240,4823,98220,11,8380
1075,5,0,15,10,40375920,4823,98220,11,8385
1076,6,0,14,11,40413660,4824,98220,11,8391
1077,6,0,15,10,40446600,4825,98220,11,8397
1078,2,0,12,13,40478400,4826,98220,11,8399
1079,9,0,17,8,40503240,4826,98220,11,8408
1080,2,0,8,17,40551420,4826,98220,11,8410
1081,7,0,12,13,40570080,4826,98220,11,8417
1082,2,0,9,16,40593420,4826,98220,11,8419
1083,7,0,11,14,40612380,4826,98220,11,8426
1084,4,0,12,13,40623600,4825,98220,11,8430
1085,9,0,12,13,40662000,4825,98220,11,8439
1086,5,0,13,12,40681740,4825,98220,11,8444
1087,6,0,12,13,40723380,4826,98220,11,8450
1088,11,0,17,8,40744500,4825,98220,11,8461
1089,7,0,14,11,40804920,4826,98220,11,8468
1090,14,0,18,7,40844280,4825,98220,11,8482
1091,13,0,23,2,40876800,4824,98220,11,8495
1092,9,0,17,8,40952940,4825,98220,11,8504
1093,6,0,13,12,41001600,4825,98220,11,8510
1094,7,0,12,13,41037720,4825,98220,11,8517
1095,10,0,17,8,41054640,4824,98220,11,8527
1096,8,0,17,8,41088120,4823,98220,11,8535
1097,14,0,20,5,41143680,4823,98220,11,8549
1098,11,0,19,6,41197320,4823,98220,11,8560
1099,5,0,15,10,41243700,4823,98220,11,8565
1100,12,0,16,9,41298660,4824,98220,11,8577
1101,4,0,15,10,41318400,4823,98220,11,8581
1102,12,0,16,9,41369640,4823,98220,11,8593
1103,6,0,17,8,41397600,4823,98220,11,8599
1104,5,0,13,12,41453400,4825,98220,11,8604
1105,9,0,14,11,41488320,4824,98220,11,8613
1106,3,0,8,17,41533680,4825,98220,11,8616
1107,6,0,13,12,41534880,4824,98220,11,8622
1108,3,0,10,15,41564340,4824,98220,11,8625
1109,8,0,15,10,41578560,4824,98220,11,8633
1110,9,0,18,7,41606160,4824,98220,11,8642
1111,12,0,16,9,41670360,4824,98220,11,8654
1112,6,0,17,8,41692020,4823,98220,11,8660
1113,10,0,16,9,41742240,4823,98220,11,8670
1114,9,0,15,10,41780280,4822,98220,11,8679
1115,12,0,18,7,41816460,4821,98220,11,8691
1116,10,0,19,6,41856720,4821,98220,11,8701
1117,13,0,20,5,41915400,4821,98220,11,8714
1118,4,0,12,13,41969880,4820,98220,11,8718
1119,7,0,14,11,42003000,4821,98220,11,8725
1120,11,0,22,3,42018240,4821,98220,11,8736
1121,10,0,22,3,42064500,4821,98220,11,8746
1122,10,0,19,6,42125280,4821,98220,11,8756
1123,5,0,12,13,42193500,4822,98220,11,8761
1124,6,0,14,11,42215460,4822,98220,11,8767
1125,9,0,17,8,42247500,4823,98220,11,8776
1126,8,0,16,9,42287220,4822,98220,11,8784
1127,8,0,17,8,42317220,4822,98220,11,8792
1128,7,0,11,14,42384960,4823,98220,11,8799
1129,4,0,10,15,42407460,4822,98220,11,8803
1130,6,0,10,15,42435780,4822,98220,11,8809
1131,5,0,11,14,42452580,4822,98220,11,8814
1132,7,0,17,8,42455100,4822,98220,11,8821
1133,3,0,11,14,42505200,4823,98220,11,8824
1134,5,0,11,14,42527400,4822,98220,11,8829
1135,11,0,15,10,42551760,4821,98220,11,8840
1136,11,0,20,5,42575340,4821,98220,11,8851
1137,9,0,20,5,42617760,4821,98220,11,8860
1138,10,0,17,8,42686400,4821,98220,11,8870
1139,8,0,16,9,42730920,4821,98220,11,8878
1140,13,0,20,5,42773820,4821,98220,11,8891
1141,9,0,18,7,42818820,4820,98220,11,8900
1142,9,0,18,7,42873780,4822,98220,11,8909
1143,10,0,20,5,42909060,4821,98220,11,8919
1144,12,0,19,6,42973380,4821,98220,10,8931
1145,10,0,19,6,43024320,4822,98220,10,8941
1146,10,0,20,5,43067160,4822,98220,10,8951
1147,5,0,16,9,43122960,4823,98220,10,8956
1148,8,0,17,8,43158480,4823,98220,10,8964
1149,8,0,17,8,43202340,4824,98220,10,8972
1150,3,0,9,16,43261860,4825,98220,10,8975
1151,8,0,13,12,43272180,4824,98220,10,8983
1152,4,0,13,12,43291980,4824,98220,10,8987
1153,4,0,9,16,43338780,4825,98220,10,8991
1154,4,0,11,14,43345740,4824,98220,10,8995
1155,3,0,10,15,43361760,4824,98220,10,8998
1156,3,0,8,17,43392360,4825,98220,10,9001
1157,6,0,10,15,43407000,4824,98220,10,9007
1158,2,0,10,15,43413360,4824,98220,10,9009
1159,7,0,13,12,43433280,4824,98220,10,9016
1160,6,0,14,11,43453200,4823,98220,10,9022
1161,18,0,24,1,43480680,4822,98220,10,9040
1162,5,0,17,8,43537080,4822,98220,10,9045
1163,12,0,16,9,43598220,4822,98220,10,9057
1164,14,0,21,4,43629960,4820,98220,10,9071
1165,8,0,19,6,43678920,4821,98220,10,9079
1166,16,0,25,0,43726800,4821,98220,10,9095
1167,6,0,17,8,43797840,4821,98640,10,9101
1168,6,0,12,13,43857660,4822,98640,10,9107
1169,2,0,8,17,43882440,4821,98640,10,9109
1170,12,0,18,7,43891920,4821,98640,10,9121
1171,7,0,15,10,43933800,4821,98640,10,9128
1172,11,0,17,8,43981140,4821,98640,10,9139
1173,5,0,16,9,44011080,4821,98640,10,9144
1174,8,0,15,10,44057820,4821,98640,10,9152
1175,9,0,18,7,44082300,4821,98640,10,9161
1176,4,0,14,11,44124540,4821,98640,10,9165
1177,2,0,9,16,44161620,4822,98640,10,9167
1178,3,0,10,15,44176800,4822,98640,10,9170
1179,7,0,13,12,44193960,4822,98640,10,9177
1180,5,0,13,12,44217240,4822,98640,10,9182
1181,6,0,12,13,44253780,4822,98640,10,9188
1182,5,0,12,13,44271900,4822,98640,10,9193
1183,7,0,15,10,44287920,4821,98640,10,9200
1184,11,0,20,5,44305440,4820,98640,10,9211
1185,10,0,18,7,44367720,4821,98640,10,9221
1186,11,0,20,5,44411520,4821,98640,10,9232
1187,8,0,16,9,44462580,4820,98640,10,9240
1188,3,0,10,15,44520660,4821,98640,10,9243
1189,8,0,15,10,44539380,4822,98640,10,9251
1190,12,0,21,4,44567340,4822,98640,10,9263
1191,8,0,16,9,44621640,4821,98640,10,9271
1192,11,0,17,8,44673420,4821,98640,10,9282
1193,9,0,21,4,44690940,4821,98640,10,9291
1194,8,0,16,9,44770200,4822,98640,10,9299
1195,11,0,17,8,44816100,4822,98640,10,9310
1196,11,0,17,8,44868360,4822,98640,10,9321
1197,7,0,16,9,44900400,4821,98640,10,9328
1198,4,0,11,14,44953380,4822,98640,10,9332
1199,7,0,14,11,44973180,4822,98640,10,9339
1200,4,0,13,12,45000180,4823,98640,10,9343
1201,7,0,15,10,45031560,4823,98640,10,9350
1202,4,0,12,13,45069240,4824,98640,10,9354
1203,6,0,13,12,45095160,4824,98640,10,9360
1204,3,0,12,13,45118260,4824,98640,10,9363
1205,9,0,16,9,45147300,4825,98640,10,9372
1206,7,0,14,11,45190080,4825,98640,10,9379
1207,5,0,11,14,45231000,4825,98640,10,9384
1208,3,0,10,15,45247440,4825,98640,10,9387
1209,12,0,18,7,45271980,4825,98640,10,9399
1210,10,0,24,1,45285840,4825,98640,10,9409
1211,8,0,19,6,45366600,4827,98640,10,9417
1212,9,0,18,7,45414060,4827,98640,10,9426
1213,12,0,23,2,45454920,4827,98640,10,9438
1214,7,0,17,8,45515640,4827,98640,10,9445
1215,13,0,20,5,45565680,4827,98640,10,9458
1216,10,0,18,7,45623880,4827,98640,10,9468
1217,9,0,19,6,45661200,4827,98640,10,9477
1218,5,0,13,12,45708660,4827,98640,10,9482
1219,8,0,16,9,45738420,4827,98640,10,9490
1220,7,0,13,12,45780420,4827,98640,10,9497
1221,7,0,14,11,45817380,4827,98640,10,9504
1222,6,0,14,11,45846900,4828,98640,10,9510
1223,8,0,14,11,45892620,4828,98640,10,9518
1224,3,0,14,11,45904560,4828,98640,10,9521
1225,3,0,8,17,45954420,4829,98640,10,9524
1226,5,0,11,14,45965280,4829,98640,10,9529
1227,6,0,14,11,45975840,4828,98640,10,9535
1228,10,0,18,7,46007520,4829,98640,10,9545
1229,10,0,19,6,46049100,4828,98640,10,9555
1230,7,0,18,7,46089900,4829,98640,10,9562
1231,7,0,16,9,46139040,4829,98640,10,9569
1232,5,0,12,13,46186380,4830,98640,10,9574
1233,11,0,19,6,46209660,4830,98640,10,9585
1234,15,1,25,0,46255380,4831,99600,10,9600
1235,13,2,25,0,46314660,4831,109620,11,9613
1236,12,0,25,0,46386660,4831,115560,12,9625
1237,11,0,19,6,46476660,4832,115560,11,9636
1238,8,0,19,6,46512780,4832,115560,11,9644
1239,14,0,22,3,46570740,4832,115560,11,9658
1240,10,0,22,3,46609860,4832,115560,11,9668
1241,9,0,17,8,46692000,4833,115560,11,9677
1242,15,0,23,2,46736880,4833,115620,11,9692
1243,5,0,15,10,46798260,4833,115620,11,9697
1244,9,0,16,9,46846260,4834,115620,11,9706
1245,4,0,13,12,46883100,4834,115620,11,9710
1246,11,0,17,8,46911000,4834,115620,11,9721
1247,6,0,15,10,46952520,4834,115620,11,9727
1248,2,0,11,14,46984740,4834,115620,11,9729
1249,7,0,12,13,47021100,4835,115620,11,9736
1250,5,0,14,11,47027580,4834,115620,11,9741
1251,3,0,11,14,47071620,4836,115620,11,9744
1252,9,0,16,9,47098500,4837,115620,11,9753
1253,3,0,10,15,47132520,4836,115620,11,9756
1254,9,0,16,9,47144940,4835,115620,11,9765
1255,10,0,17,8,47185200,4835,115620,11,9775
1256,10,0,14,11,47235780,4834,115620,11,9785
1257,7,0,13,12,47271780,4834,115620,11,9792
1258,8,0,14,11,47302800,4833,115620,11,9800
1259,10,0,21,4,47319600,4833,115620,11,9810
1260,15,0,22,3,47387700,4833,115620,11,9825
1261,15,3,25,0,47427540,4833,118800,12,9840
1262,12,0,24,1,47508840,4834,129360,13,9852
1263,10,0,20,5,47577000,4834,129780,13,9862
1264,11,0,19,6,47632740,4833,129780,13,9873
1265,16,0,21,4,47704380,4834,129780,13,9889
1266,13,0,24,1,47746980,4833,129780,13,9902
1267,3,0,17,8,47799120,4834,129780,13,9905
1268,6,0,14,11,47856000,4835,129780,13,9911
1269,8,0,15,10,47881740,4834,129780,13,9919
1270,3,0,11,14,47916780,4834,129780,13,9922
1271,5,0,13,12,47929380,4834,129780,13,9927
1272,2,0,10,15,47964960,4835,129780,13,9929
1273,5,0,12,13,47982780,4835,129780,13,9934
1274,7,0,15,10,48000000,4835,129780,13,9941
1275,5,0,9,16,48039180,4834,129780,13,9946
1276,5,0,9,16,48060240,4834,129780,13,9951
1277,6,0,13,12,48068520,4833,129780,13,9957
1278,8,0,18,7,48086280,4834,129780,13,9965
1279,6,0,17,8,48119700,4834,129780,13,9971
1280,5,0,12,13,48162900,4833,129780,13,9976
1281,11,0,18,7,48186480,4833,129780,12,9987
1282,7,0,16,9,48226860,4833,129780,12,9994
1283,7,0,14,11,48274500,4833,129780,12,10001
1284,12,0,20,5,48303180,4833,129780,12,10013
1285,11,0,20,5,48352080,4833,129780,12,10024
1286,8,0,20,5,48396660,4833,129780,12,10032
1287,10,0,19,6,48452820,4834,129780,12,10042
1288,12,0,19,6,48498060,4832,129780,12,10054
1289,9,0,14,11,48579180,4834,129780,12,10063
1290,13,0,21,4,48595980,4833,129780,12,10076
1291,6,0,17,8,48656340,4834,129780,12,10082
1292,10,0,16,9,48709500,4834,129780,12,10092
1293,8,0,19,6,48730500,4833,129780,12,10100
1294,3,0,10,15,48795780,4834,129780,12,10103
1295,6,0,10,15,48822120,4834,129780,12,10109
1296,3,0,10,15,48832680,4833,129780,12,10112
1297,1,0,7,18,48858000,4834,129780,12,10113
1298,3,0,8,17,48874560,4835,129780,12,10116
1299,2,0,7,18,48883860,4834,129780,12,10118
1300,3,0,7,18,48898440,4834,129780,12,10121
1301,10,0,14,11,48906960,4834,129780,12,10131
1302,4,0,12,13,48928560,4833,129780,12,10135
1303,7,0,12,13,48959040,4833,129780,12,10142
1304,10,0,17,8,48974820,4832,129780,12,10152
1305,6,0,14,11,49025640,4832,129780,12,10158
1306,10,0,20,5,49050480,4833,129780,12,10168
1307,17,1,25,0,49093320,4832,130500,12,10185
1308,12,0,21,4,49169760,4831,130560,12,10197
1309,7,0,20,5,49211040,4832,130560,12,10204
1310,5,0,14,11,49276920,4833,130560,12,10209
1311,7,0,14,11,49315500,4833,130560,12,10216
1312,13,0,17,8,49361760,4833,130560,12,10229
1313,9,0,19,6,49390140,4833,130560,12,10238
1314,5,0,11,14,49452420,4833,130560,12,10243
1315,5,0,14,11,49465080,4833,130560,12,10248
1316,5,0,11,14,49514940,4834,130560,12,10253
1317,10,0,14,11,49535460,4833,130560,12,10263
1318,6,0,13,12,49571040,4833,130560,12,10269
1319,4,0,11,14,49597980,4833,130560,12,10273
1320,7,0,13,12,49626660,4833,130560,12,10280
1321,9,0,16,9,49650300,4833,130560,12,10289
1322,4,0,11,14,49686360,4832,130560,12,10293
1323,8,0,13,12,49724160,4833,130560,12,10301
1324,3,0,10,15,49745280,4832,130560,12,10304
1325,7,0,12,13,49767780,4832,130560,12,10311
1326,4,0,11,14,49785300,4831,130560,12,10315
1327,12,0,15,10,49811700,4830,130560,12,10327
1328,8,0,16,9,49838520,4829,130560,12,10335
1329,9,0,19,6,49862340,4829,130560,12,10344
1330,5,0,14,11,49923540,4830,130560,12,10349
1331,10,0,18,7,49956000,4830,130560,12,10359
1332,13,0,25,0,49986840,4831,131700,12,10372
1333,8,0,15,10,50072820,4830,132000,12,10380
1334,13,0,20,5,50110260,4830,132000,12,10393
1335,6,0,18,7,50151720,4831,132000,12,10399
1336,7,0,12,13,50207700,4830,132000,12,10406
1337,12,0,18,7,50226600,4829,132000,12,10418
1338,4,0,13,12,50269560,4829,132000,12,10422
1339,15,0,18,7,50308320,4828,132000,12,10437
1340,7,0,18,7,50343300,4828,132000,12,10444
1341,7,0,14,11,50396700,4828,132000,12,10451
1342,9,0,15,10,50428260,4827,132000,12,10460
1343,9,0,15,10,50459460,4826,132000,12,10469
1344,6,0,14,11,50497080,4827,132000,12,10475
1345,6,0,20,5,50497080,4827,132000,12,10481
1346,2,0,18,7,50517060,4827,132000,12,10483
1347,4,0,19,6,50539380,4827,132000,12,10487
1348,5,0,20,5,50557620,4827,132000,12,10492
1349,8,0,21,4,50586060,4827,132000,12,10500
1350,5,0,22,3,50595000,4826,132000,12,10505
1351,6,0,20,5,50638980,4826,132000,12,10511
1352,10,1,25,0,50648580,4825,132000,12,10521
1353,7,0,23,2,50691780,4825,137400,13,10528
1354,11,2,25,0,50720280,4824,137820,13,10539
1355,5,0,24,1,50763540,4825,142560,13,10544
1356,10,0,22,3,50825640,4825,142560,13,10554
1357,15,1,25,0,50859540,4824,142680,13,10569
1358,9,2,25,0,50889300,4823,143580,13,10578
1359,12,3,25,0,50939100,4822,153300,14,10590
1360,10,7,25,0,50964420,4822,164160,15,10600
1361,16,16,25,0,51009780,4823,172380,16,10616
1362,2,7,25,0,51068940,4824,209940,19,10618
1363,5,6,25,0,51101280,4824,226740,21,10623
1364,5,3,25,0,51139500,4824,270360,25,10628
1365,4,0,22,3,51186120,4824,298980,28,10632
1366,6,0,19,6,51226860,4824,298980,28,10638
1367,6,0,20,5,51251340,4824,298980,28,10644
1368,6,0,22,3,51269580,4824,298980,28,10650
1369,3,0,18,7,51303000,4823,298980,28,10653
1370,4,0,19,6,51319920,4824,298980,28,10657
1371,8,0,23,2,51336000,4823,298980,28,10665
1372,4,0,19,6,51372720,4823,298980,28,10669
1373,4,0,20,5,51387060,4823,298980,28,10673
1374,7,0,24,1,51410100,4824,298980,27,10680
1375,11,0,21,4,51464460,4823,304080,28,10691
1376,10,1,25,0,51482640,4822,305400,28,10701
1377,12,5,25,0,51522540,4822,310800,29,10713
1378,8,4,25,0,51569280,4823,325620,30,10721
1379,14,8,25,0,51614040,4822,337140,31,10735
1380,12,16,25,0,51636720,4823,340020,31,10747
1381,7,14,25,0,51695160,4824,356760,33,10754
1382,10,16,25,0,51743520,4825,374220,34,10764
1383,13,22,25,0,51779220,4825,384720,35,10777
1384,15,26,25,0,51832260,4825,412320,38,10792
1385,10,27,25,0,51870780,4825,429000,39,10802
1386,6,24,25,0,51916920,4825,455940,42,10808
1387,5,20,25,0,51959100,4825,544440,50,10813
1388,3,10,25,0,52010640,4824,797160,73,10816
1389,6,0,25,0,52056720,4821,1040220,96,10822
1390,5,0,20,5,52084680,4819,1040220,96,10827
1391,7,0,20,5,52125120,4820,1040220,96,10834
1392,4,0,18,7,52149300,4819,1040220,95,10838
1393,3,0,17,8,52167300,4819,1040220,95,10841
1394,7,0,21,4,52183860,4819,1040220,95,10848
1395,7,0,23,2,52203780,4819,1040220,95,10855
1396,4,0,20,5,52239120,4819,1040220,95,10859
1397,7,0,21,4,52272840,4819,1040220,95,10866
1398,7,0,24,1,52289460,4819,1040220,95,10873
1399,9,0,22,3,52344420,4819,1040220,95,10882
1400,9,0,25,0,52366860,4819,1040220,95,10891
1401,11,2,25,0,52409520,4819,1045500,95,10902
1402,14,10,25,0,52441860,4819,1049580,96,10916
1403,7,9,25,0,52491240,4820,1060140,97,10923
1404,12,12,25,0,52543860,4821,1087740,99,10935
1405,8,15,25,0,52575600,4822,1123860,102,10943
1406,16,23,25,0,52623720,4822,1134360,103,10959
1407,9,26,25,0,52660440,4823,1149060,104,10968
1408,14,32,25,0,52708200,4824,1174920,106,10982
1409,11,34,25,0,52755540,4824,1186080,107,10993
1410,8,35,25,0,52791120,4825,1248300,113,11001
1411,6,33,25,0,52829880,4825,1301820,118,11007
1412,12,39,25,0,52869720,4826,1404120,127,11019
1413,3,34,25,0,52923240,4827,1441740,130,11022
1414,1,25,25,0,52976940,4827,1584360,143,11023
1415,10,21,25,0,53023680,4826,1758600,159,11033
1416,7,18,25,0,53063280,4825,1865160,168,11040
1417,4,10,25,0,53104920,4823,2079660,188,11044
1418,9,8,25,0,53153040,4823,2194500,198,11053
1419,5,0,22,3,53190060,4819,2460060,222,11058
1420,6,0,23,2,53216640,4819,2460060,222,11064
1421,7,0,22,3,53261760,4820,2460060,222,11071
1422,7,0,23,2,53287680,4820,2460060,222,11078
1423,5,0,18,7,53336160,4820,2460060,221,11083
1424,7,0,21,4,53351460,4819,2460060,221,11090
1425,7,0,23,2,53375160,4819,2460060,221,11097
1426,7,0,23,2,53419440,4820,2460060,221,11104
1427,10,0,25,0,53450940,4820,2460060,221,11114
1428,11,2,25,0,53496420,4820,2463900,221,11125
1429,15,9,25,0,53532060,4820,2469840,221,11140
1430,9,10,25,0,53573520,4820,2486100,222,11149
1431,10,13,25,0,53609580,4820,2492820,223,11159
1432,8,12,25,0,53665980,4821,2505900,224,11167
1433,8,15,25,0,53699760,4822,2511180,224,11175
1434,3,8,25,0,53752920,4823,2570100,229,11178
1435,9,6,25,0,53794860,4822,2608620,233,11187
1436,5,0,21,4,53840940,4819,2723760,243,11192
1437,10,0,25,0,53870760,4819,2723760,243,11202
1438,9,3,25,0,53895600,4819,2724360,243,11211
1439,8,4,25,0,53942040,4820,2729940,243,11219
1440,6,0,24,1,53997720,4820,2746260,244,11225
1441,5,0,19,6,54041460,4820,2746260,244,11230
1442,6,0,21,4,54055800,4819,2746260,244,11236
1443,8,0,25,0,54073500,4819,2746260,244,11244
1444,12,1,25,0,54119280,4819,2748000,244,11256
1445,5,0,22,3,54160560,4818,2750100,244,11261
1446,6,0,20,5,54206100,4819,2750100,244,11267
1447,6,0,22,3,54225240,4819,2750100,243,11273
1448,6,0,22,3,54255720,4819,2750100,243,11279
1449,5,0,22,3,54288180,4820,2750100,243,11284
1450,6,0,24,1,54305640,4820,2750100,243,11290
1451,15,7,25,0,54346080,4820,2756640,243,11305
1452,13,13,25,0,54390360,4821,2761560,244,11318
1453,12,18,25,0,54434220,4822,2778720,245,11330
1454,7,16,25,0,54482460,4823,2797020,246,11337
1455,10,19,25,0,54522840,4823,2808960,247,11347
1456,11,24,25,0,54559200,4824,2816940,248,11358
1457,18,35,25,0,54600720,4825,2832780,249,11376
1458,10,38,25,0,54648300,4826,2848380,250,11386
1459,4,36,25,0,54684360,4826,2856360,250,11390
1460,7,32,25,0,54749100,4827,2943120,258,11397
1461,6,30,25,0,54788460,4828,2977740,261,11403
1462,7,29,25,0,54832500,4828,3068580,268,11410
1463,6,25,25,0,54876780,4828,3120240,273,11416
1464,4,19,25,0,54918000,4827,3291600,288,11420
1465,4,15,25,0,54958740,4827,3473880,304,11424
1466,7,7,25,0,55011600,4826,3806820,333,11431
1467,9,8,25,0,55045320,4825,3845700,336,11440
1468,9,4,25,0,55084560,4823,4066140,355,11449
1469,3,0,23,2,55136160,4824,4096140,357,11452
1470,8,0,23,2,55173060,4824,4096140,357,11460
1471,3,0,20,5,55201260,4824,4096140,357,11463
1472,7,0,21,4,55235640,4824,4096140,357,11470
1473,8,0,23,2,55257060,4823,4096140,356,11478
1474,9,0,24,1,55294440,4823,4096140,356,11487
1475,13,4,25,0,55322400,4822,4097400,356,11500
1476,14,11,25,0,55358640,4823,4104540,356,11514
1477,10,11,25,0,55410120,4823,4135260,358,11524
1478,6,13,25,0,55435680,4823,4143600,359,11530
1479,11,15,25,0,55488480,4824,4153320,359,11541
1480,8,15,25,0,55537020,4825,4164840,360,11549
1481,8,16,25,0,55574400,4825,4179120,361,11557
1482,8,15,25,0,55621080,4826,4186560,362,11565
1483,9,17,25,0,55662480,4826,4219200,364,11574
1484,9,17,25,0,55708860,4827,4230480,365,11583
1485,6,17,25,0,55747020,4827,4238880,365,11589
1486,4,14,25,0,55788540,4828,4329060,373,11593
1487,6,9,25,0,55844160,4828,4506120,388,11599
1488,6,4,25,0,55893960,4828,4651200,400,11605
1489,5,0,20,5,55927740,4825,4745640,408,11610
1490,5,0,21,4,55951380,4825,4745640,408,11615
1491,3,0,21,4,55965180,4825,4745640,408,11618
1492,8,0,24,1,55996020,4826,4745640,408,11626
1493,6,0,23,2,56032080,4826,4745640,407,11632
1494,4,0,21,4,56061180,4826,4745640,407,11636
1495,5,0,19,6,56094420,4826,4745640,407,11641
1496,8,0,21,4,56121900,4826,4745640,407,11649
1497,9,0,24,1,56145360,4825,4745640,407,11658
1498,9,3,25,0,56169780,4825,4747080,406,11667
1499,8,3,25,0,56221500,4827,4756140,407,11675
1500,9,4,25,0,56258400,4826,4758480,407,11684
1501,13,6,25,0,56317800,4827,4770780,407,11697
1502,11,15,25,0,56328420,4827,4777260,408,11708
1503,10,16,25,0,56385660,4828,4793940,409,11718
1504,12,18,25,0,56444580,4829,4817940,410,11730
1505,7,20,25,0,56468940,4829,4830240,411,11737
1506,6,17,25,0,56527020,4830,4847160,412,11743
1507,7,16,25,0,56570340,4831,4894860,416,11750
1508,4,14,25,0,56609340,4832,4933380,419,11754
1509,5,7,25,0,56658180,4831,5098260,433,11759
1510,5,0,23,2,56702580,4829,5231280,444,11764
1511,5,0,21,4,56727360,4828,5231280,444,11769
1512,10,0,25,0,56762880,4829,5232060,444,11779
1513,4,0,20,5,56806080,4829,5232060,444,11783
1514,3,0,16,9,56840700,4829,5232060,443,11786
1515,2,0,15,10,56856600,4829,5232060,443,11788
1516,8,0,22,3,56857800,4829,5232060,443,11796
1517,6,0,19,6,56897340,4828,5232060,443,11802
1518,3,0,16,9,56924100,4828,5232060,443,11805
1519,9,0,22,3,56928780,4827,5232060,442,11814
1520,8,2,25,0,56945040,4827,5233560,442,11822
1521,9,6,25,0,56976960,4828,5238420,442,11831
1522,9,6,25,0,57034320,4829,5245440,443,11840
1523,13,9,25,0,57083760,4829,5258820,443,11853
1524,13,14,25,0,57124980,4830,5266560,443,11866
1525,3,11,25,0,57162000,4830,5286120,445,11869
1526,7,11,25,0,57206460,4831,5321640,448,11876
1527,13,14,25,0,57255240,4831,5328060,448,11889
1528,9,14,25,0,57298020,4831,5343660,449,11898
1529,11,19,25,0,57328020,4831,5351880,449,11909
1530,12,22,25,0,57388500,4833,5358840,449,11921
1531,5,20,25,0,57426840,4833,5373480,450,11926
1532,6,19,25,0,57463260,4833,5437320,455,11932
1533,8,16,25,0,57515220,4833,5512260,461,11940
1534,6,12,25,0,57561120,4833,5623380,470,11946
1535,6,6,25,0,57610620,4832,5787660,484,11952
1536,3,0,18,7,57655440,4829,5922000,495,11955
1537,9,0,21,4,57679380,4829,5922000,494,11964
1538,5,0,18,7,57710040,4828,5922000,494,11969
1539,4,0,20,5,57717720,4828,5922000,494,11973
1540,4,0,18,7,57752100,4829,5922000,494,11977
1541,10,0,23,2,57769020,4828,5922000,494,11987
1542,7,0,23,2,57800460,4828,5922000,493,11994
1543,9,1,25,0,57828060,4828,5922180,493,12003
1544,5,0,18,7,57890640,4828,5923200,493,12008
1545,10,0,24,1,57902700,4827,5923200,492,12018
1546,6,0,23,2,57933360,4827,5923200,492,12024
1547,15,7,25,0,57964980,4827,5925480,492,12039
1548,6,4,25,0,58016820,4828,5942340,493,12045
1549,10,7,25,0,58049220,4828,5945700,493,12055
1550,10,12,25,0,58083600,4829,5958420,494,12065
1551,4,6,25,0,58134780,4829,5973720,494,12069
1552,6,4,25,0,58193820,4830,6008100,497,12075
1553,8,6,25,0,58223520,4831,6019980,498,12083
1554,8,8,25,0,58257300,4831,6053880,500,12091
1555,13,13,25,0,58306740,4832,6061380,500,12104
1556,5,8,25,0,58359120,4832,6084480,502,12109
1557,12,7,25,0,58419960,4832,6103080,503,12121
1558,7,11,25,0,58432080,4832,6108840,503,12128
1559,8,10,25,0,58484760,4833,6133920,505,12136
1560,2,2,25,0,58533540,4833,6254160,515,12138
1561,4,0,21,4,58560300,4831,6298620,518,12142
1562,7,0,22,3,58595640,4831,6298620,518,12149
1563,7,0,23,2,58624740,4831,6298620,518,12156
1564,4,0,23,2,58640640,4831,6298620,517,12160
1565,12,3,25,0,58686300,4832,6303600,517,12172
1566,7,0,24,1,58728420,4831,6310020,518,12179
1567,6,0,21,4,58771980,4831,6310020,517,12185
1568,6,0,21,4,58803300,4831,6310020,517,12191
1569,8,1,25,0,58816920,4831,6310020,517,12199
1570,7,0,21,4,58881600,4832,6310500,516,12206
1571,14,2,25,0,58916340,4831,6315900,516,12220
1572,8,8,25,0,58927080,4832,6318360,517,12228
1573,12,8,25,0,59002020,4833,6335040,517,12240
1574,14,13,25,0,59039580,4832,6341640,517,12254
1575,10,16,25,0,59070360,4832,6352620,518,12264
1576,10,19,25,0,59119260,4833,6361380,518,12274
1577,12,23,25,0,59165580,4834,6393420,520,12286
1578,7,22,25,0,59211360,4835,6438180,523,12293
1579,6,20,25,0,59249160,4835,6502020,528,12299
1580,9,16,25,0,59301780,4834,6543840,531,12308
1581,6,18,25,0,59325660,4834,6573300,533,12314
1582,8,16,25,0,59390580,4835,6632820,538,12322
1583,1,11,25,0,59417340,4835,6696960,543,12323
1584,5,0,18,7,59486160,4832,7010040,568,12328
1585,6,0,21,4,59496000,4831,7010040,568,12334
1586,5,0,21,4,59524260,4832,7010040,568,12339
1587,6,0,20,5,59561220,4832,7010040,567,12345
1588,8,0,24,1,59578560,4832,7010040,567,12353
1589,5,0,20,5,59614620,4831,7010100,567,12358
1590,6,0,22,3,59640780,4832,7010100,566,12364
1591,7,0,18,7,59690400,4832,7010100,566,12371
1592,7,0,20,5,59711520,4831,7010100,566,12378
1593,13,3,25,0,59731200,4831,7010640,565,12391
1594,8,3,25,0,59771160,4831,7016940,565,12399
1595,9,3,25,0,59821740,4832,7026120,566,12408
1596,11,8,25,0,59844900,4831,7035660,566,12419
1597,5,6,25,0,59886240,4832,7043880,566,12424
1598,8,5,25,0,59940000,4833,7057080,567,12432
1599,8,3,25,0,59989500,4833,7077600,568,12440
1600,8,0,23,2,60038280,4832,7114260,571,12448
1601,14,5,25,0,60072180,4832,7122480,571,12462
1602,8,7,25,0,60110160,4832,7126620,571,12470
1603,14,11,25,0,60158460,4832,7134420,571,12484
1604,6,11,25,0,60195420,4833,7148400,572,12490
1605,6,9,25,0,60239820,4833,7171860,573,12496
1606,2,0,23,2,60295560,4833,7279200,582,12498
1607,6,0,21,4,60322800,4832,7279200,582,12504
1608,10,1,25,0,60345900,4832,7280460,581,12514
1609,4,0,18,7,60399300,4831,7281900,581,12518
1610,3,0,17,8,60415620,4831,7281900,581,12521
1611,6,0,21,4,60423420,4831,7281900,581,12527
1612,6,0,21,4,60452460,4831,7281900,581,12533
1613,11,0,24,1,60484560,4831,7282380,580,12544
1614,5,0,21,4,60520740,4830,7282980,580,12549
1615,9,0,24,1,60554520,4831,7282980,579,12558
1616,7,0,22,3,60601740,4831,7283160,579,12565
1617,4,0,21,4,60627900,4831,7283160,579,12569
1618,11,1,25,0,60657960,4831,7283760,579,12580
1619,14,6,25,0,60696660,4831,7284600,578,12594
1620,6,1,25,0,60753840,4831,7299660,579,12600
1621,14,9,25,0,60782040,4831,7305000,579,12614
1622,11,11,25,0,60836400,4832,7313460,579,12625
1623,13,18,25,0,60865560,4832,7322760,579,12638
1624,6,14,25,0,60925140,4833,7349460,581,12644
1625,5,9,25,0,60962940,4832,7406640,585,12649
1626,8,5,25,0,61010400,4831,7458660,589,12657
1627,8,4,25,0,61044960,4831,7509480,592,12665
1628,9,3,25,0,61080300,4830,7537860,594,12674
1629,7,0,24,1,61138860,4830,7573680,597,12681
1630,3,0,22,3,61164720,4830,7573680,597,12684
1631,8,0,23,2,61200360,4830,7573680,596,12692
1632,9,0,25,0,61240020,4831,7576020,596,12701
1633,7,0,23,2,61285500,4831,7576260,596,12708
1634,3,0,20,5,61318200,4831,7576260,596,12711
1635,6,0,22,3,61343760,4832,7576260,595,12717
1636,6,0,20,5,61378860,4831,7576260,595,12723
1637,8,0,20,5,61413840,4831,7576260,595,12731
1638,2,0,20,5,61423080,4831,7576260,595,12733
1639,5,0,19,6,61460280,4832,7576260,594,12738
1640,11,0,25,0,61480980,4831,7576260,594,12749
1641,10,2,25,0,61522980,4832,7580040,594,12759
1642,12,0,25,0,61573440,4830,7582140,593,12771
1643,11,0,25,0,61615140,4829,7587060,593,12782
1644,8,0,23,2,61650300,4828,7587600,593,12790
1645,14,4,25,0,61684200,4828,7591020,593,12804
1646,13,9,25,0,61727220,4828,7600800,593,12817
1647,9,14,25,0,61752600,4829,7605600,592,12826
1648,9,15,25,0,61810740,4830,7631400,594,12835
1649,8,13,25,0,61865460,4831,7667220,596,12843
1650,10,17,25,0,61900980,4831,7672320,596,12853
1651,6,15,25,0,61946280,4832,7696200,598,12859
1652,7,11,25,0,61990920,4831,7747140,602,12866
1653,11,13,25,0,62032260,4831,7809060,606,12877
1654,7,11,25,0,62074680,4831,7871460,610,12884
1655,8,11,25,0,62113020,4831,7879020,611,12892
1656,3,0,25,0,62165760,4830,8068980,625,12895
1657,4,0,17,8,62208960,4829,8068980,625,12899
1658,7,0,22,3,62213940,4828,8068980,625,12906
1659,4,0,21,4,62241480,4829,8068980,625,12910
1660,4,0,16,9,62279880,4828,8068980,624,12914
1661,5,0,19,6,62290320,4828,8068980,624,12919
1662,8,0,22,3,62321580,4829,8068980,624,12927
1663,4,0,20,5,62347800,4829,8068980,624,12931
1664,8,0,22,3,62373300,4828,8068980,623,12939
1665,11,3,25,0,62397120,4828,8072100,623,12950
1666,9,3,25,0,62441700,4828,8080020,623,12959
1667,8,2,25,0,62484240,4828,8091960,624,12967
1668,7,0,24,1,62532000,4828,8095800,624,12974
1669,12,4,25,0,62563080,4828,8097120,623,12986
1670,8,4,25,0,62608260,4829,8102940,623,12994
1671,15,12,25,0,62643480,4829,8105820,623,13009
1672,10,13,25,0,62694900,4829,8116200,623,13019
1673,16,20,25,0,62742840,4830,8123580,623,13035
1674,11,27,25,0,62764920,4830,8139960,624,13046
1675,15,34,25,0,62824980,4831,8158860,624,13061
1676,10,35,25,0,62870940,4832,8175240,625,13071
1677,4,33,25,0,62903460,4832,8189280,626,13075
1678,9,34,25,0,62950800,4833,8210100,627,13084
1679,6,31,25,0,63001500,4833,8275260,632,13090
1680,6,31,25,0,63030720,4833,8279700,632,13096
1681,5,27,25,0,63083400,4834,8409360,641,13101
1682,2,24,25,0,63118440,4835,8456700,645,13103
1683,7,19,25,0,63171540,4834,8662380,660,13110
1684,6,15,25,0,63219420,4834,8839680,673,13116
1685,7,12,25,0,63265860,4834,8988660,684,13123
1686,10,13,25,0,63302220,4834,9176700,698,13133
1687,8,12,25,0,63341280,4833,9186540,699,13141
1688,8,16,25,0,63366480,4834,9195120,699,13149
1689,7,14,25,0,63426240,4835,9243780,702,13156
1690,8,11,25,0,63474900,4835,9253560,702,13164
1691,8,4,25,0,63523080,4833,9525780,723,13172
1692,11,8,25,0,63555660,4833,9528900,722,13183
1693,4,4,25,0,63603120,4833,9569460,725,13187
1694,16,8,25,0,63654000,4833,9644040,730,13203
1695,7,11,25,0,63678120,4833,9648960,730,13210
1696,8,10,25,0,63727800,4834,9677280,732,13218
1697,15,16,25,0,63770640,4834,9683580,731,13233
1698,10,18,25,0,63818460,4834,9688740,731,13243
1699,14,25,25,0,63855660,4834,9697260,731,13257
1700,5,23,25,0,63896280,4835,9707760,731,13262
1701,6,22,25,0,63935100,4835,9737340,734,13268
1702,5,20,25,0,63979920,4836,9800340,738,13273
1703,10,18,25,0,64029120,4836,9875820,743,13283
1704,5,12,25,0,64085400,4836,9987240,751,13288
1705,8,2,25,0,64122540,4832,10365660,779,13296
1706,6,0,25,0,64161360,4832,10366860,779,13302
1707,4,0,20,5,64204920,4832,10366860,779,13306
1708,6,0,19,6,64239000,4832,10366860,778,13312
1709,7,0,22,3,64257300,4832,10366860,778,13319
1710,1,0,19,6,64277460,4832,10366860,778,13320
1711,5,0,18,7,64310700,4832,10366860,778,13325
1712,12,1,25,0,64322640,4832,10366980,777,13337
1713,14,6,25,0,64362240,4832,10372500,777,13351
1714,7,4,25,0,64408080,4832,10389300,777,13358
1715,10,5,25,0,64451640,4832,10399380,778,13368
1716,11,7,25,0,64494960,4832,10403880,777,13379
1717,17,17,25,0,64529760,4832,10409340,777,13396
1718,7,18,25,0,64570920,4833,10424700,777,13403
1719,9,21,25,0,64608540,4833,10446660,778,13412
1720,13,24,25,0,64667160,4834,10496280,781,13425
1721,12,28,25,0,64707720,4834,10514760,782,13437
1722,12,34,25,0,64744320,4835,10520700,782,13449
1723,5,30,25,0,64800060,4836,10540380,783,13454
1724,10,36,25,0,64823340,4836,10575960,785,13464
1725,8,34,25,0,64887060,4837,10600500,786,13472
1726,11,40,25,0,64911000,4837,10608480,787,13483
1727,6,35,25,0,64962900,4838,10685700,792,13489
1728,4,28,25,0,65016900,4838,10842780,803,13493
1729,3,26,25,0,65045220,4838,10864200,805,13496
1730,3,17,25,0,65103000,4838,11148900,826,13499
1731,2,1,25,0,65160240,4836,11797620,873,13501
1732,7,0,22,3,65177160,4833,11822760,875,13508
1733,9,2,25,0,65199720,4833,11823780,874,13517
1734,6,1,25,0,65243580,4834,11832000,875,13523
1735,10,3,25,0,65283480,4834,11837520,874,13533
1736,7,3,25,0,65319480,4834,11847060,875,13540
1737,9,2,25,0,65385180,4836,11860800,875,13549
1738,9,8,25,0,65401200,4836,11864940,875,13558
1739,11,13,22,3,65456640,4837,11871600,875,13569
1740,11,17,25,0,65496120,4838,11888460,875,13580
1741,11,22,25,0,65534220,4839,11895600,875,13591
1742,9,22,25,0,65587860,4840,11928780,877,13600
1743,3,16,25,0,65632260,4840,11991720,881,13603
1744,12,19,25,0,65673420,4839,12013320,882,13615
1745,23,34,25,0,65714220,4840,12022320,881,13638
1746,8,37,25,0,65744700,4840,12029340,881,13646
1747,9,32,25,0,65813280,4841,12075060,884,13655
1748,4,32,25,0,65838180,4841,12092220,885,13659
1749,3,25,25,0,65889540,4841,12200760,893,13662
1750,7,21,25,0,65930340,4841,12333000,902,13669
1751,8,18,25,0,65980560,4840,12429120,909,13677
1752,0,8,25,0,66022980,4840,12765720,933,13677
1753,5,0,19,6,66061740,4836,13049040,954,13682
1754,11,2,25,0,66079680,4836,13049580,953,13693
1755,4,0,23,2,66115200,4836,13054980,953,13697
1756,6,0,20,5,66163680,4836,13054980,952,13703
1757,4,0,18,7,66193080,4836,13054980,952,13707
1758,6,0,21,4,66207600,4836,13054980,952,13713
1759,6,0,21,4,66231180,4836,13054980,951,13719
1760,5,0,18,7,66265380,4836,13054980,951,13724
1761,8,0,23,2,66280380,4836,13054980,950,13732
1762,9,0,25,0,66313740,4836,13060860,950,13741
1763,12,3,25,0,66358500,4836,13064340,950,13753
1764,14,11,25,0,66392700,4836,13070460,949,13767
1765,14,17,25,0,66437340,4837,13079040,949,13781
1766,12,20,25,0,66483180,4837,13095300,949,13793
1767,9,18,25,0,66536580,4837,13107660,950,13802
1768,8,16,25,0,66583800,4837,13140900,951,13810
1769,10,19,25,0,66615120,4836,13163700,953,13820
1770,4,13,25,0,66665760,4837,13228320,957,13824
1771,8,11,25,0,66710580,4836,13282380,960,13832
1772,7,11,25,0,66736920,4836,13365900,966,13839
1773,7,7,25,0,66789840,4836,13485600,974,13846
1774,8,0,25,0,66837780,4834,13558980,978,13854
1775,10,1,25,0,66880200,4834,13566960,978,13864
1776,5,0,25,0,66914520,4834,13574160,979,13869
1777,10,3,25,0,66954060,4835,13575540,978,13879
1778,6,0,25,0,67008060,4836,13584780,978,13885
1779,2,0,20,5,67048980,4836,13584780,978,13887
1780,6,0,19,6,67093860,4837,13584780,978,13893
1781,8,0,22,3,67111920,4836,13584780,977,13901
1782,7,0,22,3,67143000,4836,13584780,977,13908
1783,5,0,22,3,67173240,4837,13584780,976,13913
1784,10,0,25,0,67208760,4837,13584780,975,13923
1785,8,0,23,2,67259580,4837,13589820,975,13931
1786,7,0,23,2,67288140,4837,13590420,975,13938
1787,13,2,25,0,67336080,4837,13590480,974,13951
1788,7,1,25,0,67366380,4836,13598640,974,13958
1789,12,5,25,0,67410240,4837,13601700,973,13970
1790,7,3,25,0,67461420,4837,13617480,974,13977
1791,16,14,25,0,67490520,4838,13621500,973,13993
1792,3,9,25,0,67542900,4839,13647120,975,13996
1793,12,11,25,0,67589040,4838,13672740,976,14008
1794,15,18,25,0,67624740,4838,13680480,975,14023
1795,7,16,25,0,67670400,4838,13697220,976,14030
1796,11,17,25,0,67725720,4839,13725420,977,14041
1797,6,12,25,0,67773240,4838,13762680,980,14047
1798,6,7,25,0,67811280,4837,13855740,986,14053
1799,6,0,18,7,67857360,4834,14015100,997,14059
1800,0,0,14,11,67875600,4834,14015100,997,14059
1801,2,0,15,10,67881000,4834,14015100,997,14061
1802,5,0,19,6,67884360,4834,14015100,996,14066
1803,5,0,21,4,67896120,4833,14015100,996,14071
1804,2,0,18,7,67922760,4834,14015100,996,14073
1805,6,0,21,4,67941720,4834,14015100,995,14079
1806,7,0,22,3,67967580,4834,14015100,995,14086
1807,6,0,23,2,67992360,4834,14015100,994,14092
1808,10,2,25,0,68025780,4834,14018940,994,14102
1809,12,5,25,0,68071500,4834,14024940,994,14114
1810,7,5,25,0,68101860,4834,14036640,994,14121
1811,7,0,24,1,68159040,4833,14054640,995,14128
1812,9,2,25,0,68181000,4833,14054640,994,14137
1813,8,0,24,1,68239320,4833,14058780,994,14145
1814,12,5,25,0,68267280,4833,14058780,993,14157
1815,13,8,25,0,68322300,4834,14066880,993,14170
1816,10,12,25,0,68352240,4834,14078580,993,14180
1817,8,15,25,0,68386980,4835,14085780,993,14188
1818,1,6,25,0,68442660,4835,14145600,997,14189
1819,6,0,22,3,68500200,4834,14211360,1001,14195
1820,9,0,24,1,68525940,4833,14211360,1000,14204
1821,4,0,24,1,68545380,4833,14212320,1000,14208
1822,7,0,21,4,68602320,4834,14212680,1000,14215
1823,3,0,20,5,68623080,4834,14212680,999,14218
1824,2,0,17,8,68651760,4834,14212680,999,14220
1825,4,0,17,8,68671740,4835,14212680,999,14224
1826,6,0,21,4,68679600,4834,14212680,999,14230
1827,3,0,19,6,68701500,4834,14212680,998,14233
1828,5,0,19,6,68728020,4834,14212680,998,14238
1829,5,0,20,5,68748300,4834,14212680,998,14243
1830,11,2,25,0,68769600,4835,14212980,997,14254
1831,5,0,21,4,68822220,4835,14217540,997,14259
1832,12,0,25,0,68853120,4834,14218920,996,14271
1833,14,7,25,0,68889480,4834,14223660,996,14285
1834,8,6,25,0,68934840,4834,14231340,995,14293
1835,12,13,25,0,68962920,4835,14237340,995,14305
1836,5,8,25,0,69024360,4836,14271540,997,14310
1837,10,7,25,0,69076200,4835,14298720,998,14320
1838,11,13,25,0,69095760,4835,14305920,998,14331
1839,13,18,25,0,69145320,4836,14314920,998,14344
1840,15,24,25,0,69196680,4836,14323020,997,14359
1841,8,26,25,0,69224400,4836,14338020,998,14367
1842,9,27,25,0,69277560,4837,14371320,1000,14376
1843,8,27,25,0,69323160,4838,14395620,1001,14384
1844,2,20,25,0,69371520,4838,14505540,1008,14386
1845,5,13,25,0,69421020,4838,14647020,1018,14391
1846,12,14,25,0,69451920,4836,14725800,1022,14403
1847,9,14,25,0,69492960,4836,14736600,1023,14412
1848,9,15,25,0,69532740,4836,14761560,1023,14421
1849,4,9,25,0,69581520,4836,14782560,1025,14425
1850,7,0,23,2,69629760,4833,15145200,1049,14432
1851,5,0,20,5,69666840,4833,15145200,1049,14437
1852,4,0,19,6,69693300,4833,15145200,1049,14441
1853,5,0,19,6,69721200,4834,15145200,1048,14446
1854,7,0,21,4,69739260,4833,15145200,1048,14453
1855,10,0,24,1,69777840,4833,15145200,1047,14463
1856,10,4,25,0,69792900,4833,15147600,1047,14473
1857,14,10,25,0,69834960,4833,15153780,1046,14487
1858,9,10,25,0,69888600,4834,15163500,1046,14496
1859,16,20,25,0,69924000,4834,15173040,1045,14512
1860,12,25,25,0,69967560,4835,15183600,1045,14524
1861,5,24,25,0,70004400,4835,15207780,1047,14529
1862,12,26,25,0,70063320,4836,15237240,1048,14541
1863,10,30,25,0,70090260,4836,15249540,1048,14551
1864,15,35,25,0,70146540,4837,15309540,1051,14566
1865,7,35,25,0,70184160,4837,15327900,1052,14573
1866,10,36,25,0,70234500,4837,15365460,1054,14583
1867,11,37,25,0,70279200,4837,15375360,1054,14594
1868,2,32,25,0,70313760,4837,15504480,1062,14596
1869,5,24,25,0,70379280,4838,15744660,1078,14601
1870,2,13,25,0,70425000,4836,16114680,1103,14603
1871,8,0,25,0,70471740,4833,16433520,1125,14611
1872,4,0,20,5,70491360,4831,16433520,1124,14615
1873,8,0,22,3,70523400,4831,16433520,1124,14623
1874,6,0,20,5,70559280,4831,16433520,1123,14629
1875,5,0,20,5,70580220,4831,16433520,1123,14634
1876,5,0,20,5,70608660,4831,16433520,1122,14639
1877,4,0,17,8,70642200,4831,16433520,1122,14643
1878,4,0,19,6,70652100,4831,16433520,1122,14647
1879,10,1,25,0,70667700,4831,16435440,1121,14657
1880,13,6,25,0,70712760,4832,16439700,1121,14670
1881,12,12,25,0,70752360,4832,16447680,1120,14682
1882,11,16,25,0,70796040,4833,16459740,1120,14693
1883,7,15,25,0,70840680,4833,16495500,1122,14700
1884,20,27,25,0,70881300,4834,16506240,1121,14720
1885,8,27,25,0,70927740,4834,16525740,1122,14728
1886,9,30,25,0,70957080,4834,16542180,1122,14737
1887,10,34,25,0,71000520,4835,16548240,1122,14747
1888,7,32,25,0,71051940,4836,16566180,1123,14754
1889,10,33,25,0,71107740,4836,16597260,1124,14764
1890,8,34,25,0,71145660,4837,16630500,1126,14772
1891,10,35,25,0,71191920,4837,16645860,1126,14782
1892,7,33,25,0,71234040,4837,16708020,1130,14789
1893,2,25,25,0,71284320,4837,16829040,1138,14791
1894,5,17,25,0,71329620,4836,17151240,1159,14796
1895,2,2,25,0,71381280,4834,17679900,1195,14798
1896,8,0,21,4,71411940,4831,17776740,1201,14806
1897,7,0,20,5,71441100,4831,17776740,1200,14813
1898,4,0,19,6,71463600,4830,17776740,1200,14817
1899,6,0,23,2,71471280,4830,17776740,1199,14823
1900,7,0,22,3,71512320,4830,17776740,1199,14830
1901,6,0,20,5,71548140,4830,17776740,1198,14836
1902,12,3,25,0,71567700,4830,17777100,1197,14848
1903,7,1,25,0,71606340,4830,17783580,1197,14855
1904,17,10,25,0,71652840,4830,17788500,1196,14872
1905,12,13,25,0,71703360,4831,17799600,1196,14884
1906,10,16,25,0,71746980,4832,17808060,1196,14894
1907,10,21,25,0,71770020,4832,17815380,1195,14904
1908,12,22,25,0,71836440,4832,17864820,1198,14916
1909,13,28,25,0,71871720,4833,17889480,1198,14929
1910,14,37,25,0,71902260,4833,17922240,1199,14943
1911,16,40,25,0,71959020,4834,17957160,1201,14959
1912,14,35,25,0,72014520,4834,18002220,1203,14973
1913,8,38,25,0,72035880,4834,18005700,1203,14981
1914,11,39,25,0,72089040,4834,18025680,1203,14992
1915,8,38,25,0,72124680,4834,18033420,1203,15000
1916,4,35,25,0,72170220,4835,18140940,1210,15004
1917,3,24,25,0,72226260,4834,18409380,1228,15007
1918,7,15,25,0,72275220,4832,18727200,1248,15014
1919,6,12,25,0,72305880,4831,18866400,1257,15020
1920,9,15,25,0,72336960,4831,18871980,1257,15029
1921,6,13,25,0,72388680,4832,18878940,1257,15035
1922,8,12,25,0,72433080,4832,18989760,1263,15043
1923,9,7,25,0,72487200,4831,19157820,1274,15052
1924,9,6,25,0,72516360,4830,19350420,1286,15061
1925,10,7,25,0,72565740,4830,19357020,1285,15071
1926,6,9,25,0,72587640,4831,19364340,1286,15077
1927,7,5,25,0,72656940,4832,19456020,1291,15084
1928,7,0,24,1,72697320,4830,19596240,1300,15091
1929,12,5,25,0,72730380,4830,19598040,1299,15103
1930,7,5,25,0,72766860,4831,19603560,1298,15110
1931,9,1,25,0,72823380,4830,19625520,1299,15119
1932,15,8,25,0,72863280,4830,19633140,1299,15134
1933,10,11,25,0,72895320,4830,19639500,1298,15144
1934,13,16,25,0,72939540,4831,19644420,1297,15157
1935,10,19,25,0,72985200,4831,19653660,1297,15167
1936,10,20,25,0,73037880,4832,19684380,1298,15177
1937,6,21,25,0,73065900,4832,19701360,1299,15183
1938,11,23,25,0,73116660,4833,19737360,1300,15194
1939,8,23,25,0,73159440,4833,19774560,1302,15202
1940,14,28,25,0,73211700,4834,19779660,1301,15216
1941,6,26,25,0,73251780,4834,19795740,1302,15222
1942,6,19,25,0,73305180,4833,19944000,1311,15228
1943,9,15,25,0,73347540,4832,20048160,1317,15237
1944,2,11,25,0,73374600,4832,20131260,1322,15239
1945,4,0,19,6,73443180,4829,20491980,1345,15243
1946,7,0,20,5,73464780,4829,20491980,1345,15250
1947,5,0,23,2,73470720,4829,20491980,1344,15255
1948,5,0,19,6,73515360,4829,20491980,1344,15260
1949,6,0,20,5,73543320,4829,20491980,1343,15266
1950,3,0,20,5,73557900,4829,20491980,1343,15269
1951,9,0,25,0,73582980,4829,20491980,1342,15278
1952,9,2,25,0,73612620,4829,20496120,1342,15287
1953,9,0,23,2,73663980,4828,20497560,1341,15296
1954,12,4,25,0,73692600,4828,20498100,1340,15308
1955,10,5,25,0,73730280,4828,20505840,1340,15318
1956,11,7,25,0,73772520,4828,20515860,1340,15329
1957,18,16,25,0,73826820,4829,20526420,1339,15347
1958,9,19,25,0,73859460,4829,20540160,1339,15356
1959,9,19,25,0,73908120,4829,20555820,1339,15365
1960,9,22,25,0,73946760,4830,20578320,1340,15374
1961,11,26,25,0,73988940,4830,20599020,1340,15385
1962,9,26,25,0,74035920,4831,20607060,1340,15394
1963,4,23,25,0,74077440,4831,20647560,1342,15398
1964,8,19,25,0,74131620,4831,20757720,1348,15406
1965,7,17,25,0,74171460,4831,20807520,1351,15413
1966,5,13,25,0,74213400,4830,20919000,1358,15418
1967,4,4,25,0,74261460,4830,21171120,1374,15422
1968,6,0,19,6,74307720,4827,21289680,1381,15428
1969,4,0,19,6,74326440,4827,21289680,1381,15432
1970,9,0,22,3,74352720,4827,21289680,1380,15441
1971,10,1,25,0,74378640,4827,21292200,1379,15451
1972,5,0,21,4,74424000,4827,21292620,1379,15456
1973,3,0,17,8,74461500,4827,21292620,1378,15459
1974,9,0,24,1,74471280,4827,21292620,1378,15468
1975,5,0,24,1,74495880,4827,21292620,1377,15473
1976,9,0,25,0,74532840,4827,21292620,1376,15482
1977,9,4,25,0,74564460,4828,21295260,1376,15491
1978,5,0,25,0,74625360,4829,21306420,1376,15496
1979,8,0,22,3,74669340,4828,21306480,1375,15504
1980,4,0,20,5,74701680,4828,21306480,1375,15508
1981,5,0,19,6,74729700,4828,21306480,1375,15513
1982,10,0,23,2,74750580,4828,21306600,1374,15523
1983,9,2,25,0,74775960,4828,21306720,1373,15532
1984,11,6,25,0,74812620,4828,21308940,1372,15543
1985,8,4,25,0,74868600,4828,21318240,1372,15551
1986,8,7,25,0,74891280,4828,21325200,1372,15559
1987,7,4,25,0,74951820,4829,21360660,1373,15566
1988,13,7,25,0,74995500,4829,21369240,1373,15579
1989,4,4,25,0,75033000,4829,21387120,1374,15583
1990,7,3,25,0,75071580,4829,21408540,1374,15590
1991,2,0,21,4,75119640,4829,21419640,1375,15592
1992,4,0,16,9,75165540,4830,21419640,1374,15596
1993,7,0,21,4,75175320,4830,21419640,1374,15603
1994,4,0,19,6,75202800,4829,21419640,1374,15607
1995,6,0,21,4,75216600,4829,21419640,1373,15613
1996,4,0,17,8,75260940,4829,21419640,1373,15617
1997,5,0,19,6,75273600,4829,21419640,1372,15622
1998,9,0,24,1,75287700,4829,21419640,1371,15631
1999,8,0,24,1,75322980,4829,21419640,1371,15639
2000,4,0,23,2,75352380,4829,21419640,1370,15643
2001,13,3,25,0,75398280,4830,21419820,1369,15656
2002,6,0,25,0,75438240,4829,21428040,1369,15662
2003,5,0,22,3,75472680,4829,21428040,1369,15667
2004,15,4,25,0,75512760,4829,21430080,1368,15682
2005,9,7,25,0,75545040,4829,21437580,1367,15691
2006,7,6,25,0,75591180,4830,21452760,1368,15698
2007,5,1,25,0,75643080,4830,21485280,1369,15703
2008,14,4,25,0,75692940,4830,21502920,1369,15717
2009,8,6,25,0,75722340,4830,21507360,1369,15725
2010,7,6,25,0,75768000,4831,21520320,1369,15732
2011,7,4,25,0,75820080,4831,21547260,1370,15739
2012,4,1,25,0,75855420,4831,21569100,1371,15743
2013,4,0,17,8,75908940,4831,21579000,1371,15747
2014,5,0,19,6,75923100,4831,21579000,1371,15752
2015,5,0,17,8,75950640,4830,21579000,1371,15757
2016,4,0,18,7,75967380,4830,21579000,1370,15761
2017,6,0,23,2,75970860,4830,21579000,1370,15767
2018,8,1,25,0,75987180,4830,21579000,1369,15775
2019,4,0,25,0,76012380,4830,21581100,1369,15779
2020,5,0,24,1,76043700,4830,21582780,1368,15784
2021,2,0,22,3,76064340,4830,21582780,1368,15786
2022,9,1,25,0,76088220,4830,21583260,1368,15795
2023,6,4,25,0,76104780,4830,21587580,1368,15801
2024,19,16,25,0,76146000,4831,21595200,1366,15820
2025,11,23,25,0,76166760,4831,21604920,1366,15831
2026,8,25,25,0,76198980,4831,21622680,1366,15839
2027,8,27,25,0,76233120,4831,21656220,1368,15847
2028,11,34,25,0,76253640,4831,21660480,1367,15858
2029,12,40,25,0,76289820,4832,21669780,1367,15870
2030,11,39,25,0,76310040,4832,21684660,1367,15881
2031,9,40,25,0,76329120,4832,21697320,1368,15890
2032,12,39,25,0,76376040,4833,21755820,1371,15902
2033,12,40,25,0,76398600,4833,21788820,1373,15914
2034,9,37,25,0,76434780,4834,21837480,1375,15923
2035,7,38,25,0,76464060,4834,21953580,1382,15930
2036,5,38,25,0,76486860,4834,21962520,1382,15935
2037,9,39,25,0,76516560,4834,22000980,1384,15944
2038,9,40,25,0,76536840,4834,22090200,1390,15953
2039,7,38,25,0,76578180,4835,22192080,1395,15960
2040,5,36,25,0,76606800,4835,22261200,1399,15965
2041,3,34,25,0,76632000,4835,22339140,1404,15968
2042,3,31,25,0,76659780,4835,22516680,1415,15971
2043,8,30,25,0,76692060,4834,22600380,1419,15979
2044,9,33,25,0,76717560,4834,22657380,1422,15988
2045,8,36,25,0,76747980,4834,22665120,1422,15996
2046,4,32,25,0,76787880,4834,22758060,1427,16000
2047,9,36,25,0,76804380,4834,22760700,1427,16009
2048,3,33,25,0,76838280,4834,22792680,1429,16012
2049,11,39,25,0,76858080,4834,22797420,1428,16023
2050,12,38,25,0,76885260,4834,22814400,1428,16035
2051,12,40,25,0,76903020,4834,22821720,1429,16047
2052,8,40,25,0,76941660,4835,22848900,1430,16055
2053,10,39,25,0,76975860,4836,22867980,1431,16065
2054,9,40,25,0,77001060,4836,22876560,1431,16074
2055,7,40,25,0,77026620,4836,23046300,1441,16081
2056,10,39,25,0,77056920,4836,23054640,1441,16091
2057,8,39,25,0,77090640,4836,23300340,1455,16099
2058,15,40,25,0,77122440,4836,23310360,1455,16114
2059,7,37,25,0,77155680,4836,23328360,1456,16121
2060,9,39,25,0,77176620,4836,23370840,1458,16130
2061,5,39,25,0,77206860,4836,23381220,1459,16135
2062,5,38,25,0,77227080,4836,23407560,1460,16140
2063,9,40,25,0,77263860,4836,23429820,1461,16149
2064,6,37,25,0,77297700,4836,23687580,1476,16155
2065,7,36,25,0,77329800,4835,23836500,1484,16162
2066,5,35,25,0,77351160,4835,23989200,1494,16167
2067,6,32,25,0,77393160,4835,24392640,1518,16173
2068,3,30,25,0,77406480,4834,24779880,1542,16176
2069,5,27,25,0,77437980,4834,24996060,1555,16181
2070,5,30,25,0,77442660,4833,24997740,1555,16186
2071,7,32,25,0,77487540,4835,25001700,1554,16193
2072,8,36,25,0,77511840,4835,25008960,1554,16201
2073,16,40,25,0,77551560,4836,25024140,1554,16217
2074,9,40,25,0,77570640,4836,25032780,1554,16226
2075,12,40,25,0,77602140,4836,25048140,1555,16238
2076,13,40,25,0,77629980,4837,25077180,1556,16251
2077,10,40,25,0,77664180,4837,25091100,1556,16261
2078,5,37,25,0,77702340,4837,25143240,1559,16266
2079,8,38,25,0,77718360,4837,25155720,1559,16274
2080,7,34,25,0,77767860,4837,25193940,1561,16281
2081,7,36,25,0,77786580,4836,25201860,1561,16288
2082,7,38,25,0,77809800,4836,25238760,1562,16295
2083,10,38,25,0,77842020,4837,25255800,1563,16305
2084,8,40,25,0,77854380,4837,25261140,1563,16313
2085,10,40,25,0,77901720,4838,25277280,1563,16323
2086,6,39,25,0,77924100,4838,25328760,1566,16329
2087,3,36,25,0,77954220,4838,25364460,1568,16332
2088,2,29,25,0,77996160,4838,26316780,1627,16334
2089,4,20,25,0,78027360,4836,27826620,1720,16338
2090,5,17,25,0,78043320,4834,27945600,1726,16343
2091,4,14,25,0,78077340,4834,28274520,1746,16347
2092,13,22,25,0,78090600,4834,28275660,1745,16360
2093,3,19,25,0,78130680,4834,28289340,1745,16363
2094,8,21,25,0,78154560,4834,28302720,1746,16371
2095,8,22,25,0,78188700,4834,28314240,1745,16379
2096,8,26,25,0,78204660,4834,28318200,1745,16387
2097,8,30,25,0,78231060,4834,28333620,1745,16395
2098,15,38,25,0,78269700,4835,28339560,1743,16410
2099,7,39,25,0,78298500,4835,28350720,1744,16417
2100,12,37,25,0,78333780,4836,28364580,1744,16429
2101,7,40,25,0,78352800,4836,28382700,1745,16436
2102,10,40,25,0,78383040,4836,28410960,1746,16446
2103,10,40,25,0,78418440,4837,28422000,1746,16456
2104,14,40,25,0,78448500,4837,28429320,1746,16470
2105,7,40,25,0,78469140,4837,28462980,1747,16477
2106,7,38,25,0,78506460,4837,28621860,1756,16484
2107,8,40,25,0,78537660,4837,28656300,1758,16492
2108,5,39,25,0,78563760,4837,28701000,1760,16497
2109,11,40,25,0,78587940,4837,28705620,1760,16508
2110,10,39,25,0,78618900,4837,28732620,1761,16518
2111,4,36,25,0,78656940,4837,28818300,1765,16522
2112,7,36,25,0,78683460,4837,28856760,1767,16529
2113,6,36,25,0,78711060,4837,28867800,1767,16535
2114,4,36,25,0,78730500,4837,28913280,1769,16539
2115,8,37,25,0,78765180,4837,28943640,1770,16547
2116,5,39,25,0,78783480,4837,28950180,1770,16552
2117,10,40,25,0,78813240,4837,29030400,1775,16562
2118,5,34,25,0,78856620,4837,29142540,1781,16567
2119,4,30,25,0,78883680,4836,29563620,1806,16571
2120,9,30,25,0,78908160,4835,29711100,1814,16580
2121,10,35,25,0,78930300,4835,29717400,1814,16590
2122,14,40,25,0,78961680,4835,29725980,1813,16604
2123,9,40,25,0,78975060,4835,29736480,1813,16613
2124,9,39,25,0,79022580,4835,29767980,1814,16622
2125,9,40,25,0,79046400,4836,29775540,1814,16631
2126,17,40,25,0,79069020,4836,29790840,1815,16648
2127,12,38,25,0,79115400,4837,29805300,1815,16660
2128,14,40,25,0,79136160,4837,29835600,1816,16674
2129,5,36,25,0,79164660,4836,29895840,1819,16679
2130,4,33,25,0,79193460,4836,29951580,1822,16683
2131,7,30,25,0,79223400,4835,30129480,1832,16690
2132,7,31,25,0,79247160,4835,30134820,1832,16697
2133,9,35,25,0,79279320,4835,30142920,1832,16706
2134,6,34,25,0,79315920,4835,30152520,1831,16712
2135,7,37,25,0,79335600,4835,30161280,1831,16719
2136,9,40,25,0,79356240,4835,30168540,1831,16728
2137,5,38,25,0,79392960,4836,30179400,1831,16733
2138,5,35,25,0,79429620,4836,30212820,1832,16738
2139,6,36,25,0,79455780,4836,30218700,1832,16744
2140,6,35,25,0,79489200,4836,30261720,1834,16750
2141,6,35,25,0,79514880,4836,30410160,1843,16756
2142,4,30,25,0,79546380,4835,30661020,1857,16760
2143,3,28,25,0,79566480,4835,31092780,1883,16763
2144,11,31,25,0,79600200,4834,31097160,1882,16774
2145,4,32,25,0,79617240,4834,31103520,1882,16778
2146,7,33,25,0,79653240,4835,31110360,1881,16785
2147,11,40,25,0,79674780,4835,31119300,1881,16796
2148,11,40,25,0,79705380,4836,31138920,1882,16807
2149,13,36,25,0,79750200,4836,31177080,1883,16820
2150,10,40,25,0,79763220,4836,31186080,1883,16830
2151,6,40,25,0,79791960,4837,31198260,1884,16836
2152,18,40,25,0,79820160,4837,31211580,1884,16854
2153,7,40,25,0,79846980,4837,31223220,1884,16861
2154,10,38,25,0,79894740,4838,31234800,1884,16871
2155,7,40,25,0,79901520,4838,31237560,1884,16878
2156,6,37,25,0,79947120,4838,31327380,1889,16884
2157,4,33,25,0,79979640,4838,31772340,1915,16888
2158,6,29,25,0,80001480,4836,32923320,1984,16894
2159,4,24,25,0,80029260,4835,34618980,2085,16898
2160,5,18,25,0,80053980,4834,36108600,2174,16903
2161,5,12,25,0,80092860,4833,36501600,2197,16908
2162,3,0,25,0,80123700,4830,38993100,2347,16911
2163,8,0,25,0,80143020,4829,38993100,2346,16919
2164,9,5,25,0,80159100,4829,38998980,2345,16928
2165,9,10,25,0,80186160,4829,39004140,2345,16937
2166,3,9,25,0,80209500,4830,39012180,2344,16940
2167,8,12,25,0,80243340,4830,39022260,2343,16948
2168,8,14,25,0,80281860,4831,39026160,2343,16956
2169,10,20,25,0,80303880,4831,39033600,2342,16966
2170,8,22,25,0,80335440,4831,39044820,2342,16974
2171,12,27,25,0,80369820,4831,39053700,2340,16986
2172,14,38,25,0,80383260,4831,39058740,2339,17000
2173,10,39,25,0,80419260,4832,39067680,2338,17010
2174,14,40,25,0,80427360,4832,39072180,2338,17024
2175,7,38,25,0,80480040,4833,39104280,2339,17031
2176,8,37,25,0,80516220,4833,39119580,2339,17039
2177,18,40,25,0,80534040,4833,39155520,2341,17057
2178,4,36,25,0,80571780,4834,39195780,2343,17061
2179,9,40,25,0,80590980,4834,39208800,2342,17070
2180,8,39,25,0,80629080,4834,39293220,2346,17078
2181,2,35,25,0,80656080,4834,39376980,2351,17080
2182,5,37,25,0,80671500,4834,39418140,2353,17085
2183,7,39,25,0,80705820,4835,39430320,2353,17092
2184,4,36,25,0,80742780,4835,39582420,2362,17096
2185,3,35,25,0,80764020,4835,39681960,2367,17099
2186,2,27,25,0,80797980,4834,39969060,2384,17101
2187,5,23,25,0,80832720,4834,40238580,2399,17106
2188,8,25,25,0,80854860,4833,40326720,2404,17114
2189,6,24,25,0,80881440,4833,40384500,2406,17120
2190,6,24,25,0,80911680,4833,40401420,2406,17126
2191,7,27,25,0,80931300,4833,40407300,2405,17133
2192,5,28,25,0,80958960,4833,40415760,2405,17138
2193,4,25,25,0,81003360,4834,40644360,2419,17142
2194,9,29,25,0,81018960,4834,40648560,2417,17151
2195,11,34,25,0,81058260,4834,40661040,2417,17162
2196,12,40,25,0,81071700,4834,40673400,2416,17174
2197,7,39,25,0,81113280,4835,40697520,2417,17181
2198,10,39,25,0,81129180,4835,40710480,2417,17191
2199,14,40,25,0,81166920,4836,40731360,2418,17205
2200,6,35,25,0,81208800,4836,40805460,2421,17211
2201,7,37,25,0,81231480,4836,40861560,2424,17218
2202,6,38,25,0,81259620,4836,40903560,2425,17224
2203,5,35,25,0,81292200,4836,40943580,2427,17229
2204,10,40,25,0,81307860,4836,40945740,2426,17239
2205,7,38,25,0,81348000,4836,41078400,2433,17246
2206,3,38,25,0,81362760,4836,41084940,2433,17249
2207,5,36,25,0,81402120,4836,41166540,2437,17254
2208,6,34,25,0,81438360,4836,41189820,2437,17260
2209,6,34,25,0,81459000,4836,41217540,2438,17266
2210,5,32,25,0,81488940,4835,41330100,2444,17271
2211,5,31,25,0,81519300,4835,41456520,2451,17276
2212,8,32,25,0,81544560,4835,41460060,2450,17284
2213,3,29,25,0,81576360,4835,41632200,2459,17287
2214,4,27,25,0,81610320,4835,41758200,2466,17291
2215,5,27,25,0,81629700,4835,41996280,2480,17296
2216,5,21,25,0,81669480,4834,42764760,2524,17301
2217,8,21,25,0,81694020,4833,42960540,2535,17309
2218,7,20,25,0,81722460,4833,43347600,2556,17316
2219,17,31,25,0,81748740,4833,43351740,2555,17333
2220,10,37,25,0,81766800,4833,43357800,2553,17343
2221,10,38,25,0,81806160,4833,43372500,2553,17353
2222,12,40,25,0,81824040,4833,43378860,2553,17365
2223,10,39,25,0,81858060,4834,43401240,2553,17375
2224,5,36,25,0,81892020,4834,43430460,2554,17380
2225,12,40,25,0,81909840,4835,43469640,2556,17392
2226,9,40,25,0,81941400,4835,43501800,2557,17401
2227,4,37,25,0,81972480,4835,43556460,2560,17405
2228,8,39,25,0,82008600,4835,43592640,2561,17413
2229,8,40,25,0,82022160,4835,43595820,2560,17421
2230,7,36,25,0,82067520,4836,43647660,2562,17428
2231,5,32,25,0,82102080,4835,43749060,2568,17433
2232,5,33,25,0,82119840,4835,43752720,2567,17438
2233,4,33,25,0,82144560,4835,43838700,2572,17442
2234,4,28,25,0,82182420,4835,44127660,2588,17446
2235,4,27,25,0,82201980,4835,44184180,2591,17450
2236,8,29,25,0,82236300,4835,44329080,2598,17458
2237,7,29,25,0,82269600,4835,44400540,2601,17465
2238,6,30,25,0,82291860,4835,44404980,2600,17471
2239,3,27,25,0,82319460,4835,44424240,2601,17474
2240,7,25,25,0,82360680,4835,44684820,2615,17481
2241,10,31,25,0,82372740,4834,44688480,2614,17491
2242,6,29,25,0,82414320,4834,44698920,2613,17497
2243,6,30,25,0,82440900,4834,44706540,2613,17503
2244,8,34,25,0,82466160,4835,44713680,2612,17511
2245,12,39,25,0,82494720,4835,44718060,2611,17523
2246,11,40,25,0,82507140,4835,44724660,2611,17534
2247,12,39,25,0,82549800,4836,44751540,2612,17546
2248,13,37,25,0,82593840,4836,44793540,2613,17559
2249,7,36,25,0,82611120,4835,44839260,2615,17566
2250,7,36,25,0,82641600,4835,44859720,2615,17573
2251,13,40,25,0,82661520,4834,44864940,2614,17586
2252,3,39,25,0,82685940,4835,44881440,2615,17589
2253,6,37,25,0,82729980,4835,44898240,2614,17595
2254,5,36,25,0,82755360,4835,44902800,2614,17600
2255,7,37,25,0,82791180,4835,44919480,2614,17607
2256,5,40,25,0,82794000,4835,44922060,2614,17612
2257,5,39,25,0,82837860,4836,44968500,2615,17617
2258,10,39,25,0,82872360,4836,44976600,2615,17627
2259,5,40,25,0,82888740,4836,44995800,2615,17632
2260,5,37,25,0,82924260,4836,45052740,2618,17637
2261,2,31,25,0,82957440,4836,45745140,2658,17639
2262,2,14,25,0,82996740,4833,48198060,2800,17641
2263,6,0,23,2,83026260,4829,50500140,2933,17647
2264,8,6,25,0,83026260,4829,50500140,2932,17655
2265,9,8,25,0,83069100,4829,50512680,2931,17664
2266,9,12,25,0,83096280,4829,50528100,2930,17673
2267,11,20,25,0,83113020,4829,50530140,2928,17684
2268,12,25,25,0,83153760,4830,50540820,2927,17696
2269,14,36,25,0,83169300,4830,50545620,2925,17710
2270,8,39,25,0,83207760,4831,50563860,2925,17718
2271,6,37,25,0,83248200,4831,50590440,2925,17724
2272,3,34,25,0,83275680,4831,50620500,2926,17727
2273,10,37,25,0,83303100,4831,50666880,2928,17737
2274,10,39,25,0,83323380,4831,50682060,2928,17747
2275,7,40,25,0,83356920,4832,50702880,2928,17754
2276,8,39,25,0,83382180,4832,50741760,2929,17762
2277,13,40,25,0,83403660,4832,50757540,2929,17775
2278,8,38,25,0,83446200,4832,50809800,2931,17783
2279,5,37,25,0,83472360,4832,50823240,2931,17788
2280,4,39,25,0,83486880,4833,50901960,2936,17792
2281,3,36,25,0,83525280,4833,50995620,2940,17795
2282,7,38,25,0,83554200,4833,51092160,2945,17802
2283,8,40,25,0,83579580,4833,51100260,2944,17810
2284,5,39,25,0,83608080,4834,51108300,2944,17815
2285,7,40,25,0,83643420,4834,51115440,2943,17822
2286,12,39,25,0,83673960,4834,51122760,2942,17834
2287,10,38,25,0,83696760,4834,51143460,2943,17844
2288,10,40,25,0,83724780,4835,51149220,2943,17854
2289,12,40,25,0,83754780,4834,51154680,2942,17866
2290,12,40,25,0,83784360,4835,51159120,2941,17878
2291,13,40,25,0,83811720,4835,51207900,2943,17891
2292,16,39,25,0,83842440,4834,51258900,2945,17907
2293,9,39,25,0,83874180,4835,51314760,2947,17916
2294,13,40,25,0,83887380,4835,51398700,2951,17929
2295,17,40,25,0,83927340,4835,51584580,2961,17946
2296,4,33,25,0,83966040,4835,51916560,2979,17950
2297,5,30,25,0,83996460,4834,52292220,3000,17955
2298,11,37,25,0,84007740,4834,52296180,2998,17966
2299,5,36,25,0,84048540,4834,52317540,2998,17971
2300,6,39,25,0,84062520,4834,52322940,2999,17977
2301,9,39,25,0,84106140,4835,52339260,2997,17986
2302,11,39,25,0,84126360,4835,52482480,3005,17997
2303,2,32,25,0,84164640,4834,52745100,3020,17999
2304,8,29,25,0,84202620,4833,53073780,3037,18007
2305,7,29,25,0,84227580,4833,53203800,3043,18014
2306,7,32,25,0,84246780,4833,53206680,3042,18021
2307,8,35,25,0,84273960,4833,53214420,3041,18029
2308,6,37,25,0,84295080,4833,53226000,3042,18035
2309,8,37,25,0,84332820,4834,53235840,3041,18043
2310,6,39,25,0,84359340,4834,53246220,3040,18049
2311,10,38,25,0,84392640,4834,53257020,3040,18059
2312,16,40,25,0,84421920,4835,53266560,3039,18075
2313,9,39,25,0,84454980,4835,53278740,3039,18084
2314,8,39,25,0,84474180,4835,53290860,3039,18092
2315,13,39,25,0,84510720,4835,53303400,3038,18105
2316,16,39,25,0,84535440,4835,53312400,3038,18121
2317,7,40,25,0,84562440,4835,53375640,3041,18128
2318,11,40,25,0,84594720,4835,53382540,3040,18139
2319,13,40,25,0,84620280,4835,53390400,3039,18152
2320,13,40,25,0,84642960,4835,53396040,3039,18165
2321,4,39,25,0,84669480,4836,53402940,3039,18169
2322,8,39,25,0,84713760,4836,53449260,3040,18177
2323,4,37,25,0,84734100,4836,53457660,3040,18181
2324,11,40,25,0,84764820,4835,53554620,3044,18192
2325,5,37,25,0,84800880,4836,53564280,3043,18197
2326,6,37,25,0,84825480,4835,53580540,3043,18203
2327,11,40,25,0,84837660,4835,53583360,3043,18214
2328,5,36,25,0,84887460,4836,53673780,3047,18219
2329,7,39,25,0,84904980,4836,53683380,3047,18226
2330,4,38,25,0,84926220,4836,53692080,3046,18230
2331,3,37,25,0,84954780,4836,53724300,3048,18233
2332,6,37,25,0,84995040,4837,54088920,3068,18239
2333,7,35,25,0,85035840,4837,54102660,3067,18246
2334,4,34,25,0,85057560,4837,54126000,3068,18250
2335,11,37,25,0,85087680,4836,54582840,3091,18261
2336,11,40,25,0,85109700,4836,54590760,3091,18272
2337,13,40,25,0,85139880,4836,54600060,3090,18285
2338,9,40,25,0,85158660,4837,54603900,3090,18294
2339,7,39,25,0,85196700,4837,54626580,3090,18301
2340,15,40,25,0,85220520,4837,54628860,3090,18316
2341,13,39,25,0,85256040,4837,54699660,3093,18329
2342,9,40,25,0,85283400,4837,54705300,3091,18338
2343,15,40,25,0,85312920,4837,54711420,3091,18353
2344,7,39,25,0,85334580,4837,54756420,3093,18360
2345,9,38,25,0,85380420,4837,54791100,3093,18369
2346,3,36,25,0,85401600,4837,54839340,3095,18372
2347,9,37,25,0,85435260,4837,55147440,3111,18381
2348,12,39,25,0,85462200,4837,55156620,3110,18393
2349,7,38,25,0,85485000,4837,55165920,3110,18400
2350,7,39,25,0,85508040,4837,55183140,3110,18407
2351,3,35,25,0,85553760,4837,55512780,3128,18410
2352,7,35,25,0,85581420,4837,55821480,3144,18417
2353,13,39,25,0,85589820,4837,55823520,3143,18430
2354,6,38,25,0,85633800,4838,56154180,3161,18436
2355,4,38,25,0,85645740,4837,56159340,3161,18440
2356,3,34,25,0,85691580,4838,56192820,3162,18443
2357,9,36,25,0,85720860,4838,56697780,3189,18452
2358,9,40,25,0,85735560,4838,56702040,3188,18461
2359,7,38,25,0,85771860,4837,56713140,3187,18468
2360,14,40,25,0,85797960,4838,56716620,3186,18482
2361,6,38,25,0,85833360,4838,56724600,3186,18488
2362,13,40,25,0,85858680,4838,56727720,3185,18501
2363,9,39,25,0,85890480,4838,56749140,3185,18510
2364,14,40,25,0,85916280,4838,56767080,3185,18524
2365,17,40,25,0,85946580,4838,56990160,3196,18541
2366,8,40,25,0,85963920,4838,56994000,3196,18549
2367,12,40,25,0,85986240,4838,56998740,3196,18561
2368,14,40,25,0,86032680,4839,57034980,3197,18575
2369,10,39,25,0,86061420,4839,57077880,3198,18585
2370,12,39,25,0,86094780,4839,57087360,3197,18597
2371,8,39,25,0,86119320,4839,57105480,3197,18605
2372,6,38,25,0,86149320,4839,57160320,3199,18611
2373,4,36,25,0,86177340,4839,57259080,3204,18615
2374,7,37,25,0,86200260,4839,57282420,3205,18622
2375,5,34,25,0,86243700,4839,57689880,3226,18627
2376,4,33,25,0,86260740,4839,58464000,3269,18631
2377,2,27,25,0,86294940,4839,59331900,3317,18633
2378,2,15,25,0,86323080,4836,62622720,3501,18635
2379,6,3,25,0,86358300,4833,64863960,3625,18641
2380,3,0,22,3,86378640,4832,65570460,3663,18644
2381,7,0,25,0,86395080,4832,65570460,3662,18651
2382,2,0,20,5,86430900,4832,65571300,3662,18653
2383,5,0,22,3,86444220,4832,65571300,3661,18658
2384,8,3,25,0,86452800,4832,65571300,3660,18666
2385,5,2,25,0,86482920,4832,65576340,3659,18671
2386,9,6,25,0,86507580,4832,65582400,3657,18680
2387,15,17,25,0,86534760,4832,65587680,3654,18695
2388,7,18,25,0,86574840,4833,65606160,3654,18702
2389,7,20,25,0,86601000,4833,65617380,3653,18709
2390,9,24,25,0,86630340,4834,65637900,3652,18718
2391,7,26,25,0,86657280,4834,65653980,3652,18725
2392,14,36,25,0,86683080,4834,65656620,3650,18739
2393,10,38,25,0,86714700,4834,65669760,3648,18749
2394,5,38,25,0,86732400,4834,65683440,3648,18754
2395,12,37,25,0,86777880,4835,65715000,3649,18766
2396,11,40,25,0,86801520,4835,65721600,3648,18777
2397,5,38,25,0,86831220,4835,65736840,3647,18782
2398,3,36,25,0,86857200,4835,65816460,3651,18785
2399,7,38,25,0,86886660,4835,65890380,3654,18792

