Hour,Arrivals,Waiting,Treating,Available Rooms,Total Treatment Time,Average Treatment Time,Total Wait Time,Average Wait Time,Total Arrivals
1,3,0,2,23,900,900,0,0,3
2,5,0,6,19,6540,3270,0,0,8
3,1,0,3,22,22680,3780,0,0,9
4,8,0,6,19,43740,3976,0,0,17
5,8,0,5,20,68160,3408,0,0,25
6,2,0,4,21,87420,3800,0,0,27
7,6,0,6,19,101340,3753,0,0,33
8,5,0,6,19,119580,3736,0,0,38
9,9,0,9,16,149460,3933,0,0,47
10,10,0,14,11,172680,4015,0,0,57
11,4,0,3,22,229740,3961,0,0,61
12,15,0,15,10,236220,3872,0,0,76
13,9,0,13,12,276780,3844,0,0,85
14,15,0,14,11,342180,3978,0,0,100
15,12,0,17,8,370440,3899,0,0,112
16,5,0,5,20,426960,3812,0,0,117
17,4,0,4,21,455700,3894,0,0,121
18,9,0,5,20,475920,3807,0,0,130
19,9,0,9,16,492000,3784,0,0,139
20,8,0,11,14,508800,3741,0,0,147
21,7,0,7,18,553920,3768,0,0,154
22,4,0,7,18,586080,3881,0,0,158
23,6,0,7,18,611100,3892,0,0,164
24,7,0,6,19,654060,3964,0,0,171
25,11,0,12,13,674160,3965,0,0,182
26,5,0,3,22,721500,3921,0,0,187
27,7,0,8,17,727140,3909,0,0,194
28,12,0,12,13,752940,3881,0,0,206
29,6,0,8,17,779220,3819,0,0,212
30,6,0,9,16,813840,3893,0,0,218
31,6,0,9,16,830940,3864,0,0,224
32,11,0,14,11,873480,3952,0,0,235
33,8,0,11,14,909900,3921,0,0,243
34,10,0,13,12,948780,3953,0,0,253
35,9,0,11,14,988620,3938,0,0,262
36,7,0,10,15,1032120,3985,0,0,269
37,12,0,17,8,1048920,3973,0,0,281
38,8,0,7,18,1134420,4022,0,0,289
39,6,0,10,15,1156500,4057,0,0,295
40,5,0,6,19,1195920,4067,0,0,300
41,8,0,10,15,1205700,4045,0,0,308
42,10,0,13,12,1225860,4019,0,0,318
43,11,0,12,13,1278780,4034,0,0,329
44,8,0,9,16,1313160,4003,0,0,337
45,7,0,10,15,1351380,4046,0,0,344
46,5,0,6,19,1384800,4037,0,0,349
47,7,0,3,22,1416060,4011,0,0,356
48,4,0,5,20,1424820,4013,0,0,360
49,4,0,5,20,1436400,4001,0,0,364
50,3,0,4,21,1453920,4005,0,0,367
51,4,0,4,21,1473060,4013,0,0,371
52,4,0,6,19,1477140,4003,0,0,375
53,3,0,3,22,1506540,4017,0,0,378
54,9,0,6,19,1516560,3980,0,0,387
55,8,0,9,16,1535340,3977,0,0,395
56,6,0,7,18,1566780,3976,0,0,401
57,10,0,9,16,1602180,3985,0,0,411
58,3,0,4,21,1632660,3982,0,0,414
59,7,0,7,18,1643040,3968,0,0,421
60,8,0,8,17,1666140,3957,0,0,429
61,18,0,19,6,1696020,3962,0,0,447
62,11,0,12,13,1741620,3904,0,0,458
63,15,0,15,10,1793100,3915,0,0,473
64,15,0,15,10,1818660,3844,0,0,488
65,11,0,13,12,1870380,3848,0,0,499
66,9,0,17,8,1893960,3857,0,0,508
67,10,0,10,15,1982460,3902,0,0,518
68,9,0,10,15,2025240,3917,0,0,527
69,8,0,10,15,2070000,3942,0,0,535
70,5,0,4,21,2108760,3934,0,0,540
71,5,0,4,21,2127360,3932,0,0,545
72,9,0,10,15,2137560,3929,0,0,554
73,4,0,7,18,2156520,3913,0,0,558
74,4,0,7,18,2174940,3918,0,0,562
75,1,0,1,24,2210340,3932,0,0,563
76,6,0,6,19,2211840,3928,0,0,569
77,7,0,6,19,2225040,3903,0,0,576
78,8,0,11,14,2232960,3896,0,0,584
79,7,0,5,20,2273820,3880,0,0,591
80,9,0,8,17,2299560,3884,0,0,600
81,15,0,15,10,2317080,3861,0,0,615
82,5,0,9,16,2366280,3872,0,0,620
83,12,0,8,17,2418900,3876,0,0,632
84,13,0,12,13,2448000,3867,0,0,645
85,15,0,14,11,2491440,3856,0,0,660
86,7,0,7,18,2549880,3863,0,0,667
87,8,0,5,20,2587620,3862,0,0,675
88,10,0,10,15,2607780,3863,0,0,685
89,12,0,8,17,2650560,3846,0,0,697
90,9,0,8,17,2680980,3840,0,0,706
91,5,0,3,22,2715720,3835,0,0,711
92,7,0,6,19,2732640,3837,0,0,718
93,9,0,10,15,2745840,3829,0,0,727
94,7,0,8,17,2774400,3821,0,0,734
95,7,0,9,16,2803140,3829,0,0,741
96,6,0,8,17,2830560,3830,0,0,747
97,5,0,5,20,2866020,3836,0,0,752
98,3,0,2,23,2893920,3843,0,0,755
99,5,0,4,21,2899620,3835,0,0,760
100,4,0,4,21,2909400,3828,0,0,764
101,8,0,6,19,2921340,3813,0,0,772
102,9,0,7,18,2949360,3810,0,0,781
103,8,0,6,19,2978760,3804,0,0,789
104,11,0,12,13,3005700,3814,0,0,800
105,8,0,11,14,3026700,3797,0,0,808
106,6,0,7,18,3072600,3807,0,0,814
107,6,0,6,19,3097080,3804,0,0,820
108,10,0,6,19,3130320,3798,0,0,830
109,8,0,7,18,3146220,3786,0,0,838
110,12,0,14,11,3163500,3784,0,0,850
111,15,0,14,11,3210480,3772,0,0,865
112,10,0,12,13,3253380,3769,0,0,875
113,9,0,11,14,3297780,3777,0,0,884
114,7,0,5,20,3352980,3784,0,0,891
115,7,0,3,22,3385980,3783,0,0,898
116,5,0,5,20,3394500,3780,0,0,903
117,3,0,4,21,3406620,3776,0,0,906
118,4,0,3,22,3419460,3770,0,0,910
119,6,0,8,17,3420180,3766,0,0,916
120,7,0,9,16,3457920,3783,0,0,923
121,3,0,6,19,3486600,3789,0,0,926
122,6,0,5,20,3514620,3791,0,0,932
123,7,0,7,18,3538740,3796,0,0,939
124,8,0,9,16,3557640,3792,0,0,947
125,7,0,9,16,3576960,3785,0,0,954
126,6,0,6,19,3619860,3794,0,0,960
127,11,0,12,13,3638160,3793,0,0,971
128,9,0,13,12,3671640,3796,0,0,980
129,9,0,9,16,3719340,3795,0,0,989
130,12,0,11,14,3760680,3798,0,0,1001
131,5,0,7,18,3800340,3804,0,0,1006
132,9,0,7,18,3832200,3801,0,0,1015
133,10,0,13,12,3839700,3794,0,0,1025
134,5,0,9,16,3876720,3796,0,0,1030
135,11,0,9,16,3929460,3807,0,0,1041
136,11,0,10,15,3959340,3799,0,0,1052
137,7,0,10,15,3997080,3810,0,0,1059
138,5,0,8,17,4030440,3816,0,0,1064
139,8,0,9,16,4058100,3817,0,0,1072
140,12,0,14,11,4068000,3801,0,0,1084
141,9,0,11,14,4118220,3806,0,0,1093
142,7,0,8,17,4153020,3803,0,0,1100
143,8,0,7,18,4194900,3810,0,0,1108
144,6,0,6,19,4214760,3803,0,0,1114
145,6,0,6,19,4232640,3799,0,0,1120
146,6,0,7,18,4242480,3791,0,0,1126
147,2,0,1,24,4278120,3796,0,0,1128
148,4,0,3,22,4284120,3794,0,0,1132
149,8,0,9,16,4287600,3790,0,0,1140
150,8,0,7,18,4316640,3783,0,0,1148
151,2,0,5,20,4334340,3785,0,0,1150
152,10,0,6,19,4359600,3777,0,0,1160
153,9,0,11,14,4378080,3780,0,0,1169
154,9,0,13,12,4402560,3779,0,0,1178
155,10,0,9,16,4460520,3783,0,0,1188
156,5,0,7,18,4486680,3783,0,0,1193
157,5,0,7,18,4513860,3789,0,0,1198
158,12,0,10,15,4545180,3787,0,0,1210
159,11,0,11,14,4576380,3782,0,0,1221
160,8,0,11,14,4598280,3775,0,0,1229
161,9,0,9,16,4657920,3790,0,0,1238
162,7,0,5,20,4707480,3796,0,0,1245
163,14,0,11,14,4731240,3791,0,0,1259
164,8,0,9,16,4777320,3797,0,0,1267
165,7,0,6,19,4807020,3791,0,0,1274
166,4,0,4,21,4827180,3788,0,0,1278
167,7,0,3,22,4853280,3785,0,0,1285
168,7,0,8,17,4856640,3782,0,0,1292
169,9,0,9,16,4873380,3771,0,0,1301
170,4,0,4,21,4912080,3775,0,0,1305
171,8,0,4,21,4941900,3775,0,0,1313
172,2,0,4,21,4951140,3776,0,0,1315
173,2,0,0,25,4969560,3773,0,0,1317
174,3,0,3,22,4969560,3773,0,0,1320
175,4,0,4,21,4978020,3771,0,0,1324
176,6,0,7,18,4983240,3766,0,0,1330
177,13,0,12,13,5005980,3761,0,0,1343
178,9,0,7,18,5054880,3758,0,0,1352
179,11,0,9,16,5077440,3749,0,0,1363
180,8,0,3,22,5122800,3744,0,0,1371
181,11,0,10,15,5136000,3743,0,0,1382
182,15,0,14,11,5169180,3737,0,0,1397
183,10,0,13,12,5209440,3737,0,0,1407
184,5,0,7,18,5255820,3740,0,0,1412
185,11,0,10,15,5286300,3741,0,0,1423
186,11,0,14,11,5313720,3742,0,0,1434
187,7,0,10,15,5364240,3748,0,0,1441
188,8,0,9,16,5400540,3750,0,0,1449
189,7,0,10,15,5431680,3756,60,0,1456
190,1,0,6,19,5461980,3764,60,0,1457
191,6,0,9,16,5475960,3766,60,0,1463
192,4,0,5,20,5541660,3790,60,0,1467
193,4,0,2,23,5570460,3792,60,0,1471
194,6,0,5,20,5576820,3788,60,0,1477
195,5,0,5,20,5595180,3788,60,0,1482
196,4,0,6,19,5609160,3789,60,0,1486
197,8,0,9,16,5627460,3789,60,0,1494
198,6,0,6,19,5664180,3791,60,0,1500
199,10,0,8,17,5691780,3789,60,0,1510
200,8,0,8,17,5718840,3787,60,0,1518
201,8,0,7,18,5748660,3784,60,0,1526
202,6,0,3,22,5771700,3774,60,0,1532
203,5,0,4,21,5780880,3770,60,0,1537
204,8,0,6,19,5805240,3772,60,0,1545
205,8,0,6,19,5823600,3764,60,0,1553
206,14,0,12,13,5841900,3756,60,0,1567
207,10,0,16,9,5859120,3753,60,0,1577
208,12,0,14,11,5911200,3753,60,0,1589
209,6,0,7,18,5971860,3760,60,0,1595
210,4,0,4,21,6002760,3763,60,0,1599
211,10,0,9,16,6011340,3757,60,0,1609
212,6,0,8,17,6042240,3759,60,0,1615
213,6,0,7,18,6073140,3762,60,0,1621
214,6,0,4,21,6101220,3759,60,0,1627
215,3,0,3,22,6119580,3761,60,0,1630
216,6,0,7,18,6130620,3763,60,0,1636
217,5,0,5,20,6156420,3763,60,0,1641
218,3,0,1,24,6188520,3766,60,0,1644
219,1,0,0,25,6199380,3768,60,0,1645
220,1,0,1,24,6199380,3768,60,0,1646
221,4,0,3,22,6201180,3765,60,0,1650
222,10,0,10,15,6209160,3763,60,0,1660
223,7,0,10,15,6231780,3760,60,0,1667
224,8,0,9,16,6281220,3770,60,0,1675
225,12,0,9,16,6317760,3765,60,0,1687
226,9,0,6,19,6361920,3764,60,0,1696
227,7,0,7,18,6377940,3760,60,0,1703
228,8,0,10,15,6398460,3761,60,0,1711
229,8,0,9,16,6428880,3759,60,0,1719
230,6,0,4,21,6461280,3754,60,0,1725
231,11,0,6,19,6479040,3745,60,0,1736
232,7,0,8,17,6502260,3747,60,0,1743
233,8,0,9,16,6527880,3747,60,0,1751
234,4,0,7,18,6550740,3747,60,0,1755
235,9,0,8,17,6595200,3755,60,0,1764
236,5,0,8,17,6613920,3755,60,0,1769
237,5,0,7,18,6626640,3750,60,0,1774
238,1,0,4,21,6660780,3761,60,0,1775
239,2,0,1,24,6687060,3765,60,0,1777
240,7,0,4,21,6699360,3763,60,0,1784
241,8,0,6,19,6711420,3757,60,0,1792
242,4,0,3,22,6730260,3753,60,0,1796
243,8,0,8,17,6733800,3749,60,0,1804
244,8,0,5,20,6773220,3748,60,0,1812
245,7,0,5,20,6792000,3744,60,0,1819
246,9,0,8,17,6807540,3740,60,0,1828
247,6,0,10,15,6828480,3743,60,0,1834
248,14,0,14,11,6877080,3749,60,0,1848
249,12,0,12,13,6927540,3748,60,0,1860
250,6,0,6,19,6974820,3749,60,0,1866
251,11,0,11,14,6991200,3746,60,0,1877
252,14,0,15,10,7023360,3743,60,0,1891
253,11,0,15,10,7060440,3741,60,0,1902
254,9,0,7,18,7137960,3748,60,0,1911
255,13,0,12,13,7165500,3747,60,0,1924
256,10,0,9,16,7217700,3749,60,0,1934
257,6,0,9,16,7232700,3745,60,0,1940
258,3,0,4,21,7274940,3751,60,0,1943
259,15,0,16,9,7287660,3752,60,0,1958
260,4,0,9,16,7319520,3747,60,0,1962
261,9,0,7,18,7373040,3754,60,0,1971
262,5,0,6,19,7403340,3758,60,0,1976
263,5,0,4,21,7418580,3752,60,0,1981
264,0,0,0,25,7442640,3757,60,0,1981
265,2,0,1,24,7444020,3755,60,0,1983
266,7,0,5,20,7449600,3752,60,0,1990
267,11,0,9,16,7461120,3745,60,0,2001
268,4,0,9,16,7483920,3749,60,0,2005
269,1,0,6,19,7510020,3755,60,0,2006
270,4,0,2,23,7555020,3762,60,0,2010
271,5,0,4,21,7559340,3758,60,0,2015
272,10,0,6,19,7573500,3751,60,0,2025
273,7,0,8,17,7589040,3749,60,0,2032
274,10,0,11,14,7613460,3748,60,0,2042
275,8,0,9,16,7656660,3751,60,0,2050
276,6,0,4,21,7692720,3748,60,0,2056
277,14,0,11,14,7715220,3747,60,0,2070
278,7,0,12,13,7733340,3744,60,0,2077
279,9,0,11,14,7769940,3744,60,0,2086
280,7,0,8,17,7819020,3750,60,0,2093
281,12,0,15,10,7836840,3749,60,0,2105
282,10,0,16,9,7876920,3752,60,0,2115
283,11,0,11,14,7938060,3753,60,0,2126
284,4,0,7,18,7992840,3764,60,0,2130
285,7,0,4,21,8035320,3767,60,0,2137
286,6,0,8,17,8045340,3768,60,0,2143
287,4,0,4,21,8071380,3766,60,0,2147
288,8,0,3,22,8096400,3762,60,0,2155
289,4,0,3,22,8108700,3760,60,0,2159
290,4,0,4,21,8116440,3759,60,0,2163
291,7,0,6,19,8137620,3760,60,0,2170
292,5,0,5,20,8155260,3758,60,0,2175
293,7,0,9,16,8163360,3756,60,0,2182
294,9,0,7,18,8199360,3754,60,0,2191
295,5,0,6,19,8220720,3753,60,0,2196
296,9,0,6,19,8253480,3753,60,0,2205
297,12,0,12,13,8264640,3748,60,0,2217
298,8,0,10,15,8297460,3746,60,0,2225
299,11,0,8,17,8342280,3744,60,0,2236
300,12,0,10,15,8379000,3743,60,0,2248
301,7,0,7,18,8421780,3746,60,0,2255
302,6,0,6,19,8441520,3743,60,0,2261
303,11,0,9,16,8469420,3742,60,0,2272
304,12,0,11,14,8507100,3742,60,0,2284
305,10,0,13,12,8528880,3739,60,0,2294
306,7,0,10,15,8576220,3743,60,0,2301
307,9,0,8,17,8621460,3745,60,0,2310
308,5,0,9,16,8638620,3746,60,0,2315
309,8,0,7,18,8672700,3744,60,0,2323
310,6,0,6,19,8701860,3745,60,0,2329
311,7,0,4,21,8724180,3741,60,0,2336
312,7,0,6,19,8735520,3737,60,0,2343
313,4,0,3,22,8769960,3741,60,0,2347
314,7,0,6,19,8778420,3738,60,0,2354
315,7,0,8,17,8791980,3736,60,0,2361
316,5,0,6,19,8825880,3739,60,0,2366
317,5,0,7,18,8842380,3740,60,0,2371
318,8,0,7,18,8859780,3735,60,0,2379
319,8,0,6,19,8893440,3735,60,0,2387
320,6,0,6,19,8913780,3734,60,0,2393
321,4,0,4,21,8936640,3734,60,0,2397
322,9,0,11,14,8948280,3736,60,0,2406
323,13,0,12,13,8989980,3734,60,0,2419
324,5,0,6,19,9034020,3736,60,0,2424
325,14,0,10,15,9055980,3729,60,0,2438
326,6,0,6,19,9093660,3729,60,0,2444
327,10,0,7,18,9120000,3727,60,0,2454
328,5,0,6,19,9142560,3727,60,0,2459
329,14,0,12,13,9154860,3719,60,0,2473
330,9,0,12,13,9196020,3723,60,0,2482
331,8,0,9,16,9242160,3725,60,0,2490
332,4,0,4,21,9283020,3728,60,0,2494
333,3,0,3,22,9304680,3730,60,0,2497
334,3,0,3,22,9313560,3729,60,0,2500
335,3,0,3,22,9323580,3729,60,0,2503
336,5,0,3,22,9331080,3724,60,0,2508
337,4,0,4,21,9340500,3724,60,0,2512
338,7,0,6,19,9356580,3723,60,0,2519
339,3,0,3,22,9371040,3720,60,0,2522
340,11,0,8,17,9386640,3717,60,0,2533
341,9,0,10,15,9411780,3717,60,0,2542
342,4,0,7,18,9448560,3721,60,0,2546
343,6,0,8,17,9480360,3726,60,0,2552
344,11,0,10,15,9500160,3721,60,0,2563
345,9,0,10,15,9530220,3719,60,0,2572
346,10,0,11,14,9562800,3719,60,0,2582
347,9,0,6,19,9604080,3715,60,0,2591
348,12,0,5,20,9632100,3707,60,0,2603
349,9,0,9,16,9649860,3707,60,0,2612
350,6,0,4,21,9684720,3704,60,0,2618
351,4,0,4,21,9697680,3704,60,0,2622
352,18,0,16,9,9708540,3699,60,0,2640
353,14,0,15,10,9768960,3701,60,0,2654
354,9,0,12,13,9810360,3700,60,0,2663
355,9,0,9,16,9845100,3696,60,0,2672
356,7,0,8,17,9880200,3699,60,0,2679
357,3,0,6,19,9907680,3702,60,0,2682
358,9,0,7,18,9939720,3703,60,0,2691
359,8,0,5,20,9966780,3699,60,0,2699
360,5,0,6,19,9982980,3700,60,0,2704
361,4,0,4,21,9999360,3697,60,0,2708
362,12,0,11,14,10015680,3697,60,0,2720
363,1,0,5,20,10050180,3700,60,0,2721
364,7,0,3,22,10083660,3700,60,0,2728
365,6,0,6,19,10090980,3699,60,0,2734
366,3,0,5,20,10106580,3699,60,0,2737
367,9,0,10,15,10128960,3702,60,0,2746
368,11,0,12,13,10149960,3697,60,0,2757
369,11,0,9,16,10210260,3700,60,0,2768
370,9,0,8,17,10234800,3696,60,0,2777
371,17,0,16,9,10268820,3696,60,0,2794
372,15,0,13,12,10329240,3694,60,0,2809
373,8,0,11,14,10367220,3694,60,0,2817
374,8,0,9,16,10396200,3691,60,0,2825
375,9,0,5,20,10450440,3694,60,0,2834
376,9,0,8,17,10470780,3693,60,0,2843
377,7,0,7,18,10490340,3689,60,0,2850
378,11,0,10,15,10513680,3687,60,0,2861
379,12,0,12,13,10553280,3688,60,0,2873
380,8,0,7,18,10596360,3686,60,0,2881
381,4,0,3,22,10624620,3686,60,0,2885
382,6,0,5,20,10643160,3687,60,0,2891
383,2,0,1,24,10661340,3686,60,0,2893
384,8,0,6,19,10668360,3685,60,0,2901
385,5,0,7,18,10674180,3682,60,0,2906
386,4,0,7,18,10703700,3687,60,0,2910
387,6,0,6,19,10728840,3686,60,0,2916
388,6,0,5,20,10751220,3685,60,0,2922
389,3,0,2,23,10775700,3686,60,0,2925
390,5,0,4,21,10781820,3684,60,0,2930
391,4,0,4,21,10797120,3685,60,0,2934
392,8,0,9,16,10808760,3685,60,0,2942
393,7,0,7,18,10835100,3682,60,0,2949
394,14,0,12,13,10858920,3679,60,0,2963
395,9,0,13,12,10891980,3680,60,0,2972
396,9,0,12,13,10947240,3687,60,0,2981
397,9,0,11,14,10992600,3690,60,0,2990
398,12,0,10,15,11039340,3689,60,0,3002
399,8,0,10,15,11062080,3687,60,0,3010
400,9,0,10,15,11091000,3685,60,0,3019
401,12,0,16,9,11128020,3690,60,0,3031
402,7,0,13,12,11174760,3694,60,0,3038
403,7,0,6,19,11241000,3698,60,0,3045
404,5,0,5,20,11268840,3700,60,0,3050
405,6,0,5,20,11291220,3700,60,0,3056
406,7,0,8,17,11303460,3699,60,0,3063
407,8,0,11,14,11322660,3700,60,0,3071
408,4,0,12,13,11339940,3702,60,0,3075
409,10,0,12,13,11393280,3707,60,0,3085
410,5,0,5,20,11442720,3709,60,0,3090
411,6,0,6,19,11476440,3714,60,0,3096
412,9,0,9,16,11489340,3711,60,0,3105
413,3,0,5,20,11523360,3713,60,0,3108
414,2,0,2,23,11553060,3717,60,0,3110
415,5,0,5,20,11556600,3715,60,0,3115
416,8,0,7,18,11578320,3715,60,0,3123
417,6,0,6,19,11600400,3714,60,0,3129
418,10,0,10,15,11621820,3714,60,0,3139
419,17,0,15,10,11646780,3707,60,0,3156
420,8,0,8,17,11696400,3706,60,0,3164
421,11,0,7,18,11748300,3708,60,0,3175
422,13,0,12,13,11765400,3704,60,0,3188
423,9,0,10,15,11809980,3705,60,0,3197
424,4,0,7,18,11846940,3709,60,0,3201
425,5,0,7,18,11873760,3711,60,0,3206
426,9,0,12,13,11891160,3712,60,0,3215
427,5,0,12,13,11908020,3711,60,0,3220
428,8,0,6,19,11975460,3716,60,0,3228
429,5,0,7,18,11995860,3718,60,0,3233
430,9,0,8,17,12014700,3715,60,0,3242
431,5,0,4,21,12054780,3717,60,0,3247
432,5,0,6,19,12065100,3716,60,0,3252
433,3,0,5,20,12073020,3714,60,0,3255
434,4,0,3,22,12100980,3716,60,0,3259
435,7,0,7,18,12122520,3719,60,0,3266
436,12,0,10,15,12136500,3713,60,0,3278
437,6,0,7,18,12157620,3709,60,0,3284
438,10,0,10,15,12183120,3709,60,0,3294
439,8,0,11,14,12211020,3710,60,0,3302
440,5,0,7,18,12253140,3713,60,0,3307
441,8,0,7,18,12287280,3714,60,0,3315
442,12,0,8,17,12321180,3712,60,0,3327
443,12,0,12,13,12336120,3707,60,0,3339
444,8,0,12,13,12373800,3710,60,0,3347
445,17,1,17,8,12408660,3708,540,0,3364
446,5,0,9,16,12474900,3712,1500,0,3369
447,12,0,9,16,12534240,3717,1500,0,3381
448,9,0,12,13,12550620,3715,1500,0,3390
449,10,0,8,17,12605760,3716,1500,0,3400
450,8,0,11,14,12619260,3714,1500,0,3408
451,10,0,8,17,12656100,3711,1500,0,3418
452,5,0,7,18,12679740,3711,1500,0,3423
453,8,0,9,16,12693480,3709,1500,0,3431
454,15,0,17,8,12720960,3709,1500,0,3446
455,4,0,9,16,12779100,3713,1500,0,3450
456,7,0,5,20,12830460,3716,1500,0,3457
457,2,0,0,25,12857100,3716,1500,0,3459
458,10,0,8,17,12860280,3715,1500,0,3469
459,2,0,7,18,12868200,3714,1500,0,3471
460,8,0,8,17,12904560,3717,1500,0,3479
461,3,0,7,18,12927840,3720,1500,0,3482
462,7,0,7,18,12951960,3719,1500,0,3489
463,7,0,7,18,12986280,3722,1500,0,3496
464,13,0,14,11,13009620,3722,1500,0,3509
465,8,0,7,18,13054260,3719,1500,0,3517
466,12,0,11,14,13087200,3720,1500,0,3529
467,14,0,18,7,13114680,3720,1500,0,3543
468,12,0,19,6,13166940,3723,1500,0,3555
469,13,0,9,16,13261680,3726,1500,0,3568
470,10,0,12,13,13292040,3727,1500,0,3578
471,9,0,9,16,13346640,3730,1500,0,3587
472,9,0,8,17,13375200,3727,1500,0,3596
473,7,0,6,19,13405440,3726,1500,0,3603
474,9,0,7,18,13434000,3726,1500,0,3612
475,6,0,10,15,13446240,3726,1500,0,3618
476,6,0,8,17,13473120,3725,1500,0,3624
477,3,0,6,19,13498440,3727,1500,0,3627
478,4,0,5,20,13526160,3730,1500,0,3631
479,5,0,4,21,13553640,3731,1500,0,3636
480,1,0,0,25,13571340,3731,1500,0,3637
481,4,0,0,25,13578180,3729,1500,0,3641
482,6,0,5,20,13578660,3728,1500,0,3647
483,8,0,8,17,13594140,3727,1500,0,3655
484,8,0,9,16,13621680,3727,1500,0,3663
485,8,0,10,15,13652640,3729,1500,0,3671
486,8,0,8,17,13687500,3728,1500,0,3679
487,9,0,9,16,13721640,3729,1500,0,3688
488,11,0,9,16,13758180,3728,1500,0,3699
489,13,0,12,13,13785840,3725,1500,0,3712
490,15,0,12,13,13832760,3723,1500,0,3727
491,15,0,16,9,13865160,3721,1500,0,3742
492,9,0,14,11,13916460,3723,1500,0,3751
493,16,0,15,10,13980780,3726,1500,0,3767
494,12,0,15,10,14016600,3723,1500,0,3779
495,9,0,2,23,14105580,3725,1500,0,3788
496,15,0,8,17,14122560,3721,1500,0,3803
497,12,0,11,14,14134380,3715,1500,0,3815
498,10,0,11,14,14173140,3716,1500,0,3825
499,7,0,9,16,14221140,3719,1500,0,3832
500,6,0,6,19,14247600,3718,1500,0,3838
501,7,0,6,19,14285100,3721,1500,0,3845
502,5,0,7,18,14300880,3721,1500,0,3850
503,4,0,7,18,14323020,3723,1500,0,3854
504,4,0,6,19,14344080,3723,1500,0,3858
505,6,0,5,20,14376120,3725,1500,0,3864
506,9,0,5,20,14395440,3721,1500,0,3873
507,5,0,4,21,14411760,3720,1500,0,3878
508,5,0,3,22,14436240,3720,1500,0,3883
509,7,0,6,19,14447340,3719,1500,0,3890
510,7,0,8,17,14461860,3718,1500,0,3897
511,7,0,7,18,14499600,3720,1500,0,3904
512,6,0,6,19,14525700,3720,1500,0,3910
513,4,0,4,21,14542080,3719,1500,0,3914
514,11,0,6,19,14559000,3714,1500,0,3925
515,8,0,10,15,14569440,3713,1500,0,3933
516,13,0,13,12,14600760,3712,1500,0,3946
517,10,0,12,13,14653200,3715,1500,0,3956
518,9,0,11,14,14691600,3715,1500,0,3965
519,11,0,9,16,14728080,3712,1500,0,3976
520,8,0,10,15,14752500,3712,1500,0,3984
521,5,0,8,17,14771820,3710,1500,0,3989
522,9,0,10,15,14811240,3713,1500,0,3998
523,8,0,9,16,14845860,3714,1500,0,4006
524,5,0,3,22,14891520,3715,1500,0,4011
525,7,0,6,19,14898480,3713,1500,0,4018
526,7,0,11,14,14901960,3712,1500,0,4025
527,3,0,2,23,14958780,3715,1500,0,4028
528,6,0,5,20,14970780,3715,1500,0,4034
529,7,0,5,20,14983680,3712,1500,0,4041
530,4,0,4,21,15006480,3713,1500,0,4045
531,6,0,3,22,15023760,3711,1500,0,4051
532,11,0,8,17,15040440,3710,1500,0,4062
533,4,0,4,21,15066900,3709,1500,0,4066
534,8,0,7,18,15081960,3708,1500,0,4074
535,10,0,5,20,15118980,3706,1500,0,4084
536,12,0,10,15,15138240,3704,1500,0,4096
537,10,0,9,16,15162120,3700,1500,0,4106
538,12,0,12,13,15192720,3700,1500,0,4118
539,8,0,12,13,15220080,3699,1500,0,4126
540,6,0,6,19,15273060,3701,1500,0,4132
541,11,0,8,17,15313860,3703,1500,0,4143
542,8,0,10,15,15330420,3702,1500,0,4151
543,13,0,15,10,15361020,3702,1500,0,4164
544,9,0,15,10,15400080,3703,1500,0,4173
545,10,0,7,18,15469020,3704,1500,0,4183
546,8,0,6,19,15495120,3702,1500,0,4191
547,7,0,6,19,15523140,3703,1500,0,4198
548,6,0,5,20,15547080,3702,1500,0,4204
549,5,0,4,21,15562260,3700,1500,0,4209
550,2,0,3,22,15580260,3702,1500,0,4211
551,5,0,2,23,15599520,3701,1500,0,4216
552,6,0,6,19,15603420,3701,1500,0,4222
553,4,0,5,20,15616740,3699,1500,0,4226
554,5,0,7,18,15625320,3699,1500,0,4231
555,8,0,8,17,15653820,3699,1500,0,4239
556,3,0,3,22,15692820,3702,1500,0,4242
557,9,0,8,17,15706080,3701,1500,0,4251
558,7,0,8,17,15730980,3701,1500,0,4258
559,8,0,10,15,15746040,3699,1500,0,4266
560,10,0,9,16,15798540,3702,1500,0,4276
561,9,0,13,12,15810240,3700,1500,0,4285
562,8,0,8,17,15871680,3704,1500,0,4293
563,9,0,7,18,15906060,3703,1500,0,4302
564,9,0,7,18,15929160,3701,1500,0,4311
565,11,0,11,14,15950700,3700,1500,0,4322
566,8,0,6,19,15986760,3697,1500,0,4330
567,12,0,8,17,16008240,3693,1500,0,4342
568,10,0,9,16,16030920,3691,1500,0,4352
569,13,0,9,16,16067580,3688,1500,0,4365
570,8,0,11,14,16089840,3688,1500,0,4373
571,6,0,6,19,16126740,3687,1500,0,4379
572,8,0,8,17,16140120,3685,1500,0,4387
573,4,0,7,18,16170060,3688,1500,0,4391
574,5,0,8,17,16183680,3688,1500,0,4396
575,9,0,7,18,16224120,3688,1500,0,4405
576,3,0,7,18,16237860,3689,1500,0,4408
577,3,0,3,22,16269600,3690,1500,0,4411
578,3,0,5,20,16270260,3690,1500,0,4414
579,6,0,6,19,16284000,3689,1500,0,4420
580,3,0,5,20,16308240,3691,1500,0,4423
581,7,0,5,20,16327920,3689,1500,0,4430
582,7,0,6,19,16344540,3688,1500,0,4437
583,10,0,12,13,16357620,3688,1500,0,4447
584,5,0,9,16,16381740,3687,1500,0,4452
585,6,0,6,19,16421400,3688,1500,0,4458
586,14,0,13,12,16455360,3690,1500,0,4472
587,13,0,14,11,16490100,3688,1500,0,4485
588,10,0,10,15,16544580,3688,1500,0,4495
589,12,0,12,13,16580460,3688,1500,0,4507
590,11,0,10,15,16606500,3683,1500,0,4518
591,11,0,13,12,16641240,3684,1500,0,4529
592,6,0,6,19,16698300,3686,1500,0,4535
593,12,0,5,20,16734660,3684,1500,0,4547
594,9,0,7,18,16752300,3682,1500,0,4556
595,8,0,7,18,16775700,3681,1500,0,4564
596,8,0,8,17,16799400,3680,1500,0,4572
597,10,0,9,16,16820760,3678,1500,0,4582
598,9,0,10,15,16845840,3677,1500,0,4591
599,8,0,7,18,16887900,3677,1500,0,4599
600,6,0,6,19,16912140,3677,1500,0,4605
601,4,0,5,20,16932900,3677,1500,0,4609
602,9,0,6,19,16954500,3676,1500,0,4618
603,8,0,7,18,16973940,3674,1500,0,4626
604,10,0,11,14,16994340,3674,1500,0,4636
605,8,0,10,15,17030820,3675,1500,0,4644
606,10,0,12,13,17070000,3677,1500,0,4654
607,9,0,11,14,17102220,3676,1500,0,4663
608,5,0,5,20,17161800,3680,1500,0,4668
609,11,0,12,13,17173860,3679,1500,0,4679
610,9,0,12,13,17208720,3680,1500,0,4688
611,14,0,12,13,17250900,3678,1500,0,4702
612,10,0,10,15,17300580,3679,1500,0,4712
613,9,0,8,17,17333220,3677,1500,0,4721
614,8,0,8,17,17357820,3676,1500,0,4729
615,13,0,12,13,17395440,3677,1500,0,4742
616,13,0,10,15,17432880,3673,1500,0,4755
617,9,0,9,16,17470260,3674,1500,0,4764
618,8,0,8,17,17507040,3674,1500,0,4772
619,6,0,6,19,17531700,3673,1500,0,4778
620,5,0,9,16,17540520,3674,1500,0,4783
621,4,0,5,20,17593380,3679,1500,0,4787
622,4,0,3,22,17617200,3679,1500,0,4791
623,6,0,5,20,17633820,3679,1500,0,4797
624,6,0,5,20,17653200,3679,1500,0,4803
625,4,0,0,25,17679360,3677,1500,0,4807
626,6,0,3,22,17683080,3676,1500,0,4813
627,8,0,10,15,17687160,3676,1500,0,4821
628,4,0,8,17,17704620,3675,1500,0,4825
629,4,0,6,19,17738280,3677,1500,0,4829
630,6,0,3,22,17772600,3678,1500,0,4835
631,13,0,12,13,17777580,3676,1500,0,4848
632,11,0,10,15,17810520,3673,1500,0,4859
633,11,0,9,16,17842500,3670,1500,0,4870
634,3,0,2,23,17878320,3670,1500,0,4873
635,13,0,12,13,17895060,3671,1500,0,4886
636,11,0,13,12,17918580,3668,1500,0,4897
637,12,0,14,11,17956860,3668,1500,0,4909
638,13,0,13,12,17999940,3666,1500,0,4922
639,9,0,14,11,18041580,3669,1500,0,4931
640,14,0,12,13,18104640,3670,1500,0,4945
641,8,0,11,14,18141120,3670,1500,0,4953
642,6,0,9,16,18186240,3673,1500,0,4959
643,11,0,11,14,18228780,3675,1500,0,4970
644,3,0,5,20,18256680,3674,1500,0,4973
645,5,0,3,22,18286140,3675,1500,0,4978
646,12,0,9,16,18296340,3673,1500,0,4990
647,5,0,7,18,18317220,3672,1500,0,4995
648,3,0,2,23,18347460,3672,1500,0,4998
649,5,0,4,21,18361020,3672,1500,0,5003
650,8,0,7,18,18369000,3670,1500,0,5011
651,8,0,8,17,18393960,3670,1500,0,5019
652,5,0,7,18,18420120,3671,1500,0,5024
653,6,0,7,18,18450660,3673,1500,0,5030
654,3,0,5,20,18474600,3674,1500,0,5033
655,14,0,11,14,18504120,3674,1500,0,5047
656,9,0,9,16,18531360,3671,1500,0,5056
657,16,0,15,10,18554040,3668,1500,0,5072
658,8,0,10,15,18601140,3668,1500,0,5080
659,11,0,10,15,18646980,3669,1500,0,5091
660,15,0,14,11,18672000,3666,1500,0,5106
661,13,0,9,16,18736980,3666,1500,0,5119
662,12,0,10,15,18772260,3665,1500,0,5131
663,8,0,9,16,18797760,3664,1500,0,5139
664,7,0,7,18,18829080,3663,1500,0,5146
665,3,0,4,21,18852420,3664,1500,0,5149
666,11,0,6,19,18884400,3664,1500,0,5160
667,8,0,8,17,18905160,3663,1500,0,5168
668,5,0,6,19,18922260,3662,1500,0,5173
669,13,0,11,14,18943860,3660,1500,0,5186
670,2,0,7,18,18967680,3661,1500,0,5188
671,3,0,2,23,19017180,3664,1500,0,5191
672,8,0,9,16,19022700,3665,1500,0,5199
673,6,0,15,10,19022700,3665,1500,0,5205
674,3,0,15,10,19030740,3664,1500,0,5208
675,6,0,12,13,19073340,3666,1500,0,5214
676,5,0,11,14,19086780,3664,1500,0,5219
677,6,0,14,11,19097820,3664,1500,0,5225
678,5,0,15,10,19103400,3663,1500,0,5230
679,4,0,15,10,19134240,3666,1500,0,5234
680,7,0,15,10,19164780,3667,1500,0,5241
681,9,0,18,7,19185540,3666,1500,0,5250
682,8,0,16,9,19211640,3664,1500,0,5258
683,9,0,19,6,19224900,3663,1500,0,5267
684,7,0,15,10,19274400,3665,1500,0,5274
685,10,0,20,5,19291140,3664,1500,0,5284
686,6,0,15,10,19344900,3667,1500,0,5290
687,9,0,17,8,19373280,3667,1500,0,5299
688,8,0,16,9,19397700,3666,1500,0,5307
689,5,0,15,10,19434600,3668,1500,0,5312
690,9,0,14,11,19470240,3668,1500,0,5321
691,6,0,12,13,19497300,3668,1500,0,5327
692,4,0,15,10,19499760,3668,1500,0,5331
693,5,0,12,13,19522440,3666,1500,0,5336
694,4,0,11,14,19543680,3667,1500,0,5340
695,6,0,15,10,19550400,3667,1500,0,5346
696,4,0,9,16,19576560,3665,1500,0,5350
697,1,0,8,17,19586940,3665,1500,0,5351
698,2,0,10,15,19586940,3665,1500,0,5353
699,5,0,12,13,19590480,3664,1500,0,5358
700,6,0,16,9,19597680,3664,1500,0,5364
701,8,0,16,9,19624860,3664,1500,0,5372
702,12,0,14,11,19668960,3662,1500,0,5384
703,5,0,14,11,19683240,3661,1500,0,5389
704,11,0,18,7,19706100,3661,1500,0,5400
705,8,0,18,7,19733280,3661,1500,0,5408
706,13,0,21,4,19767660,3660,1500,0,5421
707,7,0,14,11,19816740,3660,1500,0,5428
708,6,0,13,12,19836720,3659,1500,0,5434
709,17,0,21,4,19863720,3658,1500,0,5451
710,10,0,16,9,19910880,3656,1500,0,5461
711,14,0,19,6,19952100,3656,1500,0,5475
712,15,0,25,0,19988220,3657,1500,0,5490
713,12,0,25,0,20031840,3657,2160,0,5502
714,8,0,15,10,20108040,3659,3420,0,5510
715,11,0,19,6,20138520,3660,3420,0,5521
716,12,0,17,8,20182920,3658,3420,0,5533
717,9,0,16,9,20210160,3657,3420,0,5542
718,5,0,17,8,20234040,3658,3420,0,5547
719,6,0,15,10,20269260,3660,3420,0,5553
720,4,0,14,11,20294640,3661,3420,0,5557
721,3,0,11,14,20318580,3661,3420,0,5560
722,4,0,12,13,20328120,3661,3420,0,5564
723,8,0,16,9,20338800,3660,3420,0,5572
724,6,0,15,10,20359320,3659,3420,0,5578
725,13,0,17,8,20393400,3658,3420,0,5591
726,7,0,15,10,20426280,3658,3420,0,5598
727,3,0,14,11,20442120,3658,3420,0,5601
728,8,0,14,11,20479560,3660,3420,0,5609
729,10,0,15,10,20502240,3658,3420,0,5619
730,10,0,17,8,20531580,3658,3420,0,5629
731,11,0,21,4,20554320,3658,3420,0,5640
732,11,0,19,6,20604360,3658,3420,0,5651
733,7,0,16,9,20639220,3658,3420,0,5658
734,14,0,19,6,20679240,3658,3420,0,5672
735,7,0,12,13,20727720,3657,3420,0,5679
736,8,0,17,8,20732640,3656,3420,0,5687
737,14,0,23,2,20748960,3654,3420,0,5701
738,9,0,21,4,20815320,3658,3420,0,5710
739,5,0,15,10,20855760,3658,3420,0,5715
740,4,0,15,10,20878380,3660,3420,0,5719
741,4,0,13,12,20915340,3662,3420,0,5723
742,2,0,10,15,20931000,3662,3420,0,5725
743,4,0,14,11,20931000,3662,3420,0,5729
744,5,0,14,11,20953380,3663,3420,0,5734
745,7,0,14,11,20978340,3663,3420,0,5741
746,5,0,14,11,21004920,3664,3420,0,5746
747,10,0,16,9,21026520,3663,3420,0,5756
748,8,0,15,10,21052620,3661,3420,0,5764
749,12,0,19,6,21073080,3660,3420,0,5776
750,11,0,17,8,21115860,3659,3420,0,5787
751,12,0,19,6,21156600,3660,3420,0,5799
752,3,0,13,12,21190080,3660,3420,0,5802
753,9,0,17,8,21208200,3660,3420,0,5811
754,11,0,19,6,21235260,3659,3420,0,5822
755,10,0,21,4,21278400,3661,3420,0,5832
756,8,0,17,8,21316680,3660,3420,0,5840
757,8,0,15,10,21357300,3661,3420,0,5848
758,9,0,14,11,21377400,3658,3420,0,5857
759,14,0,17,8,21409140,3657,3420,0,5871
760,9,0,20,5,21422880,3655,3420,0,5880
761,7,0,14,11,21471780,3656,3420,0,5887
762,17,0,19,6,21505020,3654,3420,0,5904
763,13,0,20,5,21542700,3653,3420,0,5917
764,5,0,16,9,21583620,3654,3420,0,5922
765,5,0,15,10,21622260,3657,3420,0,5927
766,11,0,19,6,21652500,3658,3420,0,5938
767,4,0,15,10,21684240,3658,3420,0,5942
768,6,0,14,11,21718020,3659,3420,0,5948
769,5,0,13,12,21742620,3660,3420,0,5953
770,2,0,11,14,21755160,3660,3420,0,5955
771,1,0,10,15,21772440,3661,3420,0,5956
772,5,0,13,12,21776160,3661,3420,0,5961
773,15,0,18,7,21801480,3659,3420,0,5976
774,6,0,14,11,21833220,3658,3420,0,5982
775,7,0,14,11,21859260,3658,3420,0,5989
776,13,0,19,6,21885060,3657,3420,0,6002
777,9,0,18,7,21908160,3655,3420,0,6011
778,10,0,17,8,21946800,3655,3420,0,6021
779,12,0,17,8,21981060,3653,3420,0,6033
780,11,0,18,7,22018380,3653,3420,0,6044
781,11,0,20,5,22051860,3653,3420,0,6055
782,11,0,19,6,22093680,3653,3420,0,6066
783,12,1,23,2,22121460,3654,4200,0,6078
784,8,0,19,6,22190520,3657,9180,1,6086
785,12,0,20,5,22236600,3658,9180,1,6098
786,9,0,20,5,22282680,3660,9180,1,6107
787,9,0,17,8,22326000,3660,9180,1,6116
788,9,0,17,8,22354440,3659,9180,1,6125
789,9,0,14,11,22392960,3658,9180,1,6134
790,9,0,21,4,22403640,3659,9180,1,6143
791,7,0,14,11,22455780,3659,9180,1,6150
792,5,0,15,10,22466880,3659,9180,1,6155
793,4,0,13,12,22496820,3660,9180,1,6159
794,3,0,9,16,22522980,3660,9180,1,6162
795,6,0,13,12,22527000,3659,9180,1,6168
796,2,0,13,12,22535160,3660,9180,1,6170
797,3,0,11,14,22562040,3661,9180,1,6173
798,6,0,14,11,22568700,3660,9180,1,6179
799,6,0,15,10,22590660,3661,9180,1,6185
800,13,0,20,5,22624680,3662,9180,1,6198
801,7,0,17,8,22658100,3661,9180,1,6205
802,10,0,18,7,22693560,3662,9180,1,6215
803,11,0,20,5,22725300,3661,9180,1,6226
804,6,0,15,10,22769820,3662,9180,1,6232
805,14,0,20,5,22809000,3663,9180,1,6246
806,7,0,16,9,22847220,3663,9180,1,6253
807,10,0,18,7,22887540,3664,9180,1,6263
808,12,0,16,9,22926120,3662,9180,1,6275
809,4,0,13,12,22958100,3663,9180,1,6279
810,12,0,16,9,22978080,3661,9180,1,6291
811,10,0,20,5,22995120,3661,9180,1,6301
812,13,0,19,6,23049660,3661,9180,1,6314
813,3,0,14,11,23080800,3661,9180,1,6317
814,10,0,18,7,23105760,3662,9180,1,6327
815,9,0,16,9,23143260,3661,9180,1,6336
816,6,0,15,10,23159400,3660,9180,1,6342
817,4,0,13,12,23198100,3663,9180,1,6346
818,4,0,13,12,23212680,3663,9180,1,6350
819,4,0,14,11,23228040,3663,9180,1,6354
820,5,0,12,13,23251500,3663,9180,1,6359
821,5,0,11,14,23266440,3662,9180,1,6364
822,4,0,10,15,23282580,3661,9180,1,6368
823,4,0,12,13,23293380,3662,9180,1,6372
824,14,0,15,10,23309280,3658,9180,1,6386
825,7,0,17,8,23327880,3658,9180,1,6393
826,14,0,23,2,23364840,3659,9180,1,6407
827,15,1,25,0,23406300,3659,12600,1,6422
828,12,0,19,6,23482140,3660,14400,2,6434
829,13,0,22,3,23509860,3659,14400,2,6447
830,10,0,21,4,23542320,3657,14400,2,6457
831,8,0,22,3,23573040,3658,14400,2,6465
832,9,0,20,5,23639520,3662,14400,2,6474
833,10,0,15,10,23681700,3660,14400,2,6484
834,6,0,16,9,23699100,3660,14400,2,6490
835,3,0,12,13,23728380,3661,14400,2,6493
836,13,0,18,7,23741880,3659,14400,2,6506
837,10,0,17,8,23783700,3659,14400,2,6516
838,7,0,15,10,23809680,3658,14400,2,6523
839,7,0,13,12,23854980,3660,14400,2,6530
840,8,0,18,7,23863020,3659,14400,2,6538
841,1,0,10,15,23895120,3659,14400,2,6539
842,6,0,12,13,23906340,3659,14400,2,6545
843,3,0,10,15,23921160,3658,14400,2,6548
844,5,0,14,11,23921700,3658,14400,2,6553
845,3,0,13,12,23935800,3658,14400,2,6556
846,7,0,15,10,23966340,3660,14400,2,6563
847,6,0,13,12,23985780,3658,14400,2,6569
848,8,0,15,10,24008100,3658,14400,2,6577
849,7,0,15,10,24034860,3658,14400,2,6584
850,11,0,18,7,24063660,3658,14400,2,6595
851,13,0,20,5,24094020,3657,14400,2,6608
852,11,0,18,7,24126660,3655,14400,2,6619
853,9,0,18,7,24160080,3655,14400,2,6628
854,12,0,19,6,24199200,3654,14400,2,6640
855,17,0,23,2,24235500,3653,14400,2,6657
856,2,0,13,12,24281340,3653,14400,2,6659
857,10,0,17,8,24319260,3655,14400,2,6669
858,6,0,16,9,24339720,3655,14400,2,6675
859,9,0,16,9,24371340,3654,14400,2,6684
860,5,0,15,10,24391680,3654,14400,2,6689
861,5,0,13,12,24427080,3656,14400,2,6694
862,3,0,13,12,24432060,3655,14400,2,6697
863,6,0,13,12,24455580,3655,14400,2,6703
864,4,0,14,11,24460860,3654,14400,2,6707
865,7,0,11,14,24491760,3653,14400,2,6714
866,6,0,12,13,24511440,3654,14400,2,6720
867,5,0,15,10,24514440,3653,14400,2,6725
868,3,0,13,12,24545700,3655,14400,2,6728
869,5,0,13,12,24561720,3655,14400,2,6733
870,11,0,14,11,24593220,3654,14400,2,6744
871,6,0,16,9,24604320,3653,14400,2,6750
872,13,0,18,7,24634380,3652,14400,2,6763
873,11,0,22,3,24664200,3652,14400,2,6774
874,14,0,21,4,24711780,3651,14400,2,6788
875,6,0,15,10,24757380,3652,14400,2,6794
876,17,0,25,0,24786720,3652,14400,2,6811
877,5,0,18,7,24823920,3651,14400,2,6816
878,15,3,25,0,24845160,3652,14400,2,6831
879,8,0,21,4,24909060,3653,15660,2,6839
880,13,0,21,4,24966360,3654,15660,2,6852
881,11,0,25,0,24990000,3654,15660,2,6863
882,10,0,16,9,25063620,3655,15660,2,6873
883,10,0,17,8,25097640,3655,15660,2,6883
884,5,0,17,8,25118520,3655,15660,2,6888
885,7,0,15,10,25156560,3656,15660,2,6895
886,6,0,13,12,25186320,3656,15660,2,6901
887,3,0,13,12,25198260,3656,15660,2,6904
888,4,0,12,13,25215300,3656,15660,2,6908
889,4,0,12,13,25239420,3657,15660,2,6912
890,2,0,10,15,25263300,3659,15660,2,6914
891,7,0,16,9,25268700,3659,15660,2,6921
892,3,0,11,14,25288920,3658,15660,2,6924
893,3,0,13,12,25295820,3658,15660,2,6927
894,12,0,18,7,25313400,3657,15660,2,6939
895,4,0,15,10,25346220,3658,15660,2,6943
896,7,0,14,11,25386720,3660,15660,2,6950
897,11,0,17,8,25402380,3658,15660,2,6961
898,9,0,14,11,25438440,3657,15660,2,6970
899,10,0,16,9,25459380,3655,15660,2,6980
900,6,0,15,10,25482240,3655,15660,2,6986
901,12,0,21,4,25503240,3655,15660,2,6998
902,9,0,14,11,25542540,3652,15660,2,7007
903,14,0,19,6,25579500,3653,15660,2,7021
904,10,0,18,7,25620000,3653,15660,2,7031
905,5,0,15,10,25646220,3652,15660,2,7036
906,10,0,13,12,25693140,3653,15660,2,7046
907,8,0,13,12,25717200,3652,15660,2,7054
908,10,0,17,8,25729080,3651,15660,2,7064
909,10,0,17,8,25766100,3651,15660,2,7074
910,5,0,20,5,25782360,3652,15660,2,7079
911,3,0,15,10,25822800,3653,15660,2,7082
912,8,0,17,8,25855980,3655,15660,2,7090
913,5,0,14,11,25884900,3655,15660,2,7095
914,7,0,15,10,25903920,3655,15660,2,7102
915,8,0,17,8,25925760,3655,15660,2,7110
916,10,0,14,11,25964640,3653,15660,2,7120
917,7,0,11,14,25991280,3652,15660,2,7127
918,8,0,14,11,26005740,3651,15660,2,7135
919,5,0,12,13,26024100,3650,15660,2,7140
920,11,0,16,9,26049480,3650,15660,2,7151
921,5,0,15,10,26066220,3650,15660,2,7156
922,12,0,18,7,26097720,3650,15660,2,7168
923,7,0,15,10,26127600,3649,15660,2,7175
924,6,0,15,10,26149860,3649,15660,2,7181
925,7,0,19,6,26166360,3649,15660,2,7188
926,10,0,20,5,26209020,3651,15660,2,7198
927,10,0,21,4,26225700,3649,15660,2,7208
928,9,0,13,12,26304120,3651,15720,2,7217
929,7,0,15,10,26316180,3650,15720,2,7224
930,10,0,18,7,26337900,3649,15720,2,7234
931,12,0,16,9,26379720,3648,15720,2,7246
932,12,0,17,8,26413200,3647,15720,2,7258
933,6,0,15,10,26441820,3647,15720,2,7264
934,8,0,12,13,26478720,3647,15720,2,7272
935,3,0,12,13,26491620,3647,15720,2,7275
936,8,0,12,13,26515560,3646,15720,2,7283
937,6,0,14,11,26526300,3646,15720,2,7289
938,4,0,13,12,26545500,3646,15720,2,7293
939,4,0,12,13,26566800,3646,15720,2,7297
940,7,0,12,13,26583420,3645,15720,2,7304
941,4,0,11,14,26602680,3645,15720,2,7308
942,8,0,18,7,26605680,3645,15720,2,7316
943,13,0,21,4,26639520,3645,15720,2,7329
944,9,0,17,8,26691780,3645,15720,2,7338
945,8,0,16,9,26719680,3645,15720,2,7346
946,13,0,22,3,26745660,3645,15720,2,7359
947,10,0,15,10,26802960,3644,15720,2,7369
948,11,0,18,7,26828820,3644,15720,2,7380
949,7,0,15,10,26861880,3643,15720,2,7387
950,11,0,18,7,26893200,3644,15720,2,7398
951,13,0,18,7,26934300,3643,15720,2,7411
952,12,0,18,7,26963100,3641,15720,2,7423
953,9,0,20,5,26983740,3640,15720,2,7432
954,8,0,16,9,27041820,3642,15720,2,7440
955,6,0,16,9,27062640,3642,15720,2,7446
956,12,0,20,5,27090660,3642,15720,2,7458
957,3,0,12,13,27143220,3643,15720,2,7461
958,5,0,14,11,27156240,3644,15720,2,7466
959,10,0,18,7,27188340,3645,15720,2,7476
960,6,0,14,11,27223980,3645,15720,2,7482
961,9,0,17,8,27247620,3645,15720,2,7491
962,6,0,15,10,27277680,3645,15720,2,7497
963,5,0,12,13,27304740,3645,15720,2,7502
964,4,0,13,12,27319620,3646,15720,2,7506
965,1,0,10,15,27341100,3646,15720,2,7507
966,7,0,15,10,27343080,3646,15720,2,7514
967,14,0,25,0,27355680,3645,15720,2,7528
968,14,0,25,0,27398400,3644,16020,2,7542
969,9,0,19,6,27456120,3645,17520,2,7551
970,9,0,19,6,27509760,3648,17520,2,7560
971,12,0,21,4,27538380,3646,17520,2,7572
972,11,0,20,5,27582720,3647,17520,2,7583
973,12,0,19,6,27619380,3645,17520,2,7595
974,4,0,13,12,27664560,3646,17520,2,7599
975,7,0,15,10,27680760,3646,17520,2,7606
976,7,0,17,8,27697560,3646,17520,2,7613
977,12,0,19,6,27735900,3646,17520,2,7625
978,7,0,16,9,27771300,3646,17520,2,7632
979,7,0,11,14,27808740,3645,17520,2,7639
980,3,0,11,14,27817860,3645,17520,2,7642
981,7,0,11,14,27837240,3644,17520,2,7649
982,9,0,14,11,27849300,3643,17520,2,7658
983,3,0,13,12,27864060,3643,17520,2,7661
984,5,0,14,11,27886080,3644,17520,2,7666
985,6,0,13,12,27906180,3643,17520,2,7672
986,2,0,9,16,27922920,3642,17520,2,7674
987,1,0,9,16,27924300,3642,17520,2,7675
988,3,0,11,14,27926580,3642,17520,2,7678
989,10,0,18,7,27929580,3641,17520,2,7688
990,8,0,16,9,27961200,3640,17520,2,7696
991,9,0,15,10,27994140,3640,17520,2,7705
992,7,0,13,12,28021860,3639,17520,2,7712
993,7,0,14,11,28036620,3638,17520,2,7719
994,16,0,24,1,28057860,3638,17520,2,7735
995,12,0,22,3,28099920,3637,18720,2,7747
996,9,0,18,7,28147260,3637,18720,2,7756
997,9,0,20,5,28171500,3637,18720,2,7765
998,14,0,18,7,28230420,3637,18720,2,7779
999,9,0,18,7,28259700,3637,18720,2,7788
1000,11,0,20,5,28304460,3638,18720,2,7799
1001,13,1,25,0,28323120,3637,18780,2,7812
1002,10,0,22,3,28393020,3640,19620,2,7822
1003,9,0,15,10,28448100,3639,19620,2,7831
1004,3,0,12,13,28476540,3640,19620,2,7834
1005,6,0,12,13,28500240,3640,19620,2,7840
1006,1,0,12,13,28505220,3640,19620,2,7841
1007,8,0,17,8,28514100,3640,19620,2,7849
1008,10,0,15,10,28546620,3639,19620,2,7859
1009,8,0,15,10,28582260,3640,19620,2,7867
1010,4,0,14,11,28601100,3640,19620,2,7871
1011,6,0,15,10,28626600,3641,19620,2,7877
1012,9,0,17,8,28653300,3641,19620,2,7886
1013,6,0,15,10,28686720,3641,19620,2,7892
1014,9,0,16,9,28717740,3642,19620,2,7901
1015,10,0,19,6,28732020,3640,19620,2,7911
1016,11,0,20,5,28776060,3641,19620,2,7922
1017,10,0,18,7,28812720,3640,19620,2,7932
1018,12,0,16,9,28856400,3639,19620,2,7944
1019,10,0,17,8,28885620,3639,19620,2,7954
1020,7,0,14,11,28921320,3639,19620,2,7961
1021,6,0,12,13,28946820,3638,19620,2,7967
1022,8,0,15,10,28969680,3639,19620,2,7975
1023,8,0,18,7,28978200,3638,19620,2,7983
1024,12,0,19,6,29012280,3637,19620,2,7995
1025,7,0,15,10,29064240,3638,19620,2,8002
1026,9,0,18,7,29092560,3639,19620,2,8011
1027,13,0,19,6,29135280,3639,19620,2,8024
1028,9,0,17,8,29167560,3638,19620,2,8033
1029,12,0,19,6,29211600,3639,19620,2,8045
1030,7,0,14,11,29255220,3639,19620,2,8052
1031,4,0,16,9,29263620,3639,19620,2,8056
1032,6,0,12,13,29307540,3640,19620,2,8062
1033,6,0,12,13,29320800,3639,19620,2,8068
1034,4,0,12,13,29336220,3639,19620,2,8072
1035,5,0,12,13,29350440,3639,19620,2,8077
1036,11,0,19,6,29365680,3639,19620,2,8088
1037,8,0,18,7,29405220,3640,19620,2,8096
1038,14,0,22,3,29439840,3639,20040,2,8110
1039,16,0,25,0,29495520,3640,26100,3,8126
1040,8,0,22,3,29552100,3643,27000,3,8134
1041,9,0,19,6,29609400,3644,27000,3,8143
1042,7,0,20,5,29647740,3646,27000,3,8150
1043,10,0,18,7,29692740,3646,27000,3,8160
1044,10,0,17,8,29729820,3646,27000,3,8170
1045,13,0,25,0,29750280,3646,27000,3,8183
1046,6,0,19,6,29790240,3646,27000,3,8189
1047,8,0,18,7,29831040,3647,27000,3,8197
1048,4,0,15,10,29863980,3648,27000,3,8201
1049,9,0,19,6,29892720,3649,27000,3,8210
1050,0,0,9,16,29941320,3650,27000,3,8210
1051,14,0,16,9,29957760,3649,27000,3,8224
1052,7,0,17,8,29973240,3649,27000,3,8231
1053,9,0,18,7,30007440,3649,27000,3,8240
1054,5,0,17,8,30037440,3650,27000,3,8245
1055,9,0,15,10,30083820,3651,27000,3,8254
1056,5,0,16,9,30095580,3651,27000,3,8259
1057,5,0,16,9,30128940,3652,27000,3,8264
1058,7,0,15,10,30162720,3653,27000,3,8271
1059,3,0,11,14,30185280,3653,27000,3,8274
1060,6,0,12,13,30205020,3653,27000,3,8280
1061,4,0,14,11,30208980,3652,27000,3,8284
1062,18,0,19,6,30243240,3651,27000,3,8302
1063,3,0,18,7,30266580,3652,27000,3,8305
1064,6,0,14,11,30311220,3653,27000,3,8311
1065,12,0,17,8,30345720,3653,27000,3,8323
1066,9,0,19,6,30374100,3653,27000,3,8332
1067,12,0,25,0,30396540,3653,27000,3,8344
1068,11,0,23,2,30449580,3654,27000,3,8355
1069,12,0,21,4,30513780,3656,27000,3,8367
1070,13,0,20,5,30573720,3657,27000,3,8380
1071,9,0,17,8,30616140,3656,27000,3,8389
1072,14,0,22,3,30640500,3655,27000,3,8403
1073,8,0,16,9,30694740,3656,27000,3,8411
1074,7,0,16,9,30738420,3658,27000,3,8418
1075,8,0,17,8,30768840,3659,27000,3,8426
1076,9,0,16,9,30807240,3659,27000,3,8435
1077,7,0,17,8,30824880,3658,27000,3,8442
1078,4,0,12,13,30864960,3659,27000,3,8446
1079,7,0,14,11,30884400,3659,27000,3,8453
1080,3,0,13,12,30896460,3659,27000,3,8456
1081,6,0,13,12,30919740,3659,27000,3,8462
1082,4,0,12,13,30935940,3659,27000,3,8466
1083,4,0,12,13,30955560,3659,27000,3,8470
1084,6,0,15,10,30962160,3659,27000,3,8476
1085,10,0,14,11,30994740,3658,27000,3,8486
1086,6,0,14,11,31011180,3657,27000,3,8492
1087,10,0,16,9,31029960,3656,27000,3,8502
1088,7,0,17,8,31052460,3656,27000,3,8509
1089,4,0,15,10,31070940,3656,27000,3,8513
1090,11,0,17,8,31110900,3657,27000,3,8524
1091,7,0,20,5,31127340,3657,27000,3,8531
1092,10,0,16,9,31179840,3657,27000,3,8541
1093,9,0,17,8,31198380,3656,27000,3,8550
1094,8,0,13,12,31247820,3656,27000,3,8558
1095,4,0,14,11,31263180,3657,27000,3,8562
1096,9,0,14,11,31283520,3655,27000,3,8571
1097,8,0,16,9,31305600,3655,27000,3,8579
1098,10,0,20,5,31330500,3656,27000,3,8589
1099,8,0,18,7,31381260,3657,27000,3,8597
1100,6,0,14,11,31418760,3658,27000,3,8603
1101,7,0,15,10,31445040,3658,27000,3,8610
1102,7,0,15,10,31463460,3657,27000,3,8617
1103,12,0,15,10,31492800,3656,27000,3,8629
1104,5,0,15,10,31512120,3656,27000,3,8634
1105,4,0,13,12,31536360,3656,27000,3,8638
1106,5,0,14,11,31558140,3657,27000,3,8643
1107,5,0,9,16,31583040,3655,27000,3,8648
1108,12,0,18,7,31588380,3655,27000,3,8660
1109,5,0,17,8,31606980,3654,27000,3,8665
1110,10,0,17,8,31629660,3653,27000,3,8675
1111,13,0,18,7,31665240,3652,27000,3,8688
1112,10,0,17,8,31717140,3653,27000,3,8698
1113,7,0,16,9,31747380,3653,27000,3,8705
1114,9,0,17,8,31779420,3654,27000,3,8714
1115,18,0,25,0,31808640,3653,27000,3,8732
1116,17,0,25,0,31870980,3653,29640,3,8749
1117,11,0,16,9,31930800,3651,30120,3,8760
1118,9,0,18,7,31963320,3652,30120,3,8769
1119,10,0,21,4,31977120,3651,30120,3,8779
1120,13,0,23,2,32009760,3650,30120,3,8792
1121,10,0,18,7,32084040,3652,30120,3,8802
1122,9,0,20,5,32110260,3652,30120,3,8811
1123,7,0,16,9,32155800,3653,30120,3,8818
1124,13,0,19,6,32193180,3653,30120,3,8831
1125,1,0,9,16,32236560,3653,30120,3,8832
1126,1,0,10,15,32236560,3653,30120,3,8833
1127,3,0,11,14,32247300,3654,30120,3,8836
1128,9,0,15,10,32264100,3653,30120,3,8845
1129,2,0,10,15,32280720,3652,30120,3,8847
1130,6,0,12,13,32290440,3652,30120,3,8853
1131,9,0,17,8,32297640,3651,30120,3,8862
1132,5,0,13,12,32337000,3652,30120,3,8867
1133,7,0,16,9,32353200,3652,30120,3,8874
1134,5,0,14,11,32375700,3652,30120,3,8879
1135,12,0,15,10,32407380,3651,30120,3,8891
1136,9,0,18,7,32425800,3650,30120,3,8900
1137,11,0,17,8,32483040,3652,30120,3,8911
1138,7,0,18,7,32504340,3652,30120,3,8918
1139,8,0,17,8,32527980,3651,30120,3,8926
1140,6,0,13,12,32578260,3652,30120,3,8932
1141,9,0,20,5,32587020,3652,30120,3,8941
1142,6,0,15,10,32627700,3652,30120,3,8947
1143,10,0,17,8,32660760,3653,30120,3,8957
1144,8,0,18,7,32689080,3653,30120,3,8965
1145,13,0,23,2,32720160,3653,30120,3,8978
1146,8,0,19,6,32765220,3653,30120,3,8986
1147,4,0,13,12,32814780,3655,30120,3,8990
1148,7,0,13,12,32837820,3655,30120,3,8997
1149,2,0,11,14,32859420,3655,30120,3,8999
1150,3,0,13,12,32861820,3655,30120,3,9002
1151,8,0,15,10,32888460,3656,30120,3,9010
1152,8,0,17,8,32898000,3654,30120,3,9018
1153,4,0,13,12,32929380,3655,30120,3,9022
1154,3,0,11,14,32957160,3656,30120,3,9025
1155,6,0,14,11,32963940,3655,30120,3,9031
1156,6,0,15,10,32981280,3655,30120,3,9037
1157,8,0,16,9,33012000,3656,30120,3,9045
1158,8,0,16,9,33042720,3656,30120,3,9053
1159,7,0,13,12,33075180,3655,30120,3,9060
1160,4,0,11,14,33106620,3656,30120,3,9064
1161,10,0,16,9,33120840,3656,30120,3,9074
1162,8,0,19,6,33131820,3655,30120,3,9082
1163,12,0,20,5,33171960,3655,30120,3,9094
1164,12,0,23,2,33198900,3655,30120,3,9106
1165,16,0,22,3,33264420,3655,30120,3,9122
1166,5,0,18,7,33309780,3656,30120,3,9127
1167,8,0,16,9,33351840,3657,30120,3,9135
1168,7,0,14,11,33367920,3655,30120,3,9142
1169,8,0,17,8,33391020,3656,30120,3,9150
1170,4,0,18,7,33396120,3655,30120,3,9154
1171,7,0,16,9,33431940,3655,30120,3,9161
1172,6,0,15,10,33479220,3658,30120,3,9167
1173,5,0,16,9,33495360,3658,30120,3,9172
1174,6,0,16,9,33523560,3658,30120,3,9178
1175,8,0,17,8,33550020,3659,30120,3,9186
1176,2,0,13,12,33579960,3659,30120,3,9188
1177,6,0,13,12,33610320,3660,30120,3,9194
1178,5,0,14,11,33624060,3660,30120,3,9199
1179,6,0,13,12,33645180,3660,30120,3,9205
1180,4,0,12,13,33667800,3660,30120,3,9209
1181,13,0,17,8,33685020,3659,30120,3,9222
1182,11,0,14,11,33719820,3657,30120,3,9233
1183,14,0,19,6,33750480,3657,30120,3,9247
1184,7,0,12,13,33792480,3656,30120,3,9254
1185,9,0,14,11,33820260,3656,30120,3,9263
1186,9,0,15,10,33840300,3655,30120,3,9272
1187,11,0,18,7,33855840,3654,30120,3,9283
1188,11,0,19,6,33888540,3653,30120,3,9294
1189,9,0,18,7,33925200,3653,30120,3,9303
1190,10,0,19,6,33960720,3654,30120,3,9313
1191,5,0,16,9,33995400,3654,30120,3,9318
1192,12,0,19,6,34027320,3654,30120,3,9330
1193,8,0,16,9,34066620,3654,30120,3,9338
1194,12,0,17,8,34101240,3653,30120,3,9350
1195,7,0,16,9,34132020,3654,30120,3,9357
1196,9,0,19,6,34149540,3653,30120,3,9366
1197,6,0,15,10,34196460,3654,30120,3,9372
1198,5,0,14,11,34229640,3655,30120,3,9377
1199,6,0,12,13,34254780,3655,30120,3,9383
1200,4,0,12,13,34276680,3656,30120,3,9387
1201,5,0,15,10,34285380,3656,30120,3,9392
1202,7,0,13,12,34310760,3655,30120,3,9399
1203,4,0,11,14,34333080,3655,30120,3,9403
1204,4,0,13,12,34341900,3655,30120,3,9407
1205,6,0,13,12,34352220,3654,30120,3,9413
1206,7,0,14,11,34372740,3654,30120,3,9420
1207,5,0,15,10,34386720,3654,30120,3,9425
1208,8,0,16,9,34407360,3653,30120,3,9433
1209,18,0,25,0,34431780,3652,30120,3,9451
1210,7,0,24,1,34461660,3652,30300,3,9458
1211,11,0,21,4,34528020,3654,30300,3,9469
1212,8,0,21,4,34561740,3655,30300,3,9477
1213,10,0,18,7,34607520,3654,30300,3,9487
1214,6,0,13,12,34648920,3654,30300,3,9493
1215,11,0,19,6,34663500,3654,30300,3,9504
1216,11,0,24,1,34682820,3654,30300,3,9515
1217,7,0,16,9,34757700,3656,30300,3,9522
1218,6,0,14,11,34802640,3658,30300,3,9528
1219,8,0,15,10,34824540,3657,30300,3,9536
1220,5,0,15,10,34845780,3657,30300,3,9541
1221,6,0,13,12,34879680,3658,30300,3,9547
1222,9,0,17,8,34891320,3657,30300,3,9556
1223,4,0,15,10,34917060,3658,30300,3,9560
1224,4,0,12,13,34949340,3658,30300,3,9564
1225,4,0,11,14,34967100,3658,30300,3,9568
1226,4,0,9,16,34982640,3658,30300,3,9572
1227,8,0,13,12,34987200,3657,30300,3,9580
1228,5,0,15,10,34996860,3656,30300,3,9585
1229,7,0,17,8,35019780,3657,30300,3,9592
1230,6,0,16,9,35044980,3657,30300,3,9598
1231,5,0,12,13,35086200,3658,30300,3,9603
1232,7,0,14,11,35103240,3658,30300,3,9610
1233,11,0,20,5,35115780,3657,30300,3,9621
1234,11,0,17,8,35175840,3658,30360,3,9632
1235,8,0,16,9,35208180,3658,30360,3,9640
1236,7,0,18,7,35230920,3658,30360,3,9647
1237,12,0,21,4,35260140,3658,30360,3,9659
1238,8,0,16,9,35310060,3658,30360,3,9667
1239,4,0,14,11,35327520,3658,30360,3,9671
1240,5,0,13,12,35357760,3659,30360,3,9676
1241,11,0,18,7,35366220,3657,30360,3,9687
1242,11,0,20,5,35399340,3657,30360,3,9698
1243,8,0,16,9,35450220,3658,30360,3,9706
1244,5,0,14,11,35468640,3657,30360,3,9711
1245,5,0,14,11,35498340,3658,30360,3,9716
1246,3,0,11,14,35521740,3659,30360,3,9719
1247,5,0,10,15,35535120,3658,30360,3,9724
1248,4,0,13,12,35535960,3657,30360,3,9728
1249,7,0,14,11,35565900,3658,30360,3,9735
1250,8,0,14,11,35584980,3657,30360,3,9743
1251,4,0,13,12,35601060,3657,30360,3,9747
1252,7,0,12,13,35628360,3657,30360,3,9754
1253,4,0,13,12,35636280,3656,30360,3,9758
1254,10,0,16,9,35653080,3655,30360,3,9768
1255,11,0,19,6,35678940,3655,30360,3,9779
1256,10,0,17,8,35717700,3655,30360,3,9789
1257,18,2,25,0,35743380,3654,30360,3,9807
1258,9,0,20,5,35812320,3655,31440,3,9816
1259,3,0,13,12,35854980,3656,31440,3,9819
1260,8,0,17,8,35872260,3656,31440,3,9827
1261,10,0,14,11,35906280,3655,31440,3,9837
1262,11,0,16,9,35932980,3654,31440,3,9848
1263,4,0,12,13,35956260,3654,31440,3,9852
1264,9,0,14,11,35991420,3655,31440,3,9861
1265,14,0,18,7,36017520,3654,31440,3,9875
1266,7,0,14,11,36045360,3652,31440,3,9882
1267,5,0,16,9,36061560,3653,31440,3,9887
1268,9,0,16,9,36090360,3652,31440,3,9896
1269,8,0,15,10,36123180,3652,31440,3,9904
1270,7,0,16,9,36143760,3652,31440,3,9911
1271,5,0,11,14,36182520,3652,31440,3,9916
1272,4,0,12,13,36192000,3652,31440,3,9920
1273,3,0,11,14,36207720,3652,31440,3,9923
1274,4,0,10,15,36217980,3652,31440,3,9927
1275,8,0,16,9,36223080,3651,31440,3,9935
1276,8,0,16,9,36245100,3651,31440,3,9943
1277,5,0,14,11,36280860,3652,31440,3,9948
1278,7,0,14,11,36307740,3652,31440,3,9955
1279,8,0,20,5,36317220,3652,31440,3,9963
1280,4,0,19,6,36345840,3653,31440,3,9967
1281,9,0,13,12,36400560,3653,31440,3,9976
1282,8,0,13,12,36426960,3653,31440,3,9984
1283,10,0,16,9,36446760,3652,31440,3,9994
1284,14,0,22,3,36469740,3652,31440,3,10008
1285,7,0,19,6,36511500,3652,31440,3,10015
1286,11,0,21,4,36550860,3653,31440,3,10026
1287,14,0,17,8,36604200,3652,31440,3,10040
1288,8,0,18,7,36637260,3652,31440,3,10048
1289,17,2,25,0,36653880,3651,31680,3,10065
1290,5,0,18,7,36721560,3653,32160,3,10070
1291,9,0,18,7,36763080,3654,32160,3,10079
1292,5,0,15,10,36796500,3654,32160,3,10084
1293,8,0,17,8,36825120,3655,32160,3,10092
1294,7,0,15,10,36860220,3655,32160,3,10099
1295,6,0,14,11,36892680,3655,32160,3,10105
1296,8,0,14,11,36920100,3655,32160,3,10113
1297,4,0,14,11,36934980,3655,32160,3,10117
1298,5,0,13,12,36960360,3656,32160,3,10122
1299,5,0,13,12,36977700,3656,32160,3,10127
1300,3,0,13,12,36985560,3655,32160,3,10130
1301,10,0,16,9,37014660,3656,32160,3,10140
1302,8,0,18,7,37037280,3656,32160,3,10148
1303,7,0,19,6,37060980,3656,32160,3,10155
1304,6,0,16,9,37102800,3657,32160,3,10161
1305,10,0,18,7,37141440,3658,32160,3,10171
1306,7,0,19,6,37171260,3658,32160,3,10178
1307,5,0,16,9,37211160,3659,32160,3,10183
1308,12,0,17,8,37239840,3658,32160,3,10195
1309,16,0,24,1,37275000,3659,35280,3,10211
1310,15,6,25,0,37323900,3661,35820,3,10226
1311,12,2,25,0,37400760,3662,56040,5,10238
1312,9,0,19,6,37456620,3662,58740,5,10247
1313,11,0,20,5,37503840,3663,58740,5,10258
1314,5,0,15,10,37544100,3663,58740,5,10263
1315,8,0,17,8,37571100,3664,58740,5,10271
1316,7,0,14,11,37598400,3663,58740,5,10278
1317,7,0,18,7,37612860,3663,58740,5,10285
1318,7,0,16,9,37657500,3664,58740,5,10292
1319,4,0,12,13,37687080,3664,58740,5,10296
1320,4,0,14,11,37695840,3664,58740,5,10300
1321,5,0,11,14,37724880,3664,58740,5,10305
1322,4,0,12,13,37737480,3664,58740,5,10309
1323,6,0,16,9,37745520,3664,58740,5,10315
1324,6,0,10,15,37773840,3663,58740,5,10321
1325,3,0,10,15,37784280,3663,58740,5,10324
1326,3,0,12,13,37785300,3663,58740,5,10327
1327,10,0,17,8,37793700,3662,58740,5,10337
1328,9,0,18,7,37829160,3662,58740,5,10346
1329,5,0,17,8,37861020,3663,58740,5,10351
1330,11,0,19,6,37884720,3662,58740,5,10362
1331,10,0,16,9,37939320,3663,58740,5,10372
1332,9,0,15,10,37972020,3663,58740,5,10381
1333,12,0,19,6,37996140,3662,58740,5,10393
1334,8,0,17,8,38025900,3661,58740,5,10401
1335,15,0,17,8,38067240,3660,58740,5,10416
1336,8,0,14,11,38097660,3659,58740,5,10424
1337,7,0,14,11,38116620,3659,58740,5,10431
1338,9,0,18,7,38137140,3659,58740,5,10440
1339,3,0,14,11,38177580,3660,58740,5,10443
1340,13,0,16,9,38213640,3660,58740,5,10456
1341,5,0,12,13,38240820,3659,58740,5,10461
1342,3,0,11,14,38259480,3660,58740,5,10464
1343,1,0,11,14,38264340,3660,58740,5,10465
1344,3,0,13,12,38269380,3660,58740,5,10468
1345,9,0,18,7,38274360,3659,58740,5,10477
1346,8,0,19,6,38290140,3658,58740,5,10485
1347,5,0,21,4,38306520,3659,58740,5,10490
1348,1,0,16,9,38348460,3660,58740,5,10491
1349,7,0,17,8,38368740,3660,58740,5,10498
1350,11,0,18,7,38387220,3659,58740,5,10509
1351,11,0,22,3,38411880,3658,58740,5,10520
1352,5,0,17,8,38450100,3659,58740,5,10525
1353,13,0,24,1,38469180,3658,58740,5,10538
1354,10,0,21,4,38511060,3658,59220,5,10548
1355,11,0,23,2,38544660,3658,59880,5,10559
1356,8,0,21,4,38590260,3659,59880,5,10567
1357,10,0,24,1,38617800,3659,59880,5,10577
1358,7,0,22,3,38658120,3660,60540,5,10584
1359,11,0,21,4,38709960,3660,61260,5,10595
1360,11,0,23,2,38739240,3660,61680,5,10606
1361,10,0,20,5,38780280,3659,61680,5,10616
1362,12,0,22,3,38815800,3659,62160,5,10628
1363,10,0,21,4,38842980,3658,62160,5,10638
1364,13,0,21,4,38890380,3658,62400,5,10651
1365,6,0,21,4,38909400,3658,62400,5,10657
1366,4,0,18,7,38943420,3659,62400,5,10661
1367,3,0,16,9,38965140,3659,62400,5,10664
1368,2,0,14,11,38983020,3659,62400,5,10666
1369,3,0,15,10,38993220,3659,62400,5,10669
1370,4,0,16,9,39003060,3659,62400,5,10673
1371,5,0,18,7,39013740,3659,62400,5,10678
1372,7,0,19,6,39036660,3659,62400,5,10685
1373,4,0,14,11,39060120,3659,62400,5,10689
1374,3,0,15,10,39072840,3659,62400,5,10692
1375,10,0,18,7,39085680,3658,62400,5,10702
1376,8,0,19,6,39100920,3657,62400,5,10710
1377,10,0,23,2,39126420,3657,62400,5,10720
1378,5,0,17,8,39167280,3657,62400,5,10725
1379,7,0,18,7,39192660,3658,62400,5,10732
1380,10,0,24,1,39210180,3658,62640,5,10742
1381,12,0,23,2,39261300,3658,62640,5,10754
1382,10,0,22,3,39285900,3657,62640,5,10764
1383,10,0,22,3,39337860,3658,62640,5,10774
1384,6,0,19,6,39374040,3658,62640,5,10780
1385,10,0,17,8,39409740,3658,62640,5,10790
1386,11,0,25,0,39423060,3658,62640,5,10801
1387,8,0,20,5,39456420,3657,62640,5,10809
1388,8,0,21,4,39484200,3657,62640,5,10817
1389,5,0,16,9,39520200,3657,62640,5,10822
1390,8,0,18,7,39541740,3657,62640,5,10830
1391,5,0,16,9,39561780,3656,62640,5,10835
1392,4,0,16,9,39583980,3657,62640,5,10839
1393,5,0,14,11,39599160,3656,62640,5,10844
1394,4,0,15,10,39608160,3656,62640,5,10848
1395,5,0,20,5,39608160,3656,62640,5,10853
1396,13,2,25,0,39631260,3656,62640,5,10866
1397,3,0,19,6,39676980,3656,65100,5,10869
1398,6,0,18,7,39706620,3657,65100,5,10875
1399,7,0,18,7,39732780,3657,65100,5,10882
1400,8,0,21,4,39741900,3656,65100,5,10890
1401,12,6,20,5,39765600,3656,65940,6,10902
1402,9,0,25,0,39817980,3657,89340,8,10911
1403,11,0,21,4,39854460,3656,89340,8,10922
1404,8,0,21,4,39881220,3655,89340,8,10930
1405,6,0,16,9,39911580,3654,89340,8,10936
1406,4,0,16,9,39926160,3654,89340,8,10940
1407,11,0,22,3,39933660,3653,89340,8,10951
1408,11,1,25,0,39951060,3653,89340,8,10962
1409,13,1,25,0,40009200,3654,101040,9,10975
1410,10,0,19,6,40054800,3652,105840,9,10985
1411,8,0,18,7,40082820,3652,105840,9,10993
1412,10,0,20,5,40098780,3650,105840,9,11003
1413,4,0,20,5,40113660,3651,105840,9,11007
1414,3,0,18,7,40144560,3652,105840,9,11010
1415,5,0,15,10,40176600,3652,105840,9,11015
1416,5,0,15,10,40187160,3651,105840,9,11020
1417,6,0,17,8,40192980,3650,105840,9,11026
1418,6,0,20,5,40197540,3650,105840,9,11032
1419,6,0,20,5,40232460,3651,105840,9,11038
1420,9,0,23,2,40255080,3651,105840,9,11047
1421,7,1,19,6,40286100,3651,106260,9,11054
1422,4,0,18,7,40311420,3651,106440,9,11058
1423,8,0,21,4,40342440,3652,106440,9,11066
1424,9,0,22,3,40365960,3652,106440,9,11075
1425,10,0,20,5,40409640,3652,106440,9,11085
1426,10,0,23,2,40435140,3652,107400,9,11095
1427,8,0,19,6,40472160,3651,107400,9,11103
1428,14,0,24,1,40509120,3651,107400,9,11117
1429,12,1,25,0,40529520,3650,107940,9,11129
1430,6,0,17,8,40587180,3650,108360,9,11135
1431,9,0,20,5,40609020,3650,108360,9,11144
1432,11,2,25,0,40636800,3651,108360,9,11155
1433,9,0,25,0,40682880,3652,119640,10,11164
1434,11,0,20,5,40730760,3651,119640,10,11175
1435,5,0,16,9,40766100,3651,119640,10,11180
1436,4,0,18,7,40773660,3651,119640,10,11184
1437,2,0,14,11,40805640,3652,119640,10,11186
1438,4,0,16,9,40816800,3652,119640,10,11190
1439,10,0,17,8,40833900,3651,119640,10,11200
1440,6,0,17,8,40852980,3651,119640,10,11206
1441,5,0,17,8,40863840,3650,119640,10,11211
1442,6,0,15,10,40895760,3650,119640,10,11217
1443,6,0,18,7,40902360,3650,119640,10,11223
1444,4,0,18,7,40918320,3650,119640,10,11227
1445,2,0,14,11,40943400,3650,119640,10,11229
1446,4,0,16,9,40951920,3650,119640,10,11233
1447,12,0,23,2,40958760,3649,119640,10,11245
1448,6,0,21,4,40990500,3650,119640,10,11251
1449,14,1,25,0,41014080,3649,120540,10,11265
1450,14,7,25,0,41058480,3650,125940,11,11279
1451,15,10,25,0,41118720,3652,139200,12,11294
1452,13,14,20,5,41152260,3650,160320,14,11307
1453,14,25,20,5,41173920,3651,166740,14,11321
1454,10,25,25,0,41217420,3653,205800,18,11331
1455,11,29,25,0,41252820,3654,228780,20,11342
1456,10,31,25,0,41295300,3655,253800,22,11352
1457,11,31,25,0,41345220,3656,329100,28,11363
1458,11,33,25,0,41389200,3657,342120,30,11374
1459,12,37,25,0,41428860,3658,363420,31,11386
1460,3,24,25,0,41491500,3658,596100,52,11389
1461,5,0,19,6,41544780,3652,1072920,94,11394
1462,7,0,21,4,41567280,3652,1072920,94,11401
1463,6,0,16,9,41608080,3652,1072920,94,11407
1464,3,0,17,8,41620200,3653,1072920,94,11410
1465,5,0,15,10,41647440,3653,1072920,93,11415
1466,4,0,17,8,41651040,3652,1072920,93,11419
1467,1,0,13,12,41674080,3653,1072920,93,11420
1468,4,0,13,12,41681520,3652,1072920,93,11424
1469,7,0,18,7,41684280,3652,1072920,93,11431
1470,5,0,19,6,41694540,3651,1072920,93,11436
1471,6,0,18,7,41728200,3652,1072920,93,11442
1472,9,0,22,3,41739840,3652,1072920,93,11451
1473,10,0,19,6,41778540,3651,1072920,93,11461
1474,15,1,25,0,41796480,3650,1072920,93,11476
1475,16,12,20,5,41824920,3649,1075920,93,11492
1476,9,14,20,5,41877480,3651,1099260,95,11501
1477,13,21,25,0,41881920,3652,1106100,96,11514
1478,14,25,25,0,41946840,3654,1136700,98,11528
1479,7,22,25,0,41990160,3655,1157580,100,11535
1480,7,15,25,0,42043500,3655,1250520,108,11542
1481,10,0,21,4,42104940,3651,1448880,125,11552
1482,5,0,17,8,42126000,3650,1448880,125,11557
1483,9,0,18,7,42158280,3650,1448880,125,11566
1484,8,0,23,2,42160740,3649,1448880,125,11574
1485,5,0,21,4,42188880,3650,1448880,125,11579
1486,6,0,18,7,42228600,3650,1448880,125,11585
1487,2,0,15,10,42248400,3650,1448880,125,11587
1488,3,0,15,10,42259260,3650,1448880,125,11590
1489,5,0,15,10,42275280,3650,1448880,124,11595
1490,7,0,18,7,42292860,3650,1448880,124,11602
1491,5,0,17,8,42314100,3650,1448880,124,11607
1492,4,0,17,8,42335160,3651,1448880,124,11611
1493,8,0,19,6,42355980,3651,1448880,124,11619
1494,11,1,24,1,42374820,3651,1448880,124,11630
1495,7,5,19,6,42411060,3652,1453320,124,11637
1496,15,19,18,7,42428040,3652,1455660,124,11652
1497,4,18,19,6,42457380,3654,1476600,126,11656
1498,10,20,25,0,42478620,3655,1515120,129,11666
1499,11,22,25,0,42529200,3656,1568040,134,11677
1500,12,12,25,0,42599100,3655,1671600,143,11689
1501,12,4,25,0,42639000,3653,1782000,152,11701
1502,10,0,20,5,42687120,3651,1808160,154,11711
1503,9,0,18,7,42721020,3650,1808160,154,11720
1504,7,0,17,8,42743280,3650,1808160,154,11727
1505,21,0,24,1,42772380,3648,1808460,153,11748
1506,7,0,22,3,42801540,3647,1809120,153,11755
1507,13,0,21,4,42851040,3647,1809120,153,11768
1508,4,0,20,5,42870900,3647,1809120,153,11772
1509,4,0,21,4,42892620,3648,1809120,153,11776
1510,3,0,16,9,42934020,3649,1809120,153,11779
1511,5,0,16,9,42949440,3649,1809120,153,11784
1512,4,0,15,10,42966960,3649,1809120,153,11788
1513,8,0,20,5,42971640,3649,1809120,153,11796
1514,4,0,21,4,42981420,3648,1809120,153,11800
1515,7,0,18,7,43028640,3649,1809120,153,11807
1516,3,0,15,10,43039320,3648,1809120,153,11810
1517,6,0,18,7,43056480,3649,1809120,153,11816
1518,9,0,23,2,43062240,3648,1809120,152,11825
1519,12,0,22,3,43107240,3648,1809120,152,11837
1520,11,0,24,1,43138080,3648,1809120,152,11848
1521,8,0,23,2,43167600,3648,1809120,152,11856
1522,9,0,20,5,43207080,3647,1809120,152,11865
1523,14,0,22,3,43247280,3647,1809120,152,11879
1524,4,0,21,4,43261920,3647,1809120,152,11883
1525,8,0,21,4,43294920,3647,1809120,152,11891
1526,7,0,18,7,43335840,3647,1809120,152,11898
1527,6,0,18,7,43353540,3647,1809120,151,11904
1528,7,0,20,5,43365060,3646,1809120,151,11911
1529,12,0,22,3,43407840,3647,1809120,151,11923
1530,18,7,25,0,43426800,3646,1812360,151,11941
1531,9,4,25,0,43478700,3647,1831920,153,11950
1532,8,0,22,3,43523340,3646,1851420,154,11958
1533,12,0,24,1,43568400,3647,1851420,154,11970
1534,7,0,19,6,43606620,3646,1851420,154,11977
1535,4,0,16,9,43636200,3646,1851420,154,11981
1536,8,0,17,8,43661160,3646,1851420,154,11989
1537,4,0,18,7,43669440,3646,1851420,154,11993
1538,7,0,18,7,43689240,3646,1851420,154,12000
1539,5,0,15,10,43719420,3646,1851420,154,12005
1540,7,0,19,6,43730400,3646,1851420,154,12012
1541,4,0,18,7,43739400,3645,1851420,154,12016
1542,3,0,16,9,43758420,3645,1851420,154,12019
1543,5,0,17,8,43780260,3646,1851420,153,12024
1544,9,0,19,6,43800300,3645,1851420,153,12033
1545,8,0,22,3,43817400,3645,1851420,153,12041
1546,12,5,22,3,43842840,3645,1851720,153,12053
1547,10,12,18,7,43885560,3647,1856640,153,12063
1548,11,17,20,5,43914480,3648,1872960,155,12074
1549,10,19,25,0,43927260,3648,1904400,157,12084
1550,9,22,25,0,43968600,3650,1915020,158,12093
1551,9,16,25,0,44034480,3650,1992300,164,12102
1552,9,11,25,0,44063220,3649,2078100,171,12111
1553,15,11,25,0,44113080,3648,2122860,175,12126
1554,10,15,21,4,44142900,3648,2125740,175,12136
1555,2,10,21,4,44201640,3650,2160900,178,12138
1556,9,4,23,2,44227260,3649,2316840,190,12147
1557,4,0,19,6,44273700,3649,2353800,193,12151
1558,11,0,18,7,44308860,3648,2353800,193,12162
1559,2,0,16,9,44337660,3649,2353800,193,12164
1560,4,0,14,11,44355540,3649,2353800,193,12168
1561,7,0,17,8,44361840,3648,2353800,193,12175
1562,5,0,17,8,44372880,3648,2353800,193,12180
1563,5,0,17,8,44394900,3648,2353800,193,12185
1564,4,0,17,8,44407320,3648,2353800,193,12189
1565,5,0,16,9,44427660,3648,2353800,193,12194
1566,7,0,20,5,44436540,3648,2353800,192,12201
1567,11,0,25,0,44454300,3647,2353800,192,12212
1568,3,0,16,9,44499840,3647,2353800,192,12215
1569,9,0,20,5,44520120,3647,2353800,192,12224
1570,12,0,21,4,44548740,3647,2353800,192,12236
1571,10,0,23,2,44575380,3646,2353800,192,12246
1572,13,0,23,2,44609580,3645,2354640,192,12259
1573,18,6,25,0,44659440,3646,2360640,192,12277
1574,11,11,25,0,44686380,3647,2375340,193,12288
1575,18,18,25,0,44750280,3649,2383380,193,12306
1576,10,21,23,2,44789460,3649,2389560,194,12316
1577,14,23,25,0,44830140,3650,2428740,196,12330
1578,9,22,25,0,44878140,3651,2476260,200,12339
1579,9,4,25,0,44943600,3648,2676840,216,12348
1580,7,0,17,8,44977140,3645,2736300,221,12355
1581,9,0,19,6,44998860,3645,2736300,221,12364
1582,5,0,19,6,45006540,3644,2736300,221,12369
1583,6,0,18,7,45045240,3645,2736660,221,12375
1584,7,0,21,4,45061440,3645,2736660,221,12382
1585,3,0,16,9,45093120,3645,2736660,220,12385
1586,2,0,15,10,45113160,3646,2736660,220,12387
1587,6,0,17,8,45125160,3646,2736660,220,12393
1588,10,0,21,4,45140040,3645,2736660,220,12403
1589,5,0,19,6,45167940,3645,2736660,220,12408
1590,9,0,19,6,45214200,3646,2736660,220,12417
1591,2,0,17,8,45238740,3647,2736660,220,12419
1592,5,0,16,9,45269040,3648,2736660,220,12424
1593,9,0,23,2,45272940,3648,2736660,220,12433
1594,10,0,21,4,45312720,3647,2738040,220,12443
1595,8,0,23,2,45338820,3648,2738040,219,12451
1596,8,0,21,4,45378720,3648,2738040,219,12459
1597,12,0,22,3,45412620,3647,2738040,219,12471
1598,10,0,21,4,45448380,3647,2738160,219,12481
1599,10,0,22,3,45478800,3647,2738160,219,12491
1600,11,0,21,4,45523440,3647,2738160,219,12502
1601,5,0,18,7,45553380,3647,2738160,218,12507
1602,8,0,22,3,45572880,3647,2738160,218,12515
1603,11,0,21,4,45612360,3647,2738280,218,12526
1604,8,0,20,5,45638460,3646,2738280,218,12534
1605,6,0,18,7,45674700,3647,2738280,218,12540
1606,6,0,17,8,45700320,3647,2738280,218,12546
1607,9,0,20,5,45723360,3647,2738280,218,12555
1608,2,0,17,8,45733500,3647,2738280,218,12557
1609,8,0,20,5,45760200,3647,2738280,217,12565
1610,6,0,21,4,45770760,3647,2738280,217,12571
1611,9,0,19,6,45818340,3647,2738280,217,12580
1612,8,0,20,5,45833460,3646,2738280,217,12588
1613,3,0,18,7,45864840,3647,2738280,217,12591
1614,5,0,17,8,45893760,3648,2738280,217,12596
1615,8,0,21,4,45909120,3648,2738280,217,12604
1616,8,0,19,6,45937320,3647,2738280,217,12612
1617,7,0,19,6,45959460,3647,2738280,216,12619
1618,5,0,18,7,45994380,3648,2738280,216,12624
1619,11,0,19,6,46014300,3647,2738280,216,12635
1620,6,0,20,5,46041600,3648,2738280,216,12641
1621,9,0,21,4,46058400,3647,2738280,216,12650
1622,7,0,16,9,46115160,3648,2738280,216,12657
1623,21,9,25,0,46117920,3647,2738760,216,12678
1624,7,5,24,1,46178460,3648,2755440,217,12685
1625,2,0,24,1,46198860,3648,2782380,219,12687
1626,5,0,18,7,46249320,3649,2782380,219,12692
1627,3,0,19,6,46267020,3649,2782380,219,12695
1628,4,0,16,9,46290060,3649,2782380,219,12699
1629,10,0,19,6,46317000,3649,2782380,218,12709
1630,7,0,20,5,46333320,3649,2782380,218,12716
1631,4,0,15,10,46370340,3649,2782380,218,12720
1632,3,0,15,10,46384020,3649,2782380,218,12723
1633,4,0,15,10,46395300,3649,2782380,218,12727
1634,5,0,18,7,46404180,3649,2782380,218,12732
1635,9,0,20,5,46430820,3649,2782380,218,12741
1636,7,0,19,6,46459500,3649,2782380,218,12748
1637,9,0,20,5,46491300,3650,2782380,218,12757
1638,5,0,17,8,46523160,3650,2782380,218,12762
1639,7,0,19,6,46540020,3650,2782380,217,12769
1640,5,0,15,10,46571640,3650,2782380,217,12774
1641,13,0,23,2,46593120,3650,2782380,217,12787
1642,11,1,25,0,46609380,3649,2784540,217,12798
1643,18,7,25,0,46674540,3651,2788680,217,12816
1644,7,7,25,0,46701000,3651,2796240,218,12823
1645,8,7,25,0,46745400,3652,2807520,218,12831
1646,8,0,18,7,46816620,3651,2847480,221,12839
1647,12,0,20,5,46849740,3651,2847480,221,12851
1648,10,0,19,6,46886160,3651,2847480,221,12861
1649,13,1,25,0,46902000,3650,2848560,221,12874
1650,10,0,21,4,46946400,3649,2851440,221,12884
1651,4,0,18,7,46976640,3650,2851440,221,12888
1652,10,0,18,7,47013180,3650,2851440,221,12898
1653,5,0,18,7,47039880,3650,2851440,220,12903
1654,5,0,20,5,47051940,3650,2851440,220,12908
1655,4,0,21,4,47063760,3650,2851440,220,12912
1656,11,5,19,6,47109720,3652,2853360,220,12923
1657,10,12,19,6,47127600,3652,2858700,221,12933
1658,2,12,18,7,47149560,3653,2867760,221,12935
1659,8,6,25,0,47185020,3654,2917560,225,12943
1660,7,3,24,1,47233440,3654,2956320,228,12950
1661,11,0,25,0,47266140,3653,2988000,230,12961
1662,12,0,20,5,47327640,3653,2988000,230,12973
1663,12,0,21,4,47362020,3653,2988000,230,12985
1664,9,0,18,7,47393640,3652,2988000,229,12994
1665,7,0,22,3,47408400,3652,2988000,229,13001
1666,10,0,22,3,47451180,3653,2988000,229,13011
1667,7,0,23,2,47472600,3653,2988000,229,13018
1668,7,0,17,8,47524500,3653,2988000,229,13025
1669,8,0,19,6,47544840,3653,2988000,229,13033
1670,8,0,22,3,47560260,3653,2988000,229,13041
1671,9,0,22,3,47602560,3653,2988000,228,13050
1672,15,0,24,1,47641440,3653,2988660,228,13065
1673,8,0,21,4,47670120,3652,2988660,228,13073
1674,7,0,18,7,47713560,3652,2988660,228,13080
1675,8,0,20,5,47727660,3652,2988660,228,13088
1676,7,0,17,8,47762220,3652,2988660,228,13095
1677,8,0,20,5,47775900,3651,2988660,228,13103
1678,6,0,19,6,47803860,3651,2988660,227,13109
1679,1,0,13,12,47837820,3652,2988660,227,13110
1680,4,0,16,9,47838840,3652,2988660,227,13114
1681,5,0,16,9,47853180,3652,2988660,227,13119
1682,7,0,18,7,47865120,3651,2988660,227,13126
1683,5,0,18,7,47885340,3651,2988660,227,13131
1684,6,0,20,5,47897880,3651,2988660,227,13137
1685,10,0,23,2,47926620,3651,2988660,227,13147
1686,4,0,16,9,47976360,3652,2988660,227,13151
1687,11,0,17,8,48003120,3651,2988660,227,13162
1688,7,0,21,4,48011880,3651,2988660,226,13169
1689,6,0,19,6,48045900,3652,2988660,226,13175
1690,8,0,19,6,48082380,3652,2988660,226,13183
1691,15,0,25,0,48098220,3651,2988960,226,13198
1692,6,3,21,4,48118620,3650,2992920,226,13204
1693,11,4,25,0,48142320,3651,3000900,227,13215
1694,4,0,19,6,48204060,3651,3013800,227,13219
1695,8,0,18,7,48245100,3652,3013800,227,13227
1696,11,0,18,7,48273180,3651,3013800,227,13238
1697,10,0,20,5,48295140,3650,3013800,227,13248
1698,8,0,19,6,48317880,3650,3013800,227,13256
1699,4,0,17,8,48344760,3650,3013800,227,13260
1700,5,0,17,8,48357720,3650,3013800,227,13265
1701,8,0,19,6,48385140,3650,3013800,227,13273
1702,12,0,23,2,48405660,3649,3013800,226,13285
1703,3,0,18,7,48442680,3650,3013800,226,13288
1704,4,0,15,10,48476820,3651,3013800,226,13292
1705,3,0,16,9,48483180,3651,3013800,226,13295
1706,4,0,17,8,48498660,3651,3013800,226,13299
1707,6,0,16,9,48518340,3651,3013800,226,13305
1708,3,0,14,11,48534420,3650,3013800,226,13308
1709,9,0,20,5,48539700,3650,3013800,226,13317
1710,7,6,18,7,48555120,3650,3014160,226,13324
1711,3,4,21,4,48568500,3651,3029280,227,13327
1712,12,1,25,0,48622740,3652,3053340,228,13339
1713,20,4,25,0,48661980,3650,3057000,228,13359
1714,8,3,25,0,48705540,3651,3063180,229,13367
1715,9,0,21,4,48758820,3650,3074040,229,13376
1716,12,0,20,5,48782160,3649,3074040,229,13388
1717,6,0,20,5,48819300,3650,3074040,229,13394
1718,7,0,19,6,48843180,3649,3074040,229,13401
1719,14,0,23,2,48879060,3649,3074040,229,13415
1720,7,0,21,4,48904140,3649,3074040,229,13422
1721,7,0,19,6,48945720,3649,3074040,228,13429
1722,11,0,22,3,48976380,3650,3074040,228,13440
1723,9,0,21,4,48999960,3649,3074040,228,13449
1724,5,0,19,6,49031100,3649,3074040,228,13454
1725,6,0,17,8,49072920,3650,3074040,228,13460
1726,6,0,20,5,49082760,3650,3074040,228,13466
1727,8,0,20,5,49111260,3650,3074040,228,13474
1728,8,0,18,7,49144620,3650,3074040,228,13482
1729,12,0,24,1,49160100,3649,3074040,227,13494
1730,3,0,16,9,49188000,3648,3074040,227,13497
1731,6,0,16,9,49206000,3648,3074040,227,13503
1732,7,0,16,9,49236840,3648,3074040,227,13510
1733,7,0,15,10,49258260,3648,3074040,227,13517
1734,7,0,19,6,49269720,3648,3074040,227,13524
1735,18,7,25,0,49286700,3648,3075840,227,13542
1736,8,12,23,2,49313040,3648,3079200,227,13550
1737,11,13,25,0,49365060,3650,3107760,229,13561
1738,6,10,25,0,49416660,3651,3140280,231,13567
1739,11,5,25,0,49464660,3651,3187620,234,13578
1740,13,3,25,0,49512540,3650,3244260,238,13591
1741,9,0,22,3,49564080,3650,3255300,239,13600
1742,13,0,24,1,49599060,3649,3255420,239,13613
1743,7,0,18,7,49640940,3649,3255420,239,13620
1744,13,1,21,4,49667820,3649,3255480,238,13633
1745,8,4,21,4,49687380,3649,3258420,238,13641
1746,15,2,24,1,49721640,3647,3274560,239,13656
1747,7,0,23,2,49748760,3647,3281400,240,13663
1748,5,0,16,9,49813200,3648,3281400,240,13668
1749,6,0,19,6,49820820,3648,3281400,239,13674
1750,4,0,16,9,49846680,3648,3281400,239,13678
1751,7,0,18,7,49862280,3648,3281400,239,13685
1752,1,0,15,10,49881600,3648,3281400,239,13686
1753,5,0,18,7,49891380,3648,3281400,239,13691
1754,4,0,15,10,49921260,3649,3281400,239,13695
1755,4,0,17,8,49934280,3649,3281400,239,13699
1756,2,0,16,9,49943160,3649,3281400,239,13701
1757,9,0,21,4,49966500,3650,3281400,239,13710
1758,6,0,21,4,49980300,3649,3281400,239,13716
1759,11,0,22,3,50021580,3649,3281400,239,13727
1760,10,0,22,3,50055060,3649,3281400,238,13737
1761,8,0,21,4,50083440,3649,3281400,238,13745
1762,15,0,22,3,50137620,3649,3281400,238,13760
1763,8,0,20,5,50168760,3649,3281400,238,13768
1764,14,1,25,0,50198820,3649,3282180,238,13782
1765,7,0,22,3,50244240,3649,3286320,238,13789
1766,5,0,16,9,50280960,3649,3286320,238,13794
1767,5,0,17,8,50284860,3648,3286320,238,13799
1768,9,0,19,6,50315820,3648,3286320,238,13808
1769,7,0,19,6,50337180,3648,3286320,237,13815
1770,7,0,21,4,50355240,3648,3287640,237,13822
1771,6,0,22,3,50385060,3649,3289920,237,13828
1772,9,0,21,4,50421180,3649,3289920,237,13837
1773,5,0,20,5,50449560,3649,3289920,237,13842
1774,12,0,22,3,50492760,3650,3289920,237,13854
1775,4,0,15,10,50529600,3650,3289920,237,13858
1776,7,0,19,6,50537880,3649,3289920,237,13865
1777,9,0,23,2,50559300,3650,3289920,237,13874
1778,6,0,21,4,50597580,3650,3289920,237,13880
1779,4,0,19,6,50632200,3651,3289920,236,13884
1780,10,0,22,3,50671020,3652,3289920,236,13894
1781,10,0,23,2,50692740,3651,3289920,236,13904
1782,5,0,20,5,50726520,3652,3289920,236,13909
1783,7,0,17,8,50762940,3652,3289920,236,13916
1784,10,0,22,3,50775660,3651,3289920,236,13926
1785,17,2,24,1,50812140,3651,3294120,236,13943
1786,8,0,22,3,50849100,3650,3301380,236,13951
1787,7,0,21,4,50888220,3651,3301380,236,13958
1788,10,0,23,2,50911320,3650,3301380,236,13968
1789,12,0,21,4,50971800,3651,3301620,236,13980
1790,13,0,20,5,51002400,3650,3301620,235,13993
1791,8,0,20,5,51024240,3649,3301620,235,14001
1792,8,0,19,6,51071040,3650,3301620,235,14009
1793,9,0,21,4,51089760,3650,3301620,235,14018
1794,9,0,23,2,51116580,3650,3302340,235,14027
1795,8,0,22,3,51153720,3650,3302340,235,14035
1796,8,0,20,5,51195600,3650,3302340,235,14043
1797,7,0,20,5,51238380,3652,3302340,235,14050
1798,5,0,19,6,51262740,3652,3302340,234,14055
1799,6,0,14,11,51296340,3651,3302340,234,14061
1800,10,0,20,5,51307800,3651,3302340,234,14071
1801,7,0,20,5,51327000,3651,3302340,234,14078
1802,4,0,19,6,51348660,3651,3302340,234,14082
1803,12,0,18,7,51390240,3650,3302340,234,14094
1804,6,0,18,7,51409500,3650,3302340,234,14100
1805,9,0,25,0,51423180,3651,3303840,234,14109
1806,8,1,22,3,51458160,3651,3305640,234,14117
1807,8,0,24,1,51504240,3652,3310440,234,14125
1808,10,0,18,7,51548100,3651,3311340,234,14135
1809,6,0,17,8,51577200,3651,3311340,234,14141
1810,13,0,24,1,51589140,3651,3311400,233,14154
1811,13,2,25,0,51624600,3650,3312240,233,14167
1812,6,0,18,7,51678960,3650,3313140,233,14173
1813,11,0,21,4,51702240,3650,3313140,233,14184
1814,12,0,21,4,51735660,3649,3313140,233,14196
1815,11,0,25,0,51752520,3649,3313140,233,14207
1816,12,7,21,4,51777660,3648,3315360,233,14219
1817,9,7,22,3,51836340,3650,3328020,233,14228
1818,9,5,25,0,51870060,3651,3353940,235,14237
1819,9,0,23,2,51926520,3650,3400080,238,14246
1820,10,0,25,0,51946260,3650,3400080,238,14256
1821,6,0,20,5,51996000,3650,3400080,238,14262
1822,8,0,21,4,52015440,3650,3400080,238,14270
1823,5,0,16,9,52057980,3650,3400080,238,14275
1824,9,0,18,7,52072740,3650,3400080,238,14284
1825,3,0,14,11,52094520,3649,3400080,237,14287
1826,8,0,19,6,52102680,3649,3400080,237,14295
1827,8,0,19,6,52123680,3649,3400080,237,14303
1828,3,0,18,7,52137780,3649,3400080,237,14306
1829,8,0,15,10,52174860,3648,3400080,237,14314
1830,6,0,16,9,52190100,3648,3400080,237,14320
1831,8,0,20,5,52196340,3648,3400080,237,14328
1832,10,0,19,6,52226400,3647,3400080,237,14338
1833,10,0,19,6,52260060,3647,3400080,236,14348
1834,8,0,20,5,52293600,3647,3400080,236,14356
1835,10,0,19,6,52316400,3646,3400080,236,14366
1836,11,0,20,5,52344840,3645,3400080,236,14377
1837,13,0,22,3,52374480,3645,3400080,236,14390
1838,11,0,21,4,52412880,3644,3402000,236,14401
1839,8,0,21,4,52454880,3645,3402000,236,14409
1840,15,1,25,0,52486020,3645,3402120,235,14424
1841,3,0,20,5,52516680,3645,3402240,235,14427
1842,4,0,15,10,52555860,3645,3402240,235,14431
1843,11,0,21,4,52565400,3645,3402240,235,14442
1844,11,0,22,3,52599120,3644,3402240,235,14453
1845,6,0,21,4,52624560,3644,3402240,235,14459
1846,4,0,16,9,52664520,3645,3402240,235,14463
1847,4,0,15,10,52695960,3646,3402240,235,14467
1848,4,0,17,8,52703220,3646,3402240,235,14471
1849,8,0,20,5,52725300,3646,3402240,234,14479
1850,3,0,15,10,52754460,3646,3402240,234,14482
1851,3,0,15,10,52764840,3646,3402240,234,14485
1852,6,0,18,7,52772460,3646,3402240,234,14491
1853,8,0,16,9,52803540,3645,3402240,234,14499
1854,6,1,19,6,52805340,3645,3402420,234,14505
1855,8,0,20,5,52840440,3645,3403200,234,14513
1856,11,0,19,6,52862160,3644,3403200,234,14524
1857,11,0,23,2,52890300,3644,3403200,234,14535
1858,10,0,23,2,52920540,3644,3403200,233,14545
1859,6,0,19,6,52963620,3644,3403200,233,14551
1860,9,0,22,3,52987200,3644,3403200,233,14560
1861,7,0,21,4,53026260,3645,3403200,233,14567
1862,11,0,21,4,53058360,3644,3403200,233,14578
1863,6,0,18,7,53090880,3644,3403200,233,14584
1864,17,0,22,3,53126640,3644,3403200,233,14601
1865,6,0,18,7,53154420,3643,3403200,232,14607
1866,9,0,21,4,53176560,3643,3403200,232,14616
1867,8,0,20,5,53213820,3643,3403200,232,14624
1868,10,0,19,6,53249160,3643,3403200,232,14634
1869,10,3,22,3,53267640,3643,3403440,232,14644
1870,6,0,23,2,53304300,3644,3411300,232,14650
1871,3,0,19,6,53341680,3645,3411300,232,14653
1872,3,0,15,10,53378100,3645,3411300,232,14656
1873,8,0,20,5,53384820,3645,3411300,232,14664
1874,7,0,23,2,53406900,3646,3411300,232,14671
1875,5,0,15,10,53457000,3646,3411300,232,14676
1876,9,0,20,5,53477100,3646,3411300,232,14685
1877,9,0,21,4,53496840,3645,3411300,232,14694
1878,9,0,25,0,53516100,3646,3411660,232,14703
1879,8,0,24,1,53554440,3646,3411840,231,14711
1880,8,0,19,6,53606280,3646,3411840,231,14719
1881,13,0,22,3,53632380,3645,3412020,231,14732
1882,6,0,19,6,53657580,3645,3412020,231,14738
1883,4,0,17,8,53682360,3645,3412020,231,14742
1884,15,2,25,0,53695320,3645,3412020,231,14757
1885,17,8,25,0,53736240,3645,3412920,231,14774
1886,13,1,22,3,53798460,3643,3429540,231,14787
1887,9,8,18,7,53820660,3643,3433980,232,14796
1888,15,22,17,8,53837280,3644,3438480,232,14811
1889,15,32,19,6,53863020,3645,3458040,233,14826
1890,13,40,19,6,53886180,3646,3462480,233,14839
1891,7,39,19,6,53929800,3647,3488820,235,14846
1892,6,38,21,4,53943480,3648,3512580,236,14852
1893,6,34,25,0,53984280,3649,3590400,241,14858
1894,7,32,25,0,54023640,3649,3658200,246,14865
1895,2,21,25,0,54082980,3650,3955920,266,14867
1896,5,0,20,5,54138540,3646,4392000,295,14872
1897,4,0,17,8,54153660,3645,4392000,295,14876
1898,5,0,17,8,54170820,3645,4392000,295,14881
1899,9,0,22,3,54182460,3645,4392000,295,14890
1900,5,0,17,8,54204360,3644,4392000,294,14895
1901,5,0,17,8,54226560,3644,4392000,294,14900
1902,3,0,17,8,54246660,3645,4392000,294,14903
1903,16,5,24,1,54257220,3645,4394280,294,14919
1904,12,16,20,5,54289740,3646,4395240,294,14931
1905,14,27,20,5,54311820,3647,4402680,294,14945
1906,12,32,23,2,54348600,3648,4427040,296,14957
1907,14,39,25,0,54378780,3649,4446240,297,14971
1908,10,34,25,0,54455100,3651,4525500,302,14981
1909,8,28,25,0,54497340,3651,4617120,308,14989
1910,14,30,25,0,54537600,3650,4713540,314,15003
1911,10,15,25,0,54598260,3648,4961100,330,15013
1912,8,8,25,0,54630720,3647,5072160,337,15021
1913,6,0,21,4,54680940,3646,5218500,347,15027
1914,8,0,19,6,54717780,3646,5218500,347,15035
1915,6,0,17,8,54756120,3647,5218500,347,15041
1916,5,0,16,9,54772620,3646,5218500,347,15046
1917,6,0,14,11,54791760,3645,5218500,346,15052
1918,5,0,17,8,54796440,3645,5218500,346,15057
1919,6,0,18,7,54809340,3645,5218500,346,15063
1920,7,0,20,5,54824640,3645,5218500,346,15070
1921,9,0,21,4,54842280,3644,5218500,346,15079
1922,4,0,16,9,54880920,3644,5218500,346,15083
1923,5,0,14,11,54904860,3644,5218500,346,15088
1924,7,0,18,7,54908280,3644,5218500,345,15095
1925,8,0,23,2,54914100,3643,5218500,345,15103
1926,2,0,17,8,54946260,3644,5218500,345,15105
1927,6,0,16,9,54978120,3644,5218500,345,15111
1928,9,0,21,4,54986160,3644,5218500,345,15120
1929,6,4,19,6,54999000,3644,5219400,345,15126
1930,11,2,25,0,55045320,3645,5237640,346,15137
1931,13,8,24,1,55074540,3645,5243220,346,15150
1932,13,18,18,7,55123200,3646,5246580,346,15163
1933,6,19,20,5,55143060,3647,5259900,347,15169
1934,9,24,20,5,55168380,3647,5266740,347,15178
1935,9,25,24,1,55193700,3648,5327220,351,15187
1936,9,26,25,0,55227540,3648,5359380,352,15196
1937,9,22,25,0,55282380,3649,5444340,358,15205
1938,16,28,23,2,55334700,3650,5450940,358,15221
1939,12,40,20,5,55345800,3650,5450940,358,15233
1940,7,38,18,7,55402800,3652,5474940,359,15240
1941,4,37,21,4,55411380,3652,5496600,360,15244
1942,3,33,24,1,55446420,3653,5562900,365,15247
1943,9,20,25,0,55507320,3652,6020160,394,15256
1944,3,0,14,11,55552980,3647,6458040,423,15259
1945,6,0,17,8,55563180,3647,6458040,423,15265
1946,4,0,16,9,55579740,3647,6458040,423,15269
1947,8,0,17,8,55596300,3646,6458040,423,15277
1948,7,0,20,5,55604760,3646,6458040,422,15284
1949,3,0,15,10,55641420,3646,6458040,422,15287
1950,8,0,18,7,55655340,3646,6458040,422,15295
1951,6,0,18,7,55665900,3645,6458040,422,15301
1952,9,0,18,7,55706100,3646,6458040,422,15310
1953,10,0,20,5,55721640,3645,6458040,421,15320
1954,8,0,19,6,55752900,3645,6458040,421,15328
1955,10,0,20,5,55780320,3644,6458040,421,15338
1956,7,0,18,7,55809480,3644,6458040,421,15345
1957,14,3,22,3,55824120,3643,6458160,420,15359
1958,8,0,22,3,55877520,3644,6466380,421,15367
1959,12,3,25,0,55902840,3644,6466440,420,15379
1960,9,8,23,2,55938300,3645,6472500,421,15388
1961,5,0,25,0,55993320,3646,6505080,422,15393
1962,12,0,23,2,56027640,3645,6505080,422,15405
1963,7,0,20,5,56048160,3644,6505080,422,15412
1964,7,0,20,5,56085600,3645,6505080,422,15419
1965,5,0,20,5,56121720,3646,6505080,422,15424
1966,10,0,21,4,56156520,3646,6505080,421,15434
1967,4,0,15,10,56191860,3646,6505080,421,15438
1968,8,0,20,5,56201880,3646,6505080,421,15446
1969,11,0,20,5,56233560,3646,6505080,421,15457
1970,4,0,18,7,56252280,3645,6505080,421,15461
1971,5,0,18,7,56274180,3646,6505080,420,15466
1972,6,0,17,8,56298720,3646,6505080,420,15472
1973,5,0,16,9,56320680,3646,6505080,420,15477
1974,8,0,20,5,56330160,3645,6505080,420,15485
1975,5,0,16,9,56356560,3645,6505080,420,15490
1976,7,0,17,8,56371620,3644,6505080,420,15497
1977,8,0,20,5,56382960,3644,6505080,419,15505
1978,11,0,21,4,56404500,3643,6505080,419,15516
1979,11,0,25,0,56428680,3643,6505080,419,15527
1980,9,0,24,1,56465280,3643,6512400,419,15536
1981,16,1,25,0,56512920,3643,6513960,419,15552
1982,9,0,21,4,56569500,3643,6515640,419,15561
1983,12,0,25,0,56597220,3643,6515640,418,15573
1984,12,0,21,4,56640480,3642,6516660,418,15585
1985,10,0,20,5,56685540,3642,6516660,418,15595
1986,10,0,23,2,56711220,3642,6516720,417,15605
1987,2,0,18,7,56745060,3643,6516720,417,15607
1988,6,0,17,8,56779020,3643,6516720,417,15613
1989,8,0,20,5,56786820,3643,6516720,417,15621
1990,7,0,20,5,56817540,3643,6516720,417,15628
1991,7,0,22,3,56827560,3643,6516720,417,15635
1992,7,0,19,6,56869800,3643,6516720,416,15642
1993,7,0,20,5,56889120,3643,6516720,416,15649
1994,5,0,15,10,56918040,3642,6516720,416,15654
1995,7,0,18,7,56932860,3642,6516720,416,15661
1996,9,0,17,8,56955360,3641,6516720,416,15670
1997,7,0,17,8,56973960,3641,6516720,416,15677
1998,8,0,21,4,56987640,3641,6516720,415,15685
1999,8,0,19,6,57018840,3641,6516720,415,15693
2000,13,0,25,0,57041400,3640,6517020,415,15706
2001,10,2,25,0,57066000,3640,6517140,415,15716
2002,13,2,25,0,57123600,3641,6522180,415,15729
2003,14,10,22,3,57135960,3639,6526560,415,15743
2004,11,12,25,0,57176160,3641,6548280,416,15754
2005,7,8,25,0,57223500,3641,6584820,418,15761
2006,17,3,25,0,57290280,3640,6631440,420,15778
2007,12,8,25,0,57317400,3640,6638340,420,15790
2008,9,8,25,0,57365700,3641,6649500,421,15799
2009,9,0,23,2,57435360,3641,6709140,424,15808
2010,12,0,25,0,57469200,3641,6709440,424,15820
2011,12,1,25,0,57505440,3641,6709500,424,15832
2012,5,0,19,6,57544620,3641,6709560,424,15837
2013,8,0,20,5,57582300,3641,6709560,423,15845
2014,4,0,17,8,57597540,3641,6709560,423,15849
2015,4,0,15,10,57618420,3641,6709560,423,15853
2016,11,0,24,1,57619800,3640,6709560,423,15864
2017,3,1,25,0,57620400,3640,6709740,423,15867
2018,5,5,24,1,57627300,3640,6710280,423,15872
2019,8,12,24,1,57631800,3640,6714840,423,15880
2020,8,20,24,1,57631800,3640,6714840,423,15888
2021,2,21,24,1,57638400,3640,6723420,423,15890
2022,8,29,24,1,57638400,3640,6723420,423,15898
2023,5,33,24,1,57645060,3641,6738840,424,15903
2024,10,40,24,1,57645060,3641,6738840,424,15913
2025,8,40,23,2,57651540,3641,6738840,424,15921
2026,10,40,23,2,57651540,3641,6738840,424,15931
2027,9,40,23,2,57651540,3641,6738840,424,15940
2028,11,40,23,2,57651540,3641,6738840,424,15951
2029,7,40,23,2,57651540,3641,6738840,424,15958
2030,10,40,23,2,57651540,3641,6738840,424,15968
2031,13,40,23,2,57651540,3641,6738840,424,15981
2032,12,40,23,2,57651540,3641,6738840,424,15993
2033,11,40,23,2,57651540,3641,6738840,424,16004
2034,11,40,23,2,57651540,3641,6738840,424,16015
2035,13,40,23,2,57651540,3641,6738840,424,16028
2036,6,40,23,2,57651540,3641,6738840,424,16034
2037,8,40,23,2,57651540,3641,6738840,424,16042
2038,3,40,23,2,57651540,3641,6738840,424,16045
2039,10,40,23,2,57651540,3641,6738840,424,16055
2040,3,40,23,2,57651540,3641,6738840,424,16058
2041,6,40,23,2,57651540,3641,6738840,424,16064
2042,8,40,23,2,57651540,3641,6738840,424,16072
2043,5,40,23,2,57651540,3641,6738840,424,16077
2044,7,40,23,2,57651540,3641,6738840,424,16084
2045,3,40,23,2,57651540,3641,6738840,424,16087
2046,1,40,23,2,57651540,3641,6738840,424,16088
2047,10,40,23,2,57651540,3641,6738840,424,16098
2048,5,40,23,2,57651540,3641,6738840,424,16103
2049,6,40,23,2,57651540,3641,6738840,424,16109
2050,7,40,23,2,57651540,3641,6738840,424,16116
2051,6,40,23,2,57651540,3641,6738840,424,16122
2052,10,40,23,2,57651540,3641,6738840,424,16132
2053,17,40,23,2,57651540,3641,6738840,424,16149
2054,7,40,23,2,57651540,3641,6738840,424,16156
2055,15,40,23,2,57651540,3641,6738840,424,16171
2056,10,40,23,2,57651540,3641,6738840,424,16181
2057,16,40,23,2,57651540,3641,6738840,424,16197
2059,5,40,23,2,57651540,3641,6738840,424,16202
2058,0,40,23,2,57651540,3641,6738840,424,16202
2060,6,40,23,2,57651540,3641,6738840,424,16208
2061,7,40,23,2,57651540,3641,6738840,424,16215
2062,8,40,23,2,57651540,3641,6738840,424,16223
2063,4,40,23,2,57651540,3641,6738840,424,16227
2064,3,40,23,2,57651540,3641,6738840,424,16230
2065,4,40,23,2,57651540,3641,6738840,424,16234
2066,6,40,23,2,57651540,3641,6738840,424,16240
2067,7,40,23,2,57651540,3641,6738840,424,16247
2068,4,40,23,2,57651540,3641,6738840,424,16251
2069,3,40,23,2,57651540,3641,6738840,424,16254
2070,5,40,23,2,57651540,3641,6738840,424,16259
2071,8,40,23,2,57651540,3641,6738840,424,16267
2072,11,40,23,2,57651540,3641,6738840,424,16278
2073,3,40,23,2,57651540,3641,6738840,424,16281
2074,9,40,23,2,57651540,3641,6738840,424,16290
2075,11,40,23,2,57651540,3641,6738840,424,16301
2076,14,40,23,2,57651540,3641,6738840,424,16315
2077,9,40,23,2,57651540,3641,6738840,424,16324
2078,8,40,23,2,57651540,3641,6738840,424,16332
2079,8,40,23,2,57651540,3641,6738840,424,16340
2080,7,40,23,2,57651540,3641,6738840,424,16347
2081,8,40,23,2,57651540,3641,6738840,424,16355
2082,15,40,23,2,57651540,3641,6738840,424,16370
2083,9,40,23,2,57651540,3641,6738840,424,16379
2084,11,40,23,2,57651540,3641,6738840,424,16390
2085,6,40,23,2,57651540,3641,6738840,424,16396
2086,5,40,23,2,57651540,3641,6738840,424,16401
2087,5,40,23,2,57651540,3641,6738840,424,16406
2088,4,40,23,2,57651540,3641,6738840,424,16410
2089,3,40,23,2,57651540,3641,6738840,424,16413
2090,5,40,23,2,57651540,3641,6738840,424,16418
2091,11,40,23,2,57651540,3641,6738840,424,16429
2092,7,40,23,2,57651540,3641,6738840,424,16436
2093,7,40,23,2,57651540,3641,6738840,424,16443
2094,4,40,23,2,57651540,3641,6738840,424,16447
2095,6,40,23,2,57651540,3641,6738840,424,16453
2096,11,40,23,2,57651540,3641,6738840,424,16464
2097,6,40,23,2,57651540,3641,6738840,424,16470
2098,9,40,23,2,57651540,3641,6738840,424,16479
2099,10,40,23,2,57651540,3641,6738840,424,16489
2100,14,40,23,2,57651540,3641,6738840,424,16503
2101,13,40,23,2,57651540,3641,6738840,424,16516
2102,11,40,23,2,57651540,3641,6738840,424,16527
2103,10,40,23,2,57651540,3641,6738840,424,16537
2104,10,40,23,2,57651540,3641,6738840,424,16547
2105,9,40,23,2,57651540,3641,6738840,424,16556
2106,6,40,23,2,57651540,3641,6738840,424,16562
2107,14,40,23,2,57651540,3641,6738840,424,16576
2108,6,40,23,2,57651540,3641,6738840,424,16582
2109,3,40,23,2,57651540,3641,6738840,424,16585
2110,9,40,23,2,57651540,3641,6738840,424,16594
2111,5,40,23,2,57651540,3641,6738840,424,16599
2112,5,40,23,2,57651540,3641,6738840,424,16604
2113,5,40,23,2,57651540,3641,6738840,424,16609
2114,5,40,23,2,57651540,3641,6738840,424,16614
2115,6,40,23,2,57651540,3641,6738840,424,16620
2116,6,40,23,2,57651540,3641,6738840,424,16626
2117,6,40,23,2,57651540,3641,6738840,424,16632
2118,7,40,23,2,57651540,3641,6738840,424,16639
2119,4,40,23,2,57651540,3641,6738840,424,16643
2120,6,40,23,2,57651540,3641,6738840,424,16649
2121,11,40,23,2,57651540,3641,6738840,424,16660
2122,14,40,23,2,57651540,3641,6738840,424,16674
2123,8,40,23,2,57651540,3641,6738840,424,16682
2124,5,40,23,2,57651540,3641,6738840,424,16687
2125,18,40,23,2,57651540,3641,6738840,424,16705
2126,5,40,23,2,57651540,3641,6738840,424,16710
2127,23,40,23,2,57651540,3641,6738840,424,16733
2128,10,40,23,2,57651540,3641,6738840,424,16743
2129,13,40,23,2,57651540,3641,6738840,424,16756
2130,8,40,23,2,57651540,3641,6738840,424,16764
2131,10,40,23,2,57651540,3641,6738840,424,16774
2132,10,40,23,2,57651540,3641,6738840,424,16784
2133,6,40,23,2,57651540,3641,6738840,424,16790
2134,5,40,23,2,57651540,3641,6738840,424,16795
2135,3,40,23,2,57651540,3641,6738840,424,16798
2136,7,40,23,2,57651540,3641,6738840,424,16805
2137,3,40,23,2,57651540,3641,6738840,424,16808
2138,2,40,23,2,57651540,3641,6738840,424,16810
2139,2,40,23,2,57651540,3641,6738840,424,16812
2140,4,40,23,2,57651540,3641,6738840,424,16816
2141,6,40,23,2,57651540,3641,6738840,424,16822
2142,8,40,23,2,57651540,3641,6738840,424,16830
2143,16,40,23,2,57651540,3641,6738840,424,16846
2144,5,40,23,2,57651540,3641,6738840,424,16851
2145,10,40,23,2,57651540,3641,6738840,424,16861
2146,6,40,23,2,57651540,3641,6738840,424,16867
2147,14,40,23,2,57651540,3641,6738840,424,16881
2148,12,40,23,2,57651540,3641,6738840,424,16893
2149,7,40,23,2,57651540,3641,6738840,424,16900
2150,9,40,23,2,57651540,3641,6738840,424,16909
2151,4,40,23,2,57651540,3641,6738840,424,16913
2152,7,40,23,2,57651540,3641,6738840,424,16920
2153,8,40,23,2,57651540,3641,6738840,424,16928
2154,6,40,23,2,57651540,3641,6738840,424,16934
2155,9,40,23,2,57651540,3641,6738840,424,16943
2156,6,40,23,2,57651540,3641,6738840,424,16949
2157,10,40,23,2,57651540,3641,6738840,424,16959
2158,8,40,23,2,57651540,3641,6738840,424,16967
2159,5,40,23,2,57651540,3641,6738840,424,16972
2160,6,40,23,2,57651540,3641,6738840,424,16978
2161,7,40,23,2,57651540,3641,6738840,424,16985
2162,4,40,23,2,57651540,3641,6738840,424,16989
2163,4,40,23,2,57651540,3641,6738840,424,16993
2164,3,40,23,2,57651540,3641,6738840,424,16996
2165,6,40,23,2,57651540,3641,6738840,424,17002
2166,3,40,23,2,57651540,3641,6738840,424,17005
2167,7,40,23,2,57651540,3641,6738840,424,17012
2168,10,40,23,2,57651540,3641,6738840,424,17022
2169,12,40,23,2,57651540,3641,6738840,424,17034
2170,11,40,23,2,57651540,3641,6738840,424,17045
2171,10,40,23,2,57651540,3641,6738840,424,17055
2172,12,40,23,2,57651540,3641,6738840,424,17067
2173,13,40,23,2,57651540,3641,6738840,424,17080
2174,9,40,23,2,57651540,3641,6738840,424,17089
2175,18,40,23,2,57651540,3641,6738840,424,17107
2176,6,40,23,2,57651540,3641,6738840,424,17113
2177,13,40,23,2,57651540,3641,6738840,424,17126
2178,8,40,23,2,57651540,3641,6738840,424,17134
2179,10,40,23,2,57651540,3641,6738840,424,17144
2180,8,40,23,2,57651540,3641,6738840,424,17152
2181,5,40,23,2,57651540,3641,6738840,424,17157
2182,4,40,23,2,57651540,3641,6738840,424,17161
2183,7,40,23,2,57651540,3641,6738840,424,17168
2184,1,40,23,2,57651540,3641,6738840,424,17169
2185,4,40,23,2,57651540,3641,6738840,424,17173
2186,5,40,23,2,57651540,3641,6738840,424,17178
2187,7,40,23,2,57651540,3641,6738840,424,17185
2188,5,40,23,2,57651540,3641,6738840,424,17190
2189,7,40,23,2,57651540,3641,6738840,424,17197
2190,7,40,23,2,57651540,3641,6738840,424,17204
2191,12,40,23,2,57651540,3641,6738840,424,17216
2192,9,40,23,2,57651540,3641,6738840,424,17225
2193,8,40,23,2,57651540,3641,6738840,424,17233
2194,14,40,23,2,57651540,3641,6738840,424,17247
2195,13,40,23,2,57651540,3641,6738840,424,17260
2196,9,40,23,2,57651540,3641,6738840,424,17269
2197,13,40,23,2,57651540,3641,6738840,424,17282
2198,15,40,23,2,57651540,3641,6738840,424,17297
2199,7,40,23,2,57651540,3641,6738840,424,17304
2200,11,40,23,2,57651540,3641,6738840,424,17315
2201,12,40,23,2,57651540,3641,6738840,424,17327
2202,12,40,23,2,57651540,3641,6738840,424,17339
2203,7,40,23,2,57651540,3641,6738840,424,17346
2204,5,40,23,2,57651540,3641,6738840,424,17351
2205,7,40,23,2,57651540,3641,6738840,424,17358
2206,6,40,23,2,57651540,3641,6738840,424,17364
2207,4,40,23,2,57651540,3641,6738840,424,17368
2208,7,40,23,2,57651540,3641,6738840,424,17375
2209,4,40,23,2,57651540,3641,6738840,424,17379
2210,6,40,23,2,57651540,3641,6738840,424,17385
2211,2,40,23,2,57651540,3641,6738840,424,17387
2212,3,40,23,2,57651540,3641,6738840,424,17390
2213,9,40,23,2,57651540,3641,6738840,424,17399
2214,8,40,23,2,57651540,3641,6738840,424,17407
2215,7,40,23,2,57651540,3641,6738840,424,17414
2216,13,40,23,2,57651540,3641,6738840,424,17427
2217,8,40,23,2,57651540,3641,6738840,424,17435
2218,6,40,23,2,57651540,3641,6738840,424,17441
2219,11,40,23,2,57651540,3641,6738840,424,17452
2220,16,40,23,2,57651540,3641,6738840,424,17468
2221,14,40,23,2,57651540,3641,6738840,424,17482
2222,5,40,23,2,57651540,3641,6738840,424,17487
2223,12,40,23,2,57651540,3641,6738840,424,17499
2224,9,40,23,2,57651540,3641,6738840,424,17508
2225,6,40,23,2,57651540,3641,6738840,424,17514
2226,8,40,23,2,57651540,3641,6738840,424,17522
2227,6,40,23,2,57651540,3641,6738840,424,17528
2228,2,40,23,2,57651540,3641,6738840,424,17530
2229,7,40,23,2,57651540,3641,6738840,424,17537
2230,8,40,23,2,57651540,3641,6738840,424,17545
2231,4,40,23,2,57651540,3641,6738840,424,17549
2232,5,40,23,2,57651540,3641,6738840,424,17554
2233,5,40,23,2,57651540,3641,6738840,424,17559
2234,5,40,23,2,57651540,3641,6738840,424,17564
2235,5,40,23,2,57651540,3641,6738840,424,17569
2236,4,40,23,2,57651540,3641,6738840,424,17573
2237,2,40,23,2,57651540,3641,6738840,424,17575
2238,2,40,23,2,57651540,3641,6738840,424,17577
2239,7,40,23,2,57651540,3641,6738840,424,17584
2240,7,40,23,2,57651540,3641,6738840,424,17591
2241,7,40,23,2,57651540,3641,6738840,424,17598
2242,11,40,23,2,57651540,3641,6738840,424,17609
2243,11,40,23,2,57651540,3641,6738840,424,17620
2244,9,40,23,2,57651540,3641,6738840,424,17629
2245,12,40,23,2,57651540,3641,6738840,424,17641
2246,13,40,23,2,57651540,3641,6738840,424,17654
2247,9,40,23,2,57651540,3641,6738840,424,17663
2248,6,40,23,2,57651540,3641,6738840,424,17669
2249,7,40,23,2,57651540,3641,6738840,424,17676
2250,6,40,23,2,57651540,3641,6738840,424,17682
2251,9,40,23,2,57651540,3641,6738840,424,17691
2252,7,40,23,2,57651540,3641,6738840,424,17698
2253,4,40,23,2,57651540,3641,6738840,424,17702
2254,6,40,23,2,57651540,3641,6738840,424,17708
2255,8,40,23,2,57651540,3641,6738840,424,17716
2256,3,40,23,2,57651540,3641,6738840,424,17719
2257,4,40,23,2,57651540,3641,6738840,424,17723
2258,8,40,23,2,57651540,3641,6738840,424,17731
2259,7,40,23,2,57651540,3641,6738840,424,17738
2260,6,40,23,2,57651540,3641,6738840,424,17744
2261,15,40,23,2,57651540,3641,6738840,424,17759
2262,9,40,23,2,57651540,3641,6738840,424,17768
2263,8,40,23,2,57651540,3641,6738840,424,17776
2264,6,40,23,2,57651540,3641,6738840,424,17782
2265,11,40,23,2,57651540,3641,6738840,424,17793
2266,10,40,23,2,57651540,3641,6738840,424,17803
2267,11,40,23,2,57651540,3641,6738840,424,17814
2268,5,40,23,2,57651540,3641,6738840,424,17819
2269,7,40,23,2,57651540,3641,6738840,424,17826
2270,11,40,23,2,57651540,3641,6738840,424,17837
2271,9,40,23,2,57651540,3641,6738840,424,17846
2272,3,40,23,2,57651540,3641,6738840,424,17849
2273,11,40,23,2,57651540,3641,6738840,424,17860
2274,10,40,23,2,57651540,3641,6738840,424,17870
2275,6,40,23,2,57651540,3641,6738840,424,17876
2276,5,40,23,2,57651540,3641,6738840,424,17881
2277,9,40,23,2,57651540,3641,6738840,424,17890
2278,6,40,23,2,57651540,3641,6738840,424,17896
2279,11,40,23,2,57651540,3641,6738840,424,17907
2280,6,40,23,2,57651540,3641,6738840,424,17913
2281,1,40,23,2,57651540,3641,6738840,424,17914
2282,9,40,23,2,57651540,3641,6738840,424,17923
2283,5,40,23,2,57651540,3641,6738840,424,17928
2284,8,40,23,2,57651540,3641,6738840,424,17936
2285,4,40,23,2,57651540,3641,6738840,424,17940
2286,6,40,23,2,57651540,3641,6738840,424,17946
2287,10,40,23,2,57651540,3641,6738840,424,17956
2288,16,40,23,2,57651540,3641,6738840,424,17972
2289,8,40,23,2,57651540,3641,6738840,424,17980
2290,4,40,23,2,57651540,3641,6738840,424,17984
2291,7,40,23,2,57651540,3641,6738840,424,17991
2292,7,40,23,2,57651540,3641,6738840,424,17998
2293,14,40,23,2,57651540,3641,6738840,424,18012
2294,13,40,23,2,57651540,3641,6738840,424,18025
2295,13,40,23,2,57651540,3641,6738840,424,18038
2296,11,40,23,2,57651540,3641,6738840,424,18049
2297,9,40,23,2,57651540,3641,6738840,424,18058
2298,10,40,23,2,57651540,3641,6738840,424,18068
2299,8,40,23,2,57651540,3641,6738840,424,18076
2300,4,40,23,2,57651540,3641,6738840,424,18080
2301,13,40,23,2,57651540,3641,6738840,424,18093
2302,7,40,23,2,57651540,3641,6738840,424,18100
2303,5,40,23,2,57651540,3641,6738840,424,18105
2304,4,40,23,2,57651540,3641,6738840,424,18109
2305,7,40,23,2,57651540,3641,6738840,424,18116
2306,6,40,23,2,57651540,3641,6738840,424,18122
2307,5,40,23,2,57651540,3641,6738840,424,18127
2308,3,40,23,2,57651540,3641,6738840,424,18130
2309,5,40,23,2,57651540,3641,6738840,424,18135
2310,13,40,23,2,57651540,3641,6738840,424,18148
2311,12,40,23,2,57651540,3641,6738840,424,18160
2312,9,40,23,2,57651540,3641,6738840,424,18169
2313,7,40,23,2,57651540,3641,6738840,424,18176
2314,14,40,23,2,57651540,3641,6738840,424,18190
2315,14,40,23,2,57651540,3641,6738840,424,18204
2316,15,40,23,2,57651540,3641,6738840,424,18219
2317,5,40,23,2,57651540,3641,6738840,424,18224
2318,15,40,23,2,57651540,3641,6738840,424,18239
2319,13,40,23,2,57651540,3641,6738840,424,18252
2320,16,40,23,2,57651540,3641,6738840,424,18268
2321,14,40,23,2,57651540,3641,6738840,424,18282
2322,5,40,23,2,57651540,3641,6738840,424,18287
2323,8,40,23,2,57651540,3641,6738840,424,18295
2324,3,40,23,2,57651540,3641,6738840,424,18298
2325,4,40,23,2,57651540,3641,6738840,424,18302
2326,7,40,23,2,57651540,3641,6738840,424,18309
2327,4,40,23,2,57651540,3641,6738840,424,18313
2328,7,40,23,2,57651540,3641,6738840,424,18320
2329,6,40,23,2,57651540,3641,6738840,424,18326
2330,7,40,23,2,57651540,3641,6738840,424,18333
2331,7,40,23,2,57651540,3641,6738840,424,18340
2332,5,40,23,2,57651540,3641,6738840,424,18345
2333,9,40,23,2,57651540,3641,6738840,424,18354
2334,7,40,23,2,57651540,3641,6738840,424,18361
2335,7,40,23,2,57651540,3641,6738840,424,18368
2336,9,40,23,2,57651540,3641,6738840,424,18377
2337,10,40,23,2,57651540,3641,6738840,424,18387
2338,8,40,23,2,57651540,3641,6738840,424,18395
2339,4,40,23,2,57651540,3641,6738840,424,18399
2340,8,40,23,2,57651540,3641,6738840,424,18407
2341,14,40,23,2,57651540,3641,6738840,424,18421
2342,13,40,23,2,57651540,3641,6738840,424,18434
2343,6,40,23,2,57651540,3641,6738840,424,18440
2344,9,40,23,2,57651540,3641,6738840,424,18449
2345,9,40,23,2,57651540,3641,6738840,424,18458
2346,7,40,23,2,57651540,3641,6738840,424,18465
2347,4,40,23,2,57651540,3641,6738840,424,18469
2348,4,40,23,2,57651540,3641,6738840,424,18473
2349,7,40,23,2,57651540,3641,6738840,424,18480
2350,7,40,23,2,57651540,3641,6738840,424,18487
2351,6,40,23,2,57651540,3641,6738840,424,18493
2352,6,40,23,2,57651540,3641,6738840,424,18499
2353,5,40,23,2,57651540,3641,6738840,424,18504
2354,2,40,23,2,57651540,3641,6738840,424,18506
2355,2,40,23,2,57651540,3641,6738840,424,18508
2356,7,40,23,2,57651540,3641,6738840,424,18515
2357,7,40,23,2,57651540,3641,6738840,424,18522
2358,8,40,23,2,57651540,3641,6738840,424,18530
2359,8,40,23,2,57651540,3641,6738840,424,18538
2360,7,40,23,2,57651540,3641,6738840,424,18545
2361,10,40,23,2,57651540,3641,6738840,424,18555
2362,16,40,23,2,57651540,3641,6738840,424,18571
2363,9,40,23,2,57651540,3641,6738840,424,18580
2364,12,40,23,2,57651540,3641,6738840,424,18592
2365,8,40,23,2,57651540,3641,6738840,424,18600
2366,8,40,23,2,57651540,3641,6738840,424,18608
2367,11,40,23,2,57651540,3641,6738840,424,18619
2368,16,40,23,2,57651540,3641,6738840,424,18635
2369,13,40,23,2,57651540,3641,6738840,424,18648
2370,7,40,23,2,57651540,3641,6738840,424,18655
2371,11,40,23,2,57651540,3641,6738840,424,18666
2372,7,40,23,2,57651540,3641,6738840,424,18673
2373,3,40,23,2,57651540,3641,6738840,424,18676
2374,8,40,23,2,57651540,3641,6738840,424,18684
2375,6,40,23,2,57651540,3641,6738840,424,18690
2376,8,40,23,2,57651540,3641,6738840,424,18698
2377,5,40,23,2,57651540,3641,6738840,424,18703
2378,2,40,23,2,57651540,3641,6738840,424,18705
2379,4,40,23,2,57651540,3641,6738840,424,18709
2380,8,40,23,2,57651540,3641,6738840,424,18717
2381,8,40,23,2,57651540,3641,6738840,424,18725
2382,8,40,23,2,57651540,3641,6738840,424,18733
2383,9,40,23,2,57651540,3641,6738840,424,18742
2384,14,40,23,2,57651540,3641,6738840,424,18756
2385,11,40,23,2,57651540,3641,6738840,424,18767
2386,9,40,23,2,57651540,3641,6738840,424,18776
2387,10,40,23,2,57651540,3641,6738840,424,18786
2388,9,40,23,2,57651540,3641,6738840,424,18795
2389,5,40,23,2,57651540,3641,6738840,424,18800
2390,7,40,23,2,57651540,3641,6738840,424,18807
2391,11,40,23,2,57651540,3641,6738840,424,18818
2392,9,40,23,2,57651540,3641,6738840,424,18827
2393,7,40,23,2,57651540,3641,6738840,424,18834
2394,10,40,23,2,57651540,3641,6738840,424,18844
2395,10,40,23,2,57651540,3641,6738840,424,18854
2396,6,40,23,2,57651540,3641,6738840,424,18860
2397,6,40,23,2,57651540,3641,6738840,424,18866
2398,6,40,23,2,57651540,3641,6738840,424,18872
2399,8,40,23,2,57651540,3641,6738840,424,18880

