Hour,Arrivals,Waiting,Treating,Available Rooms,Total Treatment Time,Average Treatment Time,Total Wait Time,Average Wait Time,Total Arrivals
1,7,0,7,18,0,0,0,0,7
2,0,0,3,22,16200,4050,0,0,7
3,5,0,3,22,29400,3266,0,0,12
4,7,0,5,20,44580,3184,0,0,19
5,4,0,4,21,58380,3072,0,0,23
6,6,0,3,22,84720,3258,0,0,29
7,6,0,4,21,94680,3054,0,0,35
8,5,0,6,19,110520,3250,0,0,40
9,6,0,6,19,127140,3178,0,0,46
10,7,0,7,18,146280,3180,0,0,53
11,9,0,9,16,170700,3220,0,0,62
12,12,0,8,17,206100,3122,0,0,74
13,6,0,8,17,232380,3227,0,0,80
14,6,0,9,16,242580,3150,0,0,86
15,13,0,11,14,293760,3338,0,0,99
16,13,0,8,17,342180,3290,0,0,112
17,7,0,9,16,354660,3224,0,0,119
18,5,0,7,18,382020,3265,0,0,124
19,10,0,9,16,415500,3324,0,0,134
20,5,0,6,19,440580,3312,0,0,139
21,11,0,12,13,461880,3346,0,0,150
22,3,0,6,19,497760,3386,0,0,153
23,4,0,4,21,528840,3456,0,0,157
24,3,0,3,22,550380,3505,0,0,160
25,4,0,4,21,565560,3534,0,0,164
26,6,0,3,22,579000,3467,0,0,170
27,5,0,7,18,580020,3452,0,0,175
28,10,0,9,16,604740,3436,0,0,185
29,8,0,7,18,637920,3429,0,0,193
30,6,0,5,20,670920,3458,0,0,199
31,4,0,6,19,685680,3480,0,0,203
32,4,0,6,19,704400,3504,0,0,207
33,7,0,5,20,740340,3542,0,0,214
34,9,0,10,15,755100,3545,0,0,223
35,9,0,8,17,782880,3495,0,0,232
36,11,0,12,13,802020,3471,0,0,243
37,8,0,12,13,833580,3487,0,0,251
38,9,0,10,15,888780,3555,0,0,260
39,8,0,9,16,921360,3557,0,0,268
40,7,0,6,19,960540,3570,0,0,275
41,7,0,8,17,982380,3585,0,0,282
42,6,0,9,16,1001340,3589,0,0,288
43,7,0,4,21,1037700,3565,0,0,295
44,3,0,4,21,1051800,3577,0,0,298
45,6,0,7,18,1066500,3590,0,0,304
46,6,0,10,15,1074000,3580,0,0,310
47,1,0,7,18,1098660,3614,0,0,311
48,2,0,1,24,1143600,3665,0,0,313
49,6,0,5,20,1147500,3654,0,0,319
50,5,0,7,18,1153740,3639,0,0,324
51,2,0,5,20,1171440,3649,0,0,326
52,8,0,9,16,1176180,3619,0,0,334
53,6,0,7,18,1220940,3666,0,0,340
54,7,0,7,18,1242180,3653,0,0,347
55,6,0,7,18,1275780,3687,0,0,353
56,6,0,5,20,1308180,3695,0,0,359
57,5,0,3,22,1329720,3683,0,0,364
58,12,0,9,16,1345680,3666,0,0,376
59,11,0,12,13,1369980,3653,0,0,387
60,7,0,7,18,1409340,3641,0,0,394
61,5,0,4,21,1429680,3619,0,0,399
62,6,0,5,20,1453440,3633,0,0,405
63,5,0,6,19,1472340,3644,0,0,410
64,9,0,10,15,1491720,3647,0,0,419
65,4,0,4,21,1529760,3650,0,0,423
66,9,0,10,15,1538280,3645,0,0,432
67,6,0,7,18,1562040,3624,0,0,438
68,10,0,9,16,1585920,3612,0,0,448
69,6,0,7,18,1615740,3614,0,0,454
70,5,0,6,19,1648800,3639,0,0,459
71,3,0,2,23,1675140,3641,0,0,462
72,5,0,5,20,1681740,3640,0,0,467
73,3,0,6,19,1690740,3643,0,0,470
74,4,0,6,19,1720020,3675,0,0,474
75,5,0,4,21,1741680,3666,0,0,479
76,6,0,4,21,1759920,3658,0,0,485
77,8,0,8,17,1765740,3640,0,0,493
78,5,0,5,20,1796640,3644,0,0,498
79,6,0,7,18,1805640,3633,0,0,504
80,8,0,8,17,1827060,3625,0,0,512
81,9,0,8,17,1854600,3615,0,0,521
82,16,0,15,10,1871460,3585,0,0,537
83,6,0,13,12,1914540,3612,0,0,543
84,9,0,9,16,1970100,3628,0,0,552
85,4,0,6,19,1994760,3626,0,0,556
86,7,0,8,17,2027580,3653,0,0,563
87,7,0,7,18,2049060,3639,0,0,570
88,17,0,14,11,2083980,3636,0,0,587
89,10,0,12,13,2118000,3620,0,0,597
90,11,0,11,14,2163600,3624,0,0,608
91,4,0,7,18,2203500,3642,0,0,612
92,6,0,4,21,2241120,3650,0,0,618
93,5,0,6,19,2247840,3643,0,0,623
94,5,0,7,18,2263620,3645,0,0,628
95,6,0,5,20,2303340,3661,0,0,634
96,2,0,3,22,2323020,3669,0,0,636
97,4,0,4,21,2334120,3670,0,0,640
98,1,0,2,23,2343360,3667,0,0,641
99,8,0,7,18,2357400,3671,0,0,649
100,7,0,5,20,2371740,3643,0,0,656
101,5,0,4,21,2390040,3637,0,0,661
102,10,0,7,18,2412660,3633,0,0,671
103,12,0,12,13,2426820,3616,0,0,683
104,4,0,7,18,2459460,3616,0,0,687
105,8,0,5,20,2501520,3625,0,0,695
106,6,0,6,19,2518200,3623,0,0,701
107,9,0,8,17,2544780,3625,0,0,710
108,7,0,10,15,2558040,3618,0,0,717
109,7,0,10,15,2588040,3624,0,0,724
110,8,0,10,15,2628960,3641,0,0,732
111,8,0,9,16,2650920,3626,0,0,740
112,12,0,14,11,2676660,3626,0,0,752
113,11,0,10,15,2747460,3648,0,0,763
114,7,0,9,16,2772480,3643,0,0,770
115,10,0,10,15,2796120,3631,0,0,780
116,2,0,5,20,2839380,3654,0,0,782
117,3,0,6,19,2857140,3667,0,0,785
118,6,0,7,18,2882220,3676,0,0,791
119,6,0,6,19,2908080,3676,0,0,797
120,5,0,6,19,2924400,3673,0,0,802
121,5,0,5,20,2945220,3672,0,0,807
122,1,0,1,24,2970360,3680,0,0,808
123,5,0,3,22,2976780,3675,0,0,813
124,10,0,11,14,2982420,3672,0,0,823
125,12,0,9,16,3015420,3650,0,0,835
126,1,0,1,24,3062340,3667,0,0,836
127,4,0,3,22,3066780,3664,0,0,840
128,10,0,11,14,3072180,3661,0,0,850
129,8,0,9,16,3101640,3653,0,0,858
130,12,0,12,13,3133980,3652,0,0,870
131,2,0,4,21,3178380,3661,0,0,872
132,8,0,4,21,3194040,3646,0,0,880
133,8,0,7,18,3212040,3645,0,0,888
134,7,0,5,20,3228180,3627,0,0,895
135,10,0,8,17,3256080,3629,0,0,905
136,9,0,9,16,3275520,3619,0,0,914
137,10,0,10,15,3297300,3607,0,0,924
138,8,0,9,16,3322080,3599,0,0,932
139,6,0,3,22,3363360,3597,0,0,938
140,8,0,8,17,3370740,3593,0,0,946
141,12,0,10,15,3402360,3588,0,0,958
142,7,0,10,15,3431280,3592,0,0,965
143,2,0,6,19,3468000,3608,0,0,967
144,4,0,4,21,3490800,3609,0,0,971
145,5,0,5,20,3506280,3610,0,0,976
146,7,0,9,16,3515340,3609,0,0,983
147,4,0,5,20,3550920,3616,0,0,987
148,8,0,5,20,3577140,3613,0,0,995
149,2,0,2,23,3591660,3609,0,0,997
150,5,0,6,19,3594360,3608,0,0,1002
151,5,0,7,18,3617400,3617,0,0,1007
152,11,0,9,16,3644460,3611,0,0,1018
153,9,0,10,15,3664860,3603,0,0,1027
154,8,0,8,17,3703920,3606,0,0,1035
155,10,0,10,15,3724740,3598,0,0,1045
156,13,0,10,15,3775260,3602,0,0,1058
157,11,0,7,18,3807600,3585,0,0,1069
158,7,0,7,18,3831840,3584,0,0,1076
159,10,0,6,19,3871620,3584,0,0,1086
160,5,0,6,19,3886020,3581,0,0,1091
161,8,0,8,17,3901860,3576,0,0,1099
162,2,0,4,21,3928260,3580,0,0,1101
163,11,0,8,17,3952800,3580,0,0,1112
164,8,0,5,20,3981900,3571,0,0,1120
165,4,0,5,20,3990360,3566,0,0,1124
166,9,0,8,17,4020000,3573,0,0,1133
167,5,0,7,18,4043280,3574,0,0,1138
168,4,0,5,20,4075440,3584,0,0,1142
169,4,0,5,20,4092300,3586,0,0,1146
170,4,0,3,22,4111380,3584,0,0,1150
171,9,0,5,20,4126920,3576,0,0,1159
172,5,0,5,20,4142520,3574,0,0,1164
173,3,0,4,21,4152660,3570,0,0,1167
174,8,0,3,22,4181880,3568,0,0,1175
175,5,0,5,20,4189500,3565,0,0,1180
176,6,0,4,21,4214580,3565,0,0,1186
177,5,0,5,20,4218420,3556,0,0,1191
178,7,0,9,16,4231740,3559,0,0,1198
179,9,0,5,20,4279800,3560,0,0,1207
180,9,0,7,18,4296120,3553,0,0,1216
181,10,0,12,13,4310280,3550,0,0,1226
182,14,5,13,12,4338960,3550,1920,1,1240
183,9,4,16,9,4381560,3565,16920,13,1249
184,10,0,13,12,4442340,3565,30060,23,1259
185,10,0,12,13,4490640,3572,30060,23,1269
186,6,0,10,15,4533360,3583,30060,23,1275
187,6,0,7,18,4583340,3597,30060,23,1281
188,4,0,5,20,4604220,3597,30060,23,1285
189,3,0,4,21,4633800,3608,30060,23,1288
190,6,0,6,19,4643880,3605,30060,23,1294
191,3,0,4,21,4664880,3607,30060,23,1297
192,5,0,6,19,4672860,3605,30060,23,1302
193,5,0,4,21,4709340,3614,30060,22,1307
194,4,0,6,19,4717800,3615,30060,22,1311
195,1,0,2,23,4732260,3612,30060,22,1312
196,2,0,0,25,4754340,3618,30060,22,1314
197,8,0,5,20,4756920,3611,30060,22,1322
198,5,0,8,17,4763280,3611,30060,22,1327
199,9,0,6,19,4788300,3600,30060,22,1336
200,8,0,11,14,4798920,3600,30060,22,1344
201,11,0,9,16,4853940,3606,30060,22,1355
202,8,0,7,18,4884900,3602,30060,22,1363
203,10,0,9,16,4905120,3596,30060,21,1373
204,7,0,9,16,4928640,3594,30060,21,1380
205,9,0,8,17,4963500,3594,30060,21,1389
206,6,0,9,16,4980840,3593,30060,21,1395
207,7,0,7,18,5019660,3598,30060,21,1402
208,11,0,9,16,5049240,3596,30060,21,1413
209,6,0,8,17,5080260,3600,30060,21,1419
210,11,0,13,12,5103480,3601,30060,21,1430
211,3,0,6,19,5142600,3603,30060,20,1433
212,9,0,7,18,5183940,3612,30060,20,1442
213,2,0,4,21,5197380,3609,30060,20,1444
214,6,0,4,21,5222700,3611,30060,20,1450
215,2,0,3,22,5233140,3611,30060,20,1452
216,5,0,5,20,5245260,3612,30060,20,1457
217,5,0,7,18,5252520,3609,30060,20,1462
218,5,0,4,21,5284980,3612,30060,20,1467
219,6,0,10,15,5284980,3612,30060,20,1473
220,7,0,7,18,5327160,3616,30060,20,1480
221,8,0,9,16,5337480,3608,30060,20,1488
222,8,0,3,22,5388060,3608,30060,20,1496
223,8,0,6,19,5397300,3603,30060,19,1504
224,10,0,9,16,5412480,3596,30060,19,1514
225,4,0,6,19,5438700,3597,30060,19,1518
226,8,0,6,19,5467800,3597,30060,19,1526
227,3,0,4,21,5488500,3599,30060,19,1529
228,9,0,8,17,5508360,3600,30060,19,1538
229,16,0,15,10,5533200,3595,30060,19,1554
230,10,0,10,15,5582880,3592,30060,19,1564
231,12,0,12,13,5622180,3594,30060,19,1576
232,5,0,8,17,5659200,3597,30060,19,1581
233,8,0,7,18,5695740,3600,30060,18,1589
234,5,0,6,19,5726040,3605,30060,18,1594
235,10,0,8,17,5744460,3599,30060,18,1604
236,4,0,6,19,5758260,3594,30060,18,1608
237,5,0,6,19,5773500,3592,30060,18,1613
238,12,0,11,14,5793420,3589,30060,18,1625
239,2,0,6,19,5832060,3597,30060,18,1627
240,7,0,7,18,5867760,3606,30060,18,1634
241,3,0,3,22,5892900,3606,30060,18,1637
242,1,0,1,24,5903040,3606,30060,18,1638
243,7,0,4,21,5909520,3601,30060,18,1645
244,12,0,11,14,5915340,3593,30060,18,1657
245,3,0,8,17,5947920,3600,30060,18,1660
246,8,0,10,15,5960760,3595,30060,18,1668
247,6,0,5,20,6027960,3611,30060,17,1674
248,5,0,6,19,6042180,3611,30060,17,1679
249,6,0,6,19,6066600,3613,30060,17,1685
250,5,0,3,22,6098640,3615,30060,17,1690
251,8,0,9,16,6100560,3611,30060,17,1698
252,5,0,6,19,6131640,3613,30060,17,1703
253,8,0,6,19,6167940,3617,30060,17,1711
254,7,0,10,15,6177480,3616,30060,17,1718
255,10,0,10,15,6212040,3615,30060,17,1728
256,11,0,13,12,6241440,3616,30060,17,1739
257,5,0,6,19,6286620,3617,30060,17,1744
258,8,0,8,17,6315000,3620,30060,17,1752
259,3,0,6,19,6339840,3624,30060,17,1755
260,8,0,7,18,6366120,3625,30060,17,1763
261,8,0,8,17,6399840,3630,30060,16,1771
262,5,0,5,20,6426120,3628,30060,16,1776
263,3,0,4,21,6451140,3634,30060,16,1779
264,7,0,7,18,6457440,3629,30060,16,1786
265,5,0,4,21,6494760,3634,30060,16,1791
266,4,0,4,21,6506820,3633,30060,16,1795
267,3,0,2,23,6531180,3636,30060,16,1798
268,5,0,4,21,6535320,3632,30060,16,1803
269,5,0,6,19,6551460,3635,30060,16,1808
270,9,0,7,18,6570840,3630,30060,16,1817
271,10,0,7,18,6598500,3625,30060,16,1827
272,2,0,3,22,6616260,3623,30060,16,1829
273,2,0,2,23,6629400,3624,30060,16,1831
274,5,0,4,21,6633300,3620,30060,16,1836
275,4,0,5,20,6641400,3619,30060,16,1840
276,11,0,7,18,6673200,3618,30060,16,1851
277,7,0,8,17,6684000,3612,30060,16,1858
278,8,0,6,19,6720360,3613,30060,16,1866
279,7,0,8,17,6737340,3612,30060,16,1873
280,14,0,13,12,6766500,3610,30060,15,1887
281,7,0,11,14,6800340,3611,30060,15,1894
282,4,0,7,18,6830460,3612,30060,15,1898
283,3,0,1,24,6876540,3619,30060,15,1901
284,5,0,4,21,6883680,3619,30060,15,1906
285,3,0,2,23,6893760,3614,30060,15,1909
286,4,0,3,22,6906780,3616,30060,15,1913
287,4,0,3,22,6918000,3614,30060,15,1917
288,3,0,4,21,6925260,3614,30060,15,1920
289,2,0,3,22,6935880,3614,30060,15,1922
290,5,0,7,18,6936600,3612,30060,15,1927
291,5,0,5,20,6976320,3620,30060,15,1932
292,2,0,3,22,6996240,3623,30060,15,1934
293,5,0,6,19,7005060,3623,30060,15,1939
294,5,0,5,20,7024680,3622,30060,15,1944
295,4,0,4,21,7046160,3624,30060,15,1948
296,9,0,8,17,7058460,3621,30060,15,1957
297,5,0,7,18,7079040,3620,30060,15,1962
298,13,0,9,16,7111500,3617,30060,15,1975
299,13,0,15,10,7129920,3613,30060,15,1988
300,15,0,16,9,7189620,3618,30060,15,2003
301,12,0,9,16,7250700,3614,30060,14,2015
302,13,0,12,13,7288380,3615,30060,14,2028
303,10,0,11,14,7328340,3615,30060,14,2038
304,7,0,12,13,7359780,3620,30060,14,2045
305,9,0,9,16,7405440,3621,30060,14,2054
306,8,0,8,17,7450320,3627,30060,14,2062
307,4,0,6,19,7478880,3630,30060,14,2066
308,3,0,2,23,7506120,3631,30060,14,2069
309,8,0,8,17,7515720,3632,30060,14,2077
310,5,0,5,20,7544280,3632,30060,14,2082
311,2,0,2,23,7567920,3634,30060,14,2084
312,7,0,5,20,7576260,3631,30060,14,2091
313,4,0,5,20,7600560,3636,30060,14,2095
314,2,0,2,23,7621140,3637,30060,14,2097
315,5,0,4,21,7626600,3635,30060,14,2102
316,5,0,6,19,7632120,3632,30060,14,2107
317,6,0,6,19,7647780,3629,30060,14,2113
318,6,0,4,21,7673700,3628,30060,14,2119
319,7,0,7,18,7688880,3628,30060,14,2126
320,9,0,8,17,7721160,3630,30060,14,2135
321,4,0,7,18,7739640,3630,30060,14,2139
322,7,0,9,16,7764900,3633,30060,14,2146
323,10,0,8,17,7808700,3635,30060,13,2156
324,10,0,11,14,7834560,3635,30060,13,2166
325,11,0,10,15,7869660,3631,30060,13,2177
326,8,0,10,15,7896960,3630,30060,13,2185
327,10,0,15,10,7919460,3632,30060,13,2195
328,8,0,11,14,7981620,3641,30060,13,2203
329,9,0,9,16,8025540,3643,30060,13,2212
330,8,0,9,16,8056560,3643,30060,13,2220
331,4,0,9,16,8074320,3645,30060,13,2224
332,9,0,7,18,8121180,3648,30060,13,2233
333,3,0,6,19,8135220,3648,30060,13,2236
334,9,0,8,17,8168700,3651,30060,13,2245
335,7,0,3,22,8208120,3649,30060,13,2252
336,3,0,4,21,8219160,3651,30060,13,2255
337,4,0,5,20,8232660,3652,30060,13,2259
338,2,0,4,21,8251080,3655,30060,13,2261
339,3,0,2,23,8275200,3658,30060,13,2264
340,5,0,3,22,8281200,3654,30060,13,2269
341,1,0,2,23,8285640,3653,30060,13,2270
342,5,0,4,21,8300700,3655,30060,13,2275
343,8,0,6,19,8317020,3652,30060,13,2283
344,5,0,7,18,8335380,3654,30060,13,2288
345,7,0,7,18,8360280,3653,30060,13,2295
346,11,0,11,14,8379060,3651,30060,13,2306
347,15,0,14,11,8411400,3646,30060,12,2321
348,10,0,10,15,8471580,3649,30060,12,2331
349,11,0,11,14,8504280,3648,30060,12,2342
350,6,0,6,19,8537580,3645,30060,12,2348
351,13,0,8,17,8565720,3640,30060,12,2361
352,3,0,5,20,8596980,3644,30060,12,2364
353,4,0,4,21,8619420,3646,30060,12,2368
354,9,0,11,14,8629860,3647,30060,12,2377
355,6,0,5,20,8663940,3643,30060,12,2383
356,13,0,9,16,8699280,3644,30060,12,2396
357,9,0,9,16,8731440,3644,30060,12,2405
358,7,0,9,16,8765700,3647,30060,12,2412
359,7,0,7,18,8792400,3645,30060,12,2419
360,5,0,8,17,8813520,3647,30060,12,2424
361,3,0,4,21,8841480,3648,30060,12,2427
362,2,0,2,23,8868540,3654,30060,12,2429
363,4,0,3,22,8873940,3651,30060,12,2433
364,3,0,3,22,8881860,3650,30060,12,2436
365,4,0,5,20,8890320,3651,30060,12,2440
366,11,0,11,14,8903940,3649,30060,12,2451
367,6,0,7,18,8941560,3649,30060,12,2457
368,8,0,7,18,8984760,3655,30060,12,2465
369,12,0,12,13,9004620,3652,30060,12,2477
370,10,0,6,19,9049380,3647,30060,12,2487
371,4,0,5,20,9065700,3646,30060,12,2491
372,11,0,7,18,9087240,3642,30060,12,2502
373,11,0,12,13,9099300,3638,30060,11,2513
374,4,0,7,18,9143040,3642,30060,11,2517
375,8,0,6,19,9186180,3646,30060,11,2525
376,5,0,7,18,9193860,3644,30060,11,2530
377,7,0,6,19,9231300,3647,30060,11,2537
378,11,0,13,12,9238920,3644,30060,11,2548
379,4,0,7,18,9281760,3647,30060,11,2552
380,7,0,6,19,9313860,3648,30060,11,2559
381,3,0,1,24,9341700,3647,30060,11,2562
382,7,0,7,18,9342720,3646,30060,11,2569
383,5,0,7,18,9359580,3646,30060,11,2574
384,3,0,4,21,9386340,3648,30060,11,2577
385,3,0,5,20,9392520,3647,30060,11,2580
386,14,0,9,16,9417840,3643,30060,11,2594
387,8,0,11,14,9433740,3640,30060,11,2602
388,4,0,4,21,9484740,3645,30060,11,2606
389,2,0,3,22,9497160,3645,30060,11,2608
390,3,0,2,23,9510060,3645,30060,11,2611
391,2,0,2,23,9514320,3643,30060,11,2613
392,8,0,7,18,9523200,3643,30060,11,2621
393,1,0,3,22,9545520,3644,30060,11,2622
394,3,0,2,23,9556920,3643,30060,11,2625
395,4,0,2,23,9568380,3642,30060,11,2629
396,8,0,7,18,9579000,3642,30060,11,2637
397,8,0,6,19,9599640,3637,30060,11,2645
398,6,0,7,18,9623520,3639,30060,11,2651
399,7,0,8,17,9642120,3638,30060,11,2658
400,5,0,3,22,9674160,3636,30060,11,2663
401,7,0,8,17,9678900,3635,30060,11,2670
402,11,0,10,15,9704040,3633,30060,11,2681
403,4,0,6,19,9733620,3633,30060,11,2685
404,5,0,8,17,9751800,3636,30060,11,2690
405,6,0,6,19,9790140,3639,30060,11,2696
406,5,0,9,16,9798780,3639,30060,11,2701
407,3,0,3,22,9841080,3643,30060,11,2704
408,5,0,4,21,9854700,3643,30060,11,2709
409,5,0,4,21,9873660,3643,30060,11,2714
410,3,0,3,22,9884940,3642,30060,11,2717
411,2,0,2,23,9898080,3643,30060,11,2719
412,5,0,5,20,9901560,3641,30060,11,2724
413,5,0,4,21,9926760,3642,30060,11,2729
414,7,0,4,21,9944100,3639,30060,10,2736
415,2,0,3,22,9958860,3641,30060,10,2738
416,10,0,7,18,9977220,3639,30060,10,2748
417,4,0,7,18,9987480,3638,30060,10,2752
418,10,0,6,19,10024200,3637,30060,10,2762
419,7,0,8,17,10044900,3638,30060,10,2769
420,7,0,6,19,10084380,3640,30060,10,2776
421,6,0,8,17,10094160,3638,30060,10,2782
422,15,0,11,14,10128300,3635,30060,10,2797
423,9,0,13,12,10149780,3634,30060,10,2806
424,6,0,7,18,10198500,3635,30060,10,2812
425,9,0,7,18,10233120,3636,30060,10,2821
426,9,0,10,15,10256820,3637,30060,10,2830
427,4,0,6,19,10289220,3638,30060,10,2834
428,4,0,2,23,10320780,3639,30060,10,2838
429,4,0,4,21,10324080,3637,30060,10,2842
430,5,0,7,18,10334040,3638,30060,10,2847
431,8,0,7,18,10353480,3635,30060,10,2855
432,4,0,5,20,10375860,3635,30060,10,2859
433,5,0,2,23,10401240,3634,30060,10,2864
434,5,0,3,22,10413600,3633,30060,10,2869
435,3,0,2,23,10421280,3631,30060,10,2872
436,4,0,3,22,10428300,3629,30060,10,2876
437,7,0,7,18,10433160,3627,30060,10,2883
438,2,0,3,22,10461240,3629,30060,10,2885
439,7,0,5,20,10480440,3630,30060,10,2892
440,4,0,3,22,10490700,3626,30060,10,2896
441,5,0,3,22,10505220,3624,30060,10,2901
442,7,0,5,20,10517400,3622,30060,10,2908
443,6,0,11,14,10517400,3622,30060,10,2914
444,9,0,8,17,10577220,3628,30060,10,2923
445,14,0,16,9,10591920,3626,30060,10,2937
446,12,0,12,13,10659960,3629,30060,10,2949
447,14,0,15,10,10688400,3625,30060,10,2963
448,8,0,7,18,10733580,3621,30060,10,2971
449,4,0,4,21,10769880,3625,30060,10,2975
450,8,0,7,18,10782660,3623,30060,10,2983
451,6,0,7,18,10810260,3625,30060,10,2989
452,7,0,9,16,10835040,3627,30060,10,2996
453,0,0,3,22,10855920,3627,30060,10,2996
454,7,0,4,21,10885080,3629,30060,10,3003
455,5,0,5,20,10896720,3628,30060,9,3008
456,1,0,4,21,10904340,3628,30060,9,3009
457,1,0,0,25,10932300,3631,30060,9,3010
458,4,0,2,23,10934100,3630,30060,9,3014
459,4,0,2,23,10944360,3628,30060,9,3018
460,4,0,4,21,10952580,3629,30060,9,3022
461,10,0,9,16,10965960,3627,30060,9,3032
462,7,0,6,19,10999800,3626,30060,9,3039
463,8,0,5,20,11017920,3621,30060,9,3047
464,8,0,9,16,11044740,3625,30060,9,3055
465,8,0,9,16,11077020,3627,30060,9,3063
466,14,0,12,13,11103720,3622,30060,9,3077
467,11,0,11,14,11137200,3619,30060,9,3088
468,7,0,6,19,11173560,3617,30060,9,3095
469,7,0,7,18,11198640,3618,30060,9,3102
470,7,0,8,17,11215980,3616,30060,9,3109
471,11,0,10,15,11245020,3615,30060,9,3120
472,12,0,12,13,11279280,3615,30060,9,3132
473,9,0,7,18,11322780,3612,30060,9,3141
474,10,0,10,15,11345340,3612,30060,9,3151
475,8,0,7,18,11385360,3612,30060,9,3159
476,8,0,9,16,11410560,3613,30060,9,3167
477,5,0,9,16,11431980,3614,30060,9,3172
478,3,0,7,18,11464320,3618,30060,9,3175
479,5,0,6,19,11487060,3619,30060,9,3180
480,5,0,1,24,11522580,3618,30060,9,3185
481,5,0,2,23,11527680,3615,30060,9,3190
482,3,0,2,23,11535360,3614,30060,9,3193
483,2,0,3,22,11536560,3614,30060,9,3195
484,2,0,3,22,11551980,3616,30060,9,3197
485,4,0,4,21,11557920,3615,30060,9,3201
486,10,0,11,14,11571900,3616,30060,9,3211
487,2,0,6,19,11595900,3615,30060,9,3213
488,7,0,8,17,11616420,3616,30060,9,3220
489,3,0,4,21,11656800,3621,30060,9,3223
490,8,0,7,18,11674500,3621,30060,9,3231
491,4,0,6,19,11689980,3620,30060,9,3235
492,5,0,4,21,11716440,3620,30060,9,3240
493,7,0,4,21,11735220,3618,30060,9,3247
494,14,0,14,11,11746740,3617,30060,9,3261
495,9,0,14,11,11778480,3617,30060,9,3270
496,5,0,6,19,11829180,3618,30060,9,3275
497,9,0,4,21,11857620,3615,30060,9,3284
498,6,0,4,21,11878560,3614,30060,9,3290
499,6,0,4,21,11887440,3611,30060,9,3296
500,11,0,5,20,11917200,3609,30060,9,3307
501,5,0,5,20,11932740,3608,30060,9,3312
502,3,0,1,24,11949360,3605,30060,9,3315
503,6,0,5,20,11953920,3604,30060,9,3321
504,7,0,9,16,11965500,3605,30060,9,3328
505,7,0,6,19,11993340,3602,30060,9,3335
506,7,0,4,21,12025140,3602,30060,8,3342
507,3,0,3,22,12041280,3603,30060,8,3345
508,10,0,8,17,12059760,3603,30060,8,3355
509,7,0,13,12,12063000,3601,30060,8,3362
510,5,0,8,17,12118140,3607,30060,8,3367
511,6,0,10,15,12135780,3608,30060,8,3373
512,4,0,3,22,12190320,3613,30060,8,3377
513,6,0,6,19,12200100,3612,30060,8,3383
514,6,0,9,16,12210600,3612,30060,8,3389
515,12,0,11,14,12245400,3612,30060,8,3401
516,11,0,7,18,12301440,3612,30060,8,3412
517,7,0,8,17,12327060,3613,30060,8,3419
518,11,0,8,17,12360420,3612,30060,8,3430
519,9,0,10,15,12375960,3609,30060,8,3439
520,8,0,6,19,12425460,3611,30060,8,3447
521,5,0,5,20,12440760,3609,30060,8,3452
522,9,0,6,19,12460740,3606,30060,8,3461
523,5,0,6,19,12469920,3604,30060,8,3466
524,7,0,5,20,12496440,3603,30060,8,3473
525,4,0,4,21,12519660,3604,30060,8,3477
526,6,0,8,17,12527460,3605,30060,8,3483
527,7,0,4,21,12557280,3602,30060,8,3490
528,6,0,4,21,12576000,3601,30060,8,3496
529,7,0,7,18,12589020,3600,30060,8,3503
530,4,0,4,21,12612780,3600,30060,8,3507
531,5,0,4,21,12628800,3600,30060,8,3512
532,7,0,8,17,12634680,3598,30060,8,3519
533,4,0,5,20,12664560,3599,30060,8,3523
534,8,0,9,16,12682200,3600,30060,8,3531
535,9,0,7,18,12710640,3597,30060,8,3540
536,2,0,4,21,12744960,3602,30060,8,3542
537,4,0,4,21,12764640,3603,30060,8,3546
538,13,0,12,13,12778140,3602,30060,8,3559
539,6,0,8,17,12811200,3601,30060,8,3565
540,5,0,5,20,12850380,3604,30060,8,3570
541,7,0,10,15,12854280,3603,30060,8,3577
542,7,0,11,14,12878040,3604,30060,8,3584
543,9,0,11,14,12935820,3611,30060,8,3593
544,9,0,9,16,12975540,3611,30060,8,3602
545,8,0,7,18,13013940,3611,30060,8,3610
546,4,0,5,20,13037880,3612,30060,8,3614
547,5,0,5,20,13056540,3612,30060,8,3619
548,2,0,4,21,13068240,3613,30060,8,3621
549,4,0,5,20,13080000,3613,30060,8,3625
550,2,0,3,22,13094460,3613,30060,8,3627
551,7,0,4,21,13113060,3612,30060,8,3634
552,4,0,3,22,13126920,3611,30060,8,3638
553,4,0,4,21,13134000,3610,30060,8,3642
554,6,0,5,20,13144980,3608,30060,8,3648
555,5,0,4,21,13165320,3607,30060,8,3653
556,5,0,5,20,13178820,3607,30060,8,3658
557,4,0,3,22,13202280,3608,30060,8,3662
558,12,0,10,15,13221900,3608,30060,8,3674
559,7,0,11,14,13236180,3606,30060,8,3681
560,4,0,7,18,13262880,3606,30060,8,3685
561,9,0,7,18,13302240,3607,30060,8,3694
562,7,0,8,17,13324620,3608,30060,8,3701
563,8,0,11,14,13348500,3609,30060,8,3709
564,12,0,10,15,13401480,3611,30060,8,3721
565,7,0,11,14,13420080,3610,30060,8,3728
566,3,0,4,21,13476060,3615,30060,8,3731
567,9,0,6,19,13495380,3614,30060,8,3740
568,5,0,5,20,13517880,3614,30060,8,3745
569,6,0,6,19,13531740,3613,30060,8,3751
570,9,0,11,14,13549800,3614,30060,7,3760
571,9,0,8,17,13586520,3612,30060,7,3769
572,7,0,9,16,13612740,3613,30060,7,3776
573,5,0,3,22,13653540,3613,30060,7,3781
574,7,0,6,19,13661280,3612,30060,7,3788
575,5,0,5,20,13684680,3612,30060,7,3793
576,9,0,10,15,13701600,3613,30060,7,3802
577,3,0,3,22,13738980,3613,30060,7,3805
578,9,0,9,16,13741140,3611,30060,7,3814
579,5,0,5,20,13777200,3612,30060,7,3819
580,8,0,7,18,13796940,3611,30060,7,3827
581,3,0,5,20,13808940,3610,30060,7,3830
582,4,0,4,21,13834500,3612,30060,7,3834
583,4,0,5,20,13845600,3612,30060,7,3838
584,8,0,7,18,13863360,3611,30060,7,3846
585,4,0,4,21,13883880,3609,30060,7,3850
586,8,0,8,17,13900260,3610,30060,7,3858
587,6,0,4,21,13932960,3609,30060,7,3864
588,15,0,12,13,13952520,3608,30060,7,3879
589,9,0,10,15,13984320,3606,30060,7,3888
590,12,0,14,11,14023320,3608,30060,7,3900
591,12,0,13,12,14071560,3609,30060,7,3912
592,4,0,8,17,14114100,3611,30060,7,3916
593,9,0,10,15,14146980,3613,30060,7,3925
594,7,0,6,19,14180400,3611,30060,7,3932
595,4,0,5,20,14205480,3613,30060,7,3936
596,3,0,3,22,14223420,3613,30060,7,3939
597,8,0,7,18,14237100,3613,30060,7,3947
598,10,0,11,14,14256600,3612,30060,7,3957
599,3,0,3,22,14296020,3612,30060,7,3960
600,9,0,7,18,14315940,3613,30060,7,3969
601,4,0,9,16,14321640,3612,30060,7,3973
602,5,0,5,20,14358600,3614,30060,7,3978
603,8,0,5,20,14390640,3614,30060,7,3986
604,0,0,0,25,14416080,3616,30060,7,3986
605,2,0,2,23,14416080,3616,30060,7,3988
606,5,0,4,21,14421300,3615,30060,7,3993
607,6,0,7,18,14426400,3613,30060,7,3999
608,10,0,12,13,14452440,3615,30060,7,4009
609,10,0,10,15,14483400,3612,30060,7,4019
610,8,0,6,19,14528160,3613,30060,7,4027
611,8,0,6,19,14547120,3610,30060,7,4035
612,12,0,12,13,14571300,3611,30060,7,4047
613,9,0,13,12,14598060,3610,30060,7,4056
614,9,0,14,11,14638260,3613,30060,7,4065
615,5,0,9,16,14682300,3615,30060,7,4070
616,10,0,10,15,14724240,3617,30060,7,4080
617,4,0,1,24,14778540,3619,30060,7,4084
618,6,0,7,18,14778540,3619,30060,7,4090
619,4,0,5,20,14796600,3618,30060,7,4094
620,5,0,4,21,14820180,3619,30060,7,4099
621,7,0,8,17,14832420,3619,30060,7,4106
622,3,0,6,19,14852460,3619,30060,7,4109
623,4,0,5,20,14877060,3621,30060,7,4113
624,4,0,2,23,14909100,3623,30060,7,4117
625,2,0,2,23,14911080,3621,30060,7,4119
626,4,0,3,22,14924820,3622,30060,7,4123
627,4,0,6,19,14928180,3622,30060,7,4127
628,5,0,6,19,14946240,3622,30060,7,4132
629,3,0,4,21,14968140,3623,30060,7,4135
630,9,0,7,18,14995020,3624,30060,7,4144
631,5,0,8,17,15005820,3623,30060,7,4149
632,6,0,5,20,15048120,3626,30060,7,4155
633,10,0,10,15,15058560,3624,30060,7,4165
634,7,0,7,18,15102600,3626,30060,7,4172
635,9,0,11,14,15112860,3624,30060,7,4181
636,5,0,5,20,15161400,3626,30060,7,4186
637,11,0,11,14,15177420,3625,30060,7,4197
638,6,0,7,18,15221340,3627,30060,7,4203
639,6,0,6,19,15247740,3627,30060,7,4209
640,8,0,8,17,15275460,3629,30060,7,4217
641,8,0,8,17,15306960,3629,30060,7,4225
642,4,0,4,21,15333780,3629,30060,7,4229
643,7,0,7,18,15358440,3631,30060,7,4236
644,3,0,4,21,15376920,3630,30060,7,4239
645,7,0,6,19,15398220,3631,30060,7,4246
646,5,0,3,22,15418260,3629,30060,7,4251
647,5,0,4,21,15431700,3629,30060,7,4256
648,8,0,8,17,15440160,3627,30060,7,4264
649,2,0,2,23,15474660,3629,30060,7,4266
650,4,0,5,20,15479100,3629,30060,7,4270
651,4,0,6,19,15491700,3629,30060,7,4274
652,6,0,6,19,15519960,3631,30060,7,4280
653,5,0,6,19,15540720,3631,30060,7,4285
654,5,0,5,20,15556500,3630,30060,7,4290
655,3,0,4,21,15577740,3632,30060,7,4293
656,4,0,6,19,15590220,3633,30060,6,4297
657,11,0,11,14,15602880,3631,30060,6,4308
658,16,0,12,13,15653220,3630,30060,6,4324
659,12,0,9,16,15704940,3629,30060,6,4336
660,3,0,5,20,15735720,3630,30060,6,4339
661,4,0,3,22,15765780,3632,30060,6,4343
662,13,0,8,17,15785580,3630,30060,6,4356
663,6,0,7,18,15804540,3629,30060,6,4362
664,8,0,9,16,15830220,3629,30060,6,4370
665,10,0,5,20,15874200,3628,30060,6,4380
666,5,0,4,21,15883740,3625,30060,6,4385
667,5,0,4,21,15896580,3624,30060,6,4390
668,10,0,8,17,15915360,3623,30060,6,4400
669,6,0,9,16,15926940,3622,30060,6,4406
670,7,0,8,17,15960360,3623,30060,6,4413
671,4,0,5,20,16003320,3627,30060,6,4417
672,7,0,9,16,16014060,3627,30060,6,4424
673,11,0,14,11,16019040,3623,30060,6,4435
674,6,0,14,11,16037340,3622,30060,6,4441
675,2,0,14,11,16048380,3623,30060,6,4443
676,5,0,10,15,16084200,3624,30060,6,4448
677,7,0,13,12,16092120,3622,30060,6,4455
678,3,0,9,16,16114020,3621,30060,6,4458
679,7,0,14,11,16117140,3621,30060,6,4465
680,8,0,17,8,16132680,3620,30060,6,4473
681,11,0,20,5,16155600,3619,30060,6,4484
682,7,0,17,8,16194840,3619,30060,6,4491
683,6,0,14,11,16227720,3619,30060,6,4497
684,9,0,18,7,16236720,3617,30060,6,4506
685,11,0,18,7,16275480,3617,30060,6,4517
686,9,0,20,5,16314120,3620,30060,6,4526
687,9,0,18,7,16355280,3620,30060,6,4535
688,9,0,15,10,16394400,3619,30060,6,4544
689,18,3,23,2,16413780,3618,30180,6,4562
690,8,4,22,3,16453800,3620,42480,9,4570
691,9,0,16,9,16524780,3621,51480,11,4579
692,9,0,16,9,16554180,3620,51480,11,4588
693,9,0,14,11,16591680,3620,51480,11,4597
694,5,0,11,14,16620000,3620,51480,11,4602
695,4,0,11,14,16633020,3619,51480,11,4606
696,3,0,11,14,16647300,3620,51480,11,4609
697,7,0,16,9,16654500,3620,51480,11,4616
698,5,0,15,10,16670340,3619,51480,11,4621
699,5,0,12,13,16709400,3621,51480,11,4626
700,9,0,18,7,16721040,3621,51480,11,4635
701,1,0,11,14,16755480,3622,51480,11,4636
702,5,0,11,14,16776420,3623,51480,11,4641
703,7,0,15,10,16781100,3622,51480,11,4648
704,3,0,13,12,16797840,3621,51480,11,4651
705,8,0,15,10,16827180,3623,51480,11,4659
706,9,0,17,8,16840440,3620,51480,11,4668
707,16,0,21,4,16880940,3620,51480,10,4684
708,10,0,15,10,16940100,3620,51480,10,4694
709,13,0,20,5,16967160,3620,51480,10,4707
710,7,0,17,8,16993020,3617,51480,10,4714
711,6,0,13,12,17037360,3619,51480,10,4720
712,8,0,15,10,17067180,3621,51480,10,4728
713,8,0,13,12,17100480,3620,51480,10,4736
714,6,0,17,8,17104140,3619,51480,10,4742
715,2,0,11,14,17146020,3622,51480,10,4744
716,4,0,13,12,17152440,3622,51480,10,4748
717,6,0,11,14,17178060,3621,51480,10,4754
718,8,0,12,13,17191920,3619,51480,10,4762
719,4,0,12,13,17205540,3619,51480,10,4766
720,6,0,12,13,17224980,3618,51480,10,4772
721,7,0,17,8,17235540,3619,51480,10,4779
722,4,0,12,13,17271600,3620,51480,10,4783
723,3,0,13,12,17282280,3620,51480,10,4786
724,1,0,11,14,17301840,3622,51480,10,4787
725,4,0,12,13,17310300,3622,51480,10,4791
726,4,0,13,12,17318460,3621,51480,10,4795
727,12,0,18,7,17344500,3621,51480,10,4807
728,4,0,14,11,17371800,3621,51480,10,4811
729,10,0,17,8,17396160,3621,51480,10,4821
730,7,0,15,10,17419260,3619,51480,10,4828
731,7,0,17,8,17437620,3619,51480,10,4835
732,13,0,11,14,17494560,3616,51480,10,4848
733,3,0,13,12,17496360,3616,51480,10,4851
734,12,0,16,9,17518620,3614,51480,10,4863
735,0,0,11,14,17539680,3614,51480,10,4863
736,10,0,15,10,17564220,3615,51480,10,4873
737,8,0,17,8,17589060,3616,51480,10,4881
738,6,0,18,7,17608560,3616,51480,10,4887
739,3,0,10,15,17657340,3618,51480,10,4890
740,10,0,18,7,17674680,3620,51480,10,4900
741,7,0,15,10,17698440,3617,51480,10,4907
742,4,0,12,13,17727660,3618,51480,10,4911
743,3,0,11,14,17741880,3618,51480,10,4914
744,3,0,9,16,17753340,3617,51480,10,4917
745,6,0,12,13,17764800,3617,51480,10,4923
746,7,0,15,10,17778060,3617,51480,10,4930
747,3,0,10,15,17805420,3616,51480,10,4933
748,3,0,9,16,17817360,3616,51480,10,4936
749,7,0,14,11,17820120,3615,51480,10,4943
750,7,0,16,9,17835840,3614,51480,10,4950
751,12,0,21,4,17852520,3613,51480,10,4962
752,4,0,15,10,17908920,3617,51480,10,4966
753,15,0,19,6,17935080,3614,51480,10,4981
754,5,0,14,11,17967000,3613,51480,10,4986
755,9,0,16,9,17992680,3613,51480,10,4995
756,8,0,15,10,18021540,3612,51480,10,5003
757,4,0,13,12,18037620,3611,51480,10,5007
758,5,0,12,13,18063840,3612,51480,10,5012
759,6,0,13,12,18073140,3611,51480,10,5018
760,1,0,10,15,18090180,3611,51480,10,5019
761,3,0,10,15,18102840,3611,51480,10,5022
762,7,0,13,12,18112680,3610,51480,10,5029
763,8,0,15,10,18128460,3609,51480,10,5037
764,5,0,16,9,18144000,3610,51480,10,5042
765,5,0,14,11,18178140,3611,51480,10,5047
766,4,0,13,12,18192300,3611,51480,10,5051
767,4,0,12,13,18206160,3610,51480,10,5055
768,5,0,12,13,18221700,3609,51480,10,5060
769,6,0,14,11,18229080,3608,51480,10,5066
770,4,0,13,12,18247560,3608,51480,10,5070
771,1,0,11,14,18263640,3609,51480,10,5071
772,3,0,11,14,18282900,3611,51480,10,5074
773,6,0,11,14,18291960,3608,51480,10,5080
774,4,0,13,12,18304320,3609,51480,10,5084
775,6,0,14,11,18311040,3607,51480,10,5090
776,6,0,15,10,18330540,3607,51480,10,5096
777,7,0,15,10,18357660,3608,51480,10,5103
778,4,0,13,12,18374640,3607,51480,10,5107
779,11,0,19,6,18395940,3607,51480,10,5118
780,6,0,16,9,18423360,3606,51480,10,5124
781,9,0,14,11,18470520,3608,51480,10,5133
782,5,0,15,10,18484800,3608,51480,10,5138
783,9,0,15,10,18518280,3608,51480,10,5147
784,12,0,20,5,18540000,3607,51480,9,5159
785,4,0,13,12,18577200,3607,51480,9,5163
786,7,0,14,11,18602640,3607,51480,9,5170
787,5,0,15,10,18624540,3609,51480,9,5175
788,8,0,14,11,18657060,3609,51480,9,5183
789,6,0,14,11,18670380,3607,51480,9,5189
790,5,0,15,10,18691200,3609,51480,9,5194
791,3,0,14,11,18708180,3609,51480,9,5197
792,3,0,11,14,18737340,3610,51480,9,5200
793,5,0,12,13,18748740,3610,51480,9,5205
794,7,0,11,14,18763260,3607,51480,9,5212
795,6,0,15,10,18774840,3608,51480,9,5218
796,1,0,9,16,18798060,3608,51480,9,5219
797,6,0,13,12,18806160,3608,51480,9,5225
798,8,0,18,7,18815940,3608,51480,9,5233
799,10,0,18,7,18834000,3604,51480,9,5243
800,7,0,18,7,18863460,3605,51480,9,5250
801,2,0,11,14,18903600,3606,51480,9,5252
802,12,0,13,12,18932940,3605,51480,9,5264
803,13,0,21,4,18941520,3603,51480,9,5277
804,6,0,18,7,18973800,3603,51480,9,5283
805,9,0,15,10,19027200,3605,51780,9,5292
806,9,0,15,10,19047720,3603,51780,9,5301
807,9,0,14,11,19090080,3604,51780,9,5310
808,9,0,16,9,19104900,3602,51780,9,5319
809,9,0,17,8,19124040,3600,51780,9,5328
810,13,0,17,8,19161900,3599,51780,9,5341
811,7,0,18,7,19178760,3598,51780,9,5348
812,7,0,13,12,19224180,3598,51780,9,5355
813,5,0,10,15,19257120,3599,51780,9,5360
814,5,0,13,12,19266960,3599,51780,9,5365
815,8,0,12,13,19283100,3596,51780,9,5373
816,6,0,14,11,19290660,3595,51780,9,5379
817,3,0,12,13,19314420,3596,51780,9,5382
818,3,0,10,15,19334640,3597,51780,9,5385
819,2,0,9,16,19341660,3596,51780,9,5387
820,4,0,11,14,19343700,3595,51780,9,5391
821,4,0,11,14,19352040,3594,51780,9,5395
822,3,0,11,14,19359060,3593,51780,9,5398
823,9,0,15,10,19375440,3593,51780,9,5407
824,6,0,14,11,19398000,3592,51780,9,5413
825,10,0,16,9,19431540,3593,51780,9,5423
826,2,0,13,12,19448880,3593,51780,9,5425
827,6,0,15,10,19468500,3594,51780,9,5431
828,9,0,17,8,19499040,3595,51780,9,5440
829,9,0,19,6,19531680,3596,51780,9,5449
830,15,0,23,2,19572180,3597,52200,9,5464
831,7,0,18,7,19616940,3597,52560,9,5471
832,16,7,19,6,19654560,3599,56520,10,5487
833,7,3,21,4,19703220,3602,79500,14,5494
834,11,5,19,6,19729140,3599,94920,17,5505
835,6,0,16,9,19797180,3602,103800,18,5511
836,5,0,13,12,19834440,3604,103800,18,5516
837,6,0,12,13,19864260,3605,103800,18,5522
838,9,0,19,6,19867980,3604,103800,18,5531
839,7,0,15,10,19904400,3603,103800,18,5538
840,5,0,12,13,19927140,3602,103800,18,5543
841,8,0,13,12,19953300,3602,103800,18,5551
842,5,0,11,14,19975860,3602,103800,18,5556
843,3,0,11,14,19986420,3602,103800,18,5559
844,8,0,15,10,19998000,3601,103800,18,5567
845,4,0,14,11,20013360,3601,103800,18,5571
846,5,0,15,10,20034660,3602,103800,18,5576
847,6,0,13,12,20060520,3602,103800,18,5582
848,2,0,12,13,20071620,3602,103800,18,5584
849,9,0,16,9,20088060,3601,103800,18,5593
850,7,0,14,11,20114340,3600,103800,18,5600
851,4,0,11,14,20137860,3600,103800,18,5604
852,7,0,13,12,20160540,3601,103800,18,5611
853,5,0,10,15,20185740,3600,103800,18,5616
854,8,0,11,14,20204220,3599,103800,18,5624
855,8,0,15,10,20218920,3599,103800,18,5632
856,13,0,19,6,20235180,3596,103800,18,5645
857,8,0,18,7,20267160,3596,103800,18,5653
858,11,0,23,2,20300820,3598,103800,18,5664
859,10,0,17,8,20358600,3598,103920,18,5674
860,6,0,15,10,20390100,3599,103920,18,5680
861,4,0,11,14,20431140,3601,103920,18,5684
862,6,0,12,13,20439960,3599,103920,18,5690
863,7,0,15,10,20452680,3599,103920,18,5697
864,2,0,12,13,20473200,3600,103920,18,5699
865,4,0,12,13,20476440,3598,103920,18,5703
866,6,0,15,10,20498760,3600,103920,18,5709
867,9,0,17,8,20516940,3598,103920,18,5718
868,9,0,15,10,20556000,3598,103920,18,5727
869,2,0,11,14,20574540,3598,103920,18,5729
870,6,0,11,14,20594460,3597,103920,18,5735
871,6,0,12,13,20604840,3596,103920,18,5741
872,6,0,15,10,20618100,3597,103920,18,5747
873,5,0,16,9,20636280,3597,103920,18,5752
874,8,0,17,8,20668920,3598,103920,18,5760
875,7,0,15,10,20701440,3598,103920,18,5767
876,11,0,18,7,20727000,3598,103920,17,5778
877,10,0,16,9,20768040,3598,103920,17,5788
878,7,0,17,8,20801220,3600,103920,17,5795
879,8,0,17,8,20838420,3601,103920,17,5803
880,6,0,17,8,20870100,3603,103920,17,5809
881,9,0,15,10,20898840,3601,103920,17,5818
882,9,0,17,8,20925540,3601,103920,17,5827
883,10,0,18,7,20957040,3601,103920,17,5837
884,5,0,16,9,20989920,3602,103920,17,5842
885,4,0,16,9,21003360,3602,103920,17,5846
886,8,0,13,12,21054840,3604,103920,17,5854
887,5,0,12,13,21072120,3603,103920,17,5859
888,4,0,11,14,21092040,3604,103920,17,5863
889,5,0,11,14,21104400,3603,103920,17,5868
890,5,0,12,13,21115680,3602,103920,17,5873
891,5,0,10,15,21131340,3601,103920,17,5878
892,4,0,10,15,21144120,3600,103920,17,5882
893,8,0,11,14,21152160,3597,103920,17,5890
894,7,0,12,13,21169200,3597,103920,17,5897
895,5,0,14,11,21172260,3595,103920,17,5902
896,6,0,14,11,21197220,3596,103920,17,5908
897,4,0,13,12,21210480,3595,103920,17,5912
898,7,0,17,8,21221760,3595,103920,17,5919
899,9,0,16,9,21251160,3594,103920,17,5928
900,14,0,21,4,21278520,3593,103920,17,5942
901,8,0,21,4,21300720,3592,103920,17,5950
902,8,0,19,6,21334440,3592,103920,17,5958
903,5,0,14,11,21387300,3595,103920,17,5963
904,9,0,15,10,21400800,3592,103920,17,5972
905,5,0,12,13,21433920,3593,103920,17,5977
906,5,0,14,11,21444900,3593,103920,17,5982
907,11,0,18,7,21465900,3592,103920,17,5993
908,8,0,21,4,21486900,3593,103920,17,6001
909,8,0,20,5,21532620,3595,103920,17,6009
910,4,0,13,12,21586380,3597,103920,17,6013
911,5,0,14,11,21602700,3598,103920,17,6018
912,3,0,11,14,21632580,3599,103920,17,6021
913,5,0,14,11,21642300,3599,103920,17,6026
914,4,0,12,13,21669900,3600,103920,17,6030
915,6,0,14,11,21677460,3599,103920,17,6036
916,3,0,14,11,21692280,3600,103920,17,6039
917,6,0,12,13,21720540,3600,103920,17,6045
918,8,0,16,9,21726060,3598,103920,17,6053
919,6,0,13,12,21759960,3599,103920,17,6059
920,7,0,15,10,21783120,3599,103920,17,6066
921,6,0,15,10,21809400,3600,103920,17,6072
922,10,0,20,5,21827760,3600,103920,17,6082
923,15,0,24,1,21871440,3601,103920,17,6097
924,9,1,17,8,21920700,3600,103920,17,6106
925,4,4,15,10,21935820,3601,103980,17,6110
926,13,0,23,2,21981840,3603,115740,18,6123
927,3,0,13,12,22034280,3604,115740,18,6126
928,9,0,15,10,22056300,3603,115740,18,6135
929,7,0,15,10,22077600,3603,115740,18,6142
930,10,0,14,11,22119780,3603,115740,18,6152
931,7,0,14,11,22139640,3602,115740,18,6159
932,10,0,18,7,22164180,3603,115740,18,6169
933,5,0,13,12,22195980,3602,115740,18,6174
934,2,0,11,14,22211160,3602,115740,18,6176
935,5,0,13,12,22219800,3602,115740,18,6181
936,1,0,8,17,22246860,3603,115740,18,6182
937,6,0,13,12,22248780,3603,115740,18,6188
938,3,0,9,16,22267020,3601,115740,18,6191
939,1,0,9,16,22274760,3602,115740,18,6192
940,8,0,14,11,22278480,3601,115740,18,6200
941,9,0,18,7,22293480,3600,115740,18,6209
942,5,0,15,10,22330500,3602,115740,18,6214
943,9,0,12,13,22360560,3600,115740,18,6223
944,4,0,12,13,22379040,3600,115740,18,6227
945,6,0,16,9,22390680,3601,115740,18,6233
946,7,0,16,9,22410360,3600,115740,18,6240
947,6,0,13,12,22445940,3601,115740,18,6246
948,7,0,14,11,22455300,3599,115740,18,6253
949,13,0,17,8,22490280,3599,115740,18,6266
950,12,0,19,6,22512300,3596,115740,18,6278
951,5,0,16,9,22554240,3598,115740,18,6283
952,7,0,13,12,22596300,3599,115740,18,6290
953,11,0,17,8,22615740,3598,115740,18,6301
954,4,0,13,12,22647660,3599,115740,18,6305
955,12,0,17,8,22667700,3598,115740,18,6317
956,11,0,14,11,22713240,3597,115740,18,6328
957,4,0,13,12,22729560,3597,115740,18,6332
958,6,0,12,13,22754460,3596,115740,18,6338
959,10,0,19,6,22765200,3596,115740,18,6348
960,10,0,21,4,22789980,3596,115740,18,6358
961,8,0,17,8,22825980,3595,115740,18,6366
962,6,0,14,11,22878840,3598,115740,18,6372
963,6,0,11,14,22910820,3598,115740,18,6378
964,8,0,14,11,22919400,3596,115740,18,6386
965,5,0,15,10,22932120,3596,115740,18,6391
966,7,0,16,9,22957920,3597,115740,18,6398
967,5,0,15,10,22980780,3597,115740,18,6403
968,8,0,15,10,23015580,3598,115740,18,6411
969,6,0,10,15,23044440,3596,115740,18,6417
970,10,0,15,10,23058840,3596,115740,18,6427
971,10,0,16,9,23080380,3594,115740,17,6437
972,6,0,15,10,23108220,3594,115740,17,6443
973,9,0,15,10,23136120,3594,115740,17,6452
974,9,0,17,8,23160840,3594,115740,17,6461
975,5,0,14,11,23194740,3594,115740,17,6466
976,4,0,12,13,23218680,3595,115740,17,6470
977,8,0,14,11,23238120,3595,115740,17,6478
978,8,0,17,8,23254560,3594,115740,17,6486
979,6,4,15,10,23271780,3595,116940,18,6492
980,10,5,19,6,23312460,3598,129060,19,6502
981,6,0,19,6,23338020,3596,150720,23,6508
982,1,0,10,15,23395560,3599,150720,23,6509
983,3,0,10,15,23407860,3600,150720,23,6512
984,2,0,10,15,23418240,3600,150720,23,6514
985,4,0,12,13,23426820,3600,150720,23,6518
986,4,0,10,15,23442240,3599,150720,23,6522
987,6,0,14,11,23453400,3600,150720,23,6528
988,3,0,9,16,23481120,3600,150720,23,6531
989,7,0,14,11,23482980,3599,150720,23,6538
990,7,0,15,10,23498460,3598,150720,23,6545
991,9,0,18,7,23516640,3598,150720,22,6554
992,6,0,15,10,23565180,3600,150720,22,6560
993,13,0,19,6,23588340,3599,150720,22,6573
994,8,0,20,5,23609880,3598,150720,22,6581
995,4,0,14,11,23654400,3599,150720,22,6585
996,7,0,17,8,23672700,3600,150720,22,6592
997,9,0,17,8,23704980,3600,150720,22,6601
998,7,0,16,9,23734920,3600,150720,22,6608
999,2,0,13,12,23766660,3602,150720,22,6610
1000,4,0,15,10,23778300,3603,150720,22,6614
1001,6,0,13,12,23813340,3604,150720,22,6620
1002,8,0,15,10,23823420,3602,150720,22,6628
1003,6,0,12,13,23848320,3601,150720,22,6634
1004,9,0,17,8,23870580,3602,150720,22,6643
1005,1,0,12,13,23890200,3602,150720,22,6644
1006,6,0,11,14,23920440,3603,150720,22,6650
1007,4,0,10,15,23932200,3602,150720,22,6654
1008,3,0,12,13,23940060,3602,150720,22,6657
1009,4,0,11,14,23954220,3602,150720,22,6661
1010,6,0,13,12,23971200,3602,150720,22,6667
1011,6,0,14,11,23988660,3602,150720,22,6673
1012,3,0,11,14,24001980,3601,150720,22,6676
1013,8,0,14,11,24016680,3600,150720,22,6684
1014,2,0,11,14,24033060,3600,150720,22,6686
1015,10,0,15,10,24053280,3600,150720,22,6696
1016,6,0,16,9,24064200,3599,150720,22,6702
1017,13,0,21,4,24093180,3599,150720,22,6715
1018,8,0,15,10,24140640,3598,150720,22,6723
1019,4,0,13,12,24166920,3599,150720,22,6727
1020,7,0,15,10,24184560,3599,150720,22,6734
1021,12,1,19,6,24201840,3598,151020,22,6746
1022,6,4,15,10,24231000,3598,152940,22,6752
1023,11,1,24,1,24258540,3600,166620,24,6763
1024,8,0,21,4,24307320,3601,169200,24,6771
1025,7,0,14,11,24367080,3602,169200,24,6778
1026,10,0,20,5,24379800,3602,169200,24,6788
1027,0,0,10,15,24435300,3605,169200,24,6788
1028,6,0,11,14,24454380,3605,169200,24,6794
1029,5,0,14,11,24459420,3604,169200,24,6799
1030,4,0,14,11,24479340,3605,169200,24,6803
1031,4,0,15,10,24493680,3606,169200,24,6807
1032,4,0,12,13,24524100,3607,169200,24,6811
1033,3,0,12,13,24529920,3606,169200,24,6814
1034,11,0,16,9,24546960,3605,169200,24,6825
1035,5,0,16,9,24569160,3605,169200,24,6830
1036,6,0,16,9,24609840,3608,169200,24,6836
1037,5,0,15,10,24638460,3609,169200,24,6841
1038,4,0,13,12,24657900,3609,169200,24,6845
1039,5,0,11,14,24673560,3607,169200,24,6850
1040,4,0,12,13,24682380,3607,169200,24,6854
1041,12,0,18,7,24697920,3606,169200,24,6866
1042,9,0,18,7,24730080,3606,169920,24,6875
1043,8,0,15,10,24763380,3605,169920,24,6883
1044,8,0,14,11,24805860,3607,169920,24,6891
1045,7,0,14,11,24822060,3605,169920,24,6898
1046,12,0,18,7,24848880,3605,169920,24,6910
1047,6,0,12,13,24878820,3603,169920,24,6916
1048,8,0,15,10,24893940,3603,169920,24,6924
1049,8,0,19,6,24903720,3602,169920,24,6932
1050,10,0,16,9,24955740,3603,169920,24,6942
1051,9,0,19,6,24983220,3604,169920,24,6951
1052,7,0,17,8,25023120,3605,169920,24,6958
1053,8,0,18,7,25061580,3607,169920,24,6966
1054,6,0,15,10,25097160,3607,169920,24,6972
1055,5,0,12,13,25124460,3607,169920,24,6977
1056,5,0,15,10,25142940,3608,169920,24,6982
1057,6,0,14,11,25160580,3607,169920,24,6988
1058,7,0,15,10,25189320,3608,169920,24,6995
1059,5,0,12,13,25217340,3608,169920,24,7000
1060,3,0,14,11,25219500,3608,169920,24,7003
1061,6,0,12,13,25244640,3607,169920,24,7009
1062,8,0,17,8,25255140,3607,169920,24,7017
1063,3,0,11,14,25287000,3607,169920,24,7020
1064,8,0,17,8,25294560,3607,169920,24,7028
1065,8,5,16,9,25310160,3608,172200,24,7036
1066,6,8,15,10,25338780,3610,180720,25,7042
1067,8,10,18,7,25363200,3611,193020,27,7050
1068,10,16,20,5,25378320,3613,198240,28,7060
1069,8,14,22,3,25447920,3618,219660,31,7068
1070,10,3,25,0,25499760,3616,347640,49,7078
1071,6,0,16,9,25553640,3615,367140,51,7084
1072,12,0,22,3,25582980,3616,367140,51,7096
1073,13,0,21,4,25625220,3615,367140,51,7109
1074,10,0,17,8,25681860,3616,367140,51,7119
1075,8,0,13,12,25721400,3615,367140,51,7127
1076,6,0,15,10,25729140,3614,367140,51,7133
1077,8,0,16,9,25761420,3615,367140,51,7141
1078,4,0,12,13,25788240,3615,367140,51,7145
1079,3,0,12,13,25809960,3616,367140,51,7148
1080,8,0,12,13,25824360,3614,367140,51,7156
1081,10,0,16,9,25834380,3613,367140,51,7166
1082,7,0,16,9,25856400,3612,367140,51,7173
1083,3,0,10,15,25890960,3613,367140,51,7176
1084,8,0,13,12,25903020,3612,367140,51,7184
1085,5,0,12,13,25919460,3611,367140,51,7189
1086,9,0,17,8,25938240,3612,367140,51,7198
1087,8,0,16,9,25969080,3611,367140,50,7206
1088,11,0,22,3,25980600,3610,367140,50,7217
1089,9,0,17,8,26038800,3611,367140,50,7226
1090,9,0,15,10,26090220,3613,367140,50,7235
1091,12,0,23,2,26096460,3612,367140,50,7247
1092,8,0,20,5,26139960,3612,367140,50,7255
1093,10,0,19,6,26185740,3613,367140,50,7265
1094,6,0,14,11,26228940,3614,367140,50,7271
1095,8,0,15,10,26252160,3614,367140,50,7279
1096,3,0,13,12,26273640,3614,367140,50,7282
1097,8,0,15,10,26290620,3613,367140,50,7290
1098,9,0,15,10,26322600,3613,367140,50,7299
1099,6,0,11,14,26354880,3613,367140,50,7305
1100,9,0,16,9,26363280,3612,367140,50,7314
1101,10,0,19,6,26381280,3611,367140,50,7324
1102,5,0,14,11,26416380,3611,367140,50,7329
1103,4,0,12,13,26448900,3612,367140,50,7333
1104,4,0,14,11,26456400,3612,367140,50,7337
1105,7,0,11,14,26482320,3611,367140,49,7344
1106,1,0,10,15,26493240,3611,367140,49,7345
1107,7,0,12,13,26498160,3610,367140,49,7352
1108,9,0,17,8,26517660,3610,367140,49,7361
1109,9,0,18,7,26538600,3609,367140,49,7370
1110,8,0,16,9,26578440,3610,367140,49,7378
1111,7,0,14,11,26602440,3609,367140,49,7385
1112,6,0,14,11,26630760,3609,367140,49,7391
1113,5,0,11,14,26655600,3609,367140,49,7396
1114,9,0,14,11,26668680,3608,367140,49,7405
1115,8,0,14,11,26681760,3606,367140,49,7413
1116,12,0,15,10,26712780,3604,367140,49,7425
1117,14,0,22,3,26731440,3604,367140,49,7439
1118,12,0,20,5,26768280,3602,367140,49,7451
1119,3,0,13,12,26813280,3603,367140,49,7454
1120,7,0,13,12,26852940,3605,367140,49,7461
1121,7,0,14,11,26870340,3604,367140,49,7468
1122,10,0,14,11,26889660,3602,367140,49,7478
1123,10,0,17,8,26904960,3601,367140,49,7488
1124,7,0,17,8,26932980,3601,367140,48,7495
1125,2,0,14,11,26966760,3603,367140,48,7497
1126,7,0,16,9,26992080,3604,367140,48,7504
1127,5,0,14,11,27036840,3607,367140,48,7509
1128,7,0,16,9,27047100,3606,367140,48,7516
1129,3,0,9,16,27093120,3607,367140,48,7519
1130,2,0,9,16,27099900,3607,367140,48,7521
1131,4,0,12,13,27102240,3607,367140,48,7525
1132,5,0,15,10,27106980,3607,367140,48,7530
1133,8,0,12,13,27137880,3605,367140,48,7538
1134,8,0,14,11,27154440,3605,367140,48,7546
1135,7,0,17,8,27170760,3605,367140,48,7553
1136,9,0,15,10,27206280,3604,367140,48,7562
1137,8,0,16,9,27233520,3605,367140,48,7570
1138,10,0,20,5,27249420,3604,367140,48,7580
1139,8,0,19,6,27280740,3604,367140,48,7588
1140,8,0,16,9,27323340,3604,367140,48,7596
1141,6,0,15,10,27353940,3605,367140,48,7602
1142,8,0,13,12,27386460,3604,367140,48,7610
1143,12,0,17,8,27402720,3603,367140,48,7622
1144,8,0,16,9,27439260,3603,367140,48,7630
1145,4,0,17,8,27449220,3603,367140,48,7634
1146,7,0,18,7,27473400,3604,367140,48,7641
1147,9,0,16,9,27519240,3604,367140,47,7650
1148,8,0,16,9,27551160,3605,367140,47,7658
1149,7,0,16,9,27584160,3606,367140,47,7665
1150,4,0,16,9,27599640,3606,367140,47,7669
1151,2,0,10,15,27636120,3607,367140,47,7671
1152,2,0,9,16,27648540,3607,367140,47,7673
1153,5,0,12,13,27655560,3607,367140,47,7678
1154,8,0,17,8,27660900,3606,367140,47,7686
1155,6,0,14,11,27682620,3605,367140,47,7692
1156,4,0,13,12,27721260,3608,367140,47,7696
1157,8,0,13,12,27737340,3606,367140,47,7704
1158,8,0,16,9,27756300,3606,367140,47,7712
1159,7,0,14,11,27784620,3606,367140,47,7719
1160,7,0,13,12,27818400,3606,367140,47,7726
1161,5,0,13,12,27838680,3606,367140,47,7731
1162,10,0,15,10,27854700,3605,367140,47,7741
1163,14,0,18,7,27897120,3605,367140,47,7755
1164,12,0,19,6,27936000,3605,367140,47,7767
1165,9,0,21,4,27961800,3605,367140,47,7776
1166,11,0,19,6,28018560,3606,367320,47,7787
1167,9,0,18,7,28063200,3608,367320,47,7796
1168,6,0,13,12,28109220,3608,367320,47,7802
1169,7,0,14,11,28128900,3608,367320,47,7809
1170,2,0,11,14,28148100,3608,367320,47,7811
1171,7,0,12,13,28168260,3608,367320,46,7818
1172,5,0,12,13,28175340,3607,367320,46,7823
1173,5,0,11,14,28197300,3607,367320,46,7828
1174,6,0,13,12,28207320,3606,367320,46,7834
1175,6,0,15,10,28219440,3606,367320,46,7840
1176,2,0,12,13,28239360,3606,367320,46,7842
1177,3,0,11,14,28261200,3607,367320,46,7845
1178,6,0,12,13,28272600,3606,367320,46,7851
1179,3,0,11,14,28281660,3605,367320,46,7854
1180,7,0,12,13,28288140,3604,367320,46,7861
1181,3,0,11,14,28296120,3603,367320,46,7864
1182,7,0,13,12,28314540,3603,367320,46,7871
1183,6,0,12,13,28334820,3602,367320,46,7877
1184,11,0,18,7,28347840,3602,367320,46,7888
1185,12,0,21,4,28376340,3601,367320,46,7900
1186,11,0,18,7,28424160,3601,367320,46,7911
1187,7,0,17,8,28454880,3601,367320,46,7918
1188,7,0,19,6,28477980,3602,367320,46,7925
1189,4,0,11,14,28524180,3602,367320,46,7929
1190,11,0,14,11,28549380,3601,367320,46,7940
1191,12,0,17,8,28573620,3600,367320,46,7952
1192,12,0,21,4,28596840,3600,367320,46,7964
1193,10,0,20,5,28629780,3599,367320,46,7974
1194,14,0,17,8,28686360,3598,367320,45,7988
1195,10,0,18,7,28723980,3599,367320,45,7998
1196,5,0,15,10,28747140,3598,367320,45,8003
1197,7,0,16,9,28772880,3599,367320,45,8010
1198,5,0,15,10,28804620,3600,367320,45,8015
1199,6,0,16,9,28828380,3601,367320,45,8021
1200,4,0,11,14,28866060,3601,367320,45,8025
1201,2,0,11,14,28873620,3601,367320,45,8027
1202,6,0,11,14,28890240,3601,367320,45,8033
1203,4,0,10,15,28904940,3600,367320,45,8037
1204,7,0,15,10,28907580,3600,367320,45,8044
1205,3,0,12,13,28932300,3600,367320,45,8047
1206,8,0,14,11,28939080,3598,367320,45,8055
1207,3,0,10,15,28955400,3597,367320,45,8058
1208,7,0,14,11,28973760,3598,367320,45,8065
1209,3,0,13,12,28986840,3598,367320,45,8068
1210,4,0,12,13,29004420,3598,367320,45,8072
1211,8,0,13,12,29028300,3598,367320,45,8080
1212,13,0,18,7,29036820,3595,367320,45,8093
1213,9,0,17,8,29068680,3595,367320,45,8102
1214,6,0,12,13,29112360,3595,367320,45,8108
1215,13,0,21,4,29115900,3594,367320,45,8121
1216,10,0,19,6,29163840,3595,367320,45,8131
1217,11,0,23,2,29203860,3596,367320,45,8142
1218,8,0,18,7,29255040,3597,367320,45,8150
1219,8,0,15,10,29292960,3597,367320,45,8158
1220,8,0,16,9,29316840,3597,367320,44,8166
1221,5,0,16,9,29347560,3598,367320,44,8171
1222,8,0,17,8,29362020,3597,367320,44,8179
1223,5,0,19,6,29386680,3599,367320,44,8184
1224,6,0,13,12,29448000,3601,367320,44,8190
1225,3,0,10,15,29458260,3599,367320,44,8193
1226,6,0,12,13,29468700,3599,367320,44,8199
1227,6,0,15,10,29480760,3599,367320,44,8205
1228,3,0,12,13,29505300,3599,367320,44,8208
1229,5,0,12,13,29528460,3600,367320,44,8213
1230,7,0,12,13,29549220,3600,367320,44,8220
1231,5,0,14,11,29556000,3599,367320,44,8225
1232,10,0,14,11,29588640,3599,367320,44,8235
1233,10,0,15,10,29609160,3597,367320,44,8245
1234,14,0,23,2,29628480,3597,367320,44,8259
1235,9,0,20,5,29666640,3596,367320,44,8268
1236,9,0,16,9,29716920,3597,367320,44,8277
1237,8,0,15,10,29740260,3596,367320,44,8285
1238,14,0,19,6,29772060,3595,367320,44,8299
1239,8,0,19,6,29791260,3594,367320,44,8307
1240,11,0,16,9,29844960,3594,367320,44,8318
1241,3,0,14,11,29872140,3596,367320,44,8321
1242,10,0,14,11,29912580,3596,367320,44,8331
1243,4,0,14,11,29925120,3596,367320,44,8335
1244,10,0,14,11,29965020,3596,367320,44,8345
1245,5,0,17,8,29968260,3596,367320,43,8350
1246,3,0,13,12,29997720,3596,367320,43,8353
1247,8,0,12,13,30028380,3596,367320,43,8361
1248,3,0,11,14,30040140,3596,367320,43,8364
1249,3,0,10,15,30052200,3596,367320,43,8367
1250,5,0,10,15,30063180,3595,367320,43,8372
1251,7,0,14,11,30067320,3594,367320,43,8379
1252,6,0,14,11,30092400,3594,367320,43,8385
1253,8,0,17,8,30109860,3594,367320,43,8393
1254,8,0,18,7,30133560,3594,367320,43,8401
1255,6,0,15,10,30163260,3594,367320,43,8407
1256,10,0,17,8,30194220,3594,367320,43,8417
1257,6,0,14,11,30228660,3594,367320,43,8423
1258,10,0,19,6,30247620,3594,367320,43,8433
1259,7,0,19,6,30279420,3595,367320,43,8440
1260,9,0,18,7,30316560,3595,367320,43,8449
1261,13,0,19,6,30348900,3594,367320,43,8462
1262,7,0,9,16,30407940,3594,367320,43,8469
1263,9,0,14,11,30415500,3593,367320,43,8478
1264,3,0,11,14,30427140,3592,367320,43,8481
1265,8,0,17,8,30433320,3592,367320,43,8489
1266,7,0,14,11,30455100,3590,367320,43,8496
1267,13,0,20,5,30487380,3591,367320,43,8509
1268,3,0,14,11,30515580,3590,367320,43,8512
1269,5,0,13,12,30557100,3593,367320,43,8517
1270,6,0,14,11,30571800,3592,367320,43,8523
1271,1,0,9,16,30594180,3592,367320,43,8524
1272,4,0,12,13,30602760,3593,367320,43,8528
1273,5,0,14,11,30607680,3592,367320,43,8533
1274,4,0,15,10,30620760,3593,367320,43,8537
1275,6,0,13,12,30647940,3592,367320,42,8543
1276,5,0,15,10,30661320,3593,367320,42,8548
1277,10,0,22,3,30668280,3592,367320,42,8558
1278,6,0,16,9,30723540,3594,369960,43,8564
1279,7,0,16,9,30759840,3595,369960,43,8571
1280,11,0,19,6,30792900,3596,369960,43,8582
1281,10,0,18,7,30826140,3595,369960,43,8592
1282,7,0,16,9,30864660,3596,369960,43,8599
1283,7,0,15,10,30887400,3595,369960,42,8606
1284,17,2,21,4,30924300,3595,370560,42,8623
1285,9,0,24,1,30967440,3597,381060,44,8632
1286,12,0,18,7,31027980,3597,382380,44,8644
1287,6,0,18,7,31054680,3597,382380,44,8650
1288,11,0,17,8,31102560,3598,382380,44,8661
1289,13,0,16,9,31134180,3596,382380,44,8674
1290,7,0,19,6,31153140,3596,382380,44,8681
1291,8,0,16,9,31197000,3597,382380,44,8689
1292,5,0,15,10,31225440,3597,382380,43,8694
1293,3,0,12,13,31248300,3597,382380,43,8697
1294,5,0,14,11,31261980,3598,382380,43,8702
1295,4,0,13,12,31288560,3599,382380,43,8706
1296,7,0,16,9,31305720,3599,382380,43,8713
1297,6,0,14,11,31337280,3599,382380,43,8719
1298,4,0,11,14,31360740,3599,382380,43,8723
1299,5,0,13,12,31377780,3600,382380,43,8728
1300,5,0,12,13,31397400,3600,382380,43,8733
1301,5,0,14,11,31403520,3599,382380,43,8738
1302,6,0,13,12,31428420,3599,382380,43,8744
1303,7,0,17,8,31440120,3599,382380,43,8751
1304,3,0,15,10,31459920,3599,382380,43,8754
1305,2,0,10,15,31492800,3600,382380,43,8756
1306,9,0,14,11,31499460,3599,382380,43,8765
1307,9,0,16,9,31509900,3597,382380,43,8774
1308,12,0,17,8,31549860,3597,382380,43,8786
1309,7,0,16,9,31573620,3597,382380,43,8793
1310,9,0,17,8,31597680,3596,382380,43,8802
1311,11,0,18,7,31633200,3596,382380,43,8813
1312,11,0,18,7,31664220,3595,382380,43,8824
1313,6,0,14,11,31707120,3596,382380,43,8830
1314,4,0,12,13,31729800,3596,382380,43,8834
1315,5,0,15,10,31737300,3596,382380,43,8839
1316,5,0,12,13,31772400,3597,382380,43,8844
1317,6,0,12,13,31790460,3597,382380,43,8850
1318,6,0,13,12,31800960,3596,382380,43,8856
1319,2,0,13,12,31812900,3596,382380,43,8858
1320,5,0,14,11,31835580,3597,382380,43,8863
1321,1,0,11,14,31854480,3598,382380,43,8864
1322,1,0,10,15,31863420,3598,382380,43,8865
1323,7,0,13,12,31875420,3598,382380,43,8872
1324,5,0,15,10,31883340,3597,382380,43,8877
1325,7,0,14,11,31913700,3597,382380,43,8884
1326,5,0,14,11,31933980,3598,382380,43,8889
1327,7,0,14,11,31948980,3597,382380,42,8896
1328,3,0,9,16,31977840,3597,382380,42,8899
1329,5,0,12,13,31979160,3596,382380,42,8904
1330,10,0,17,8,31992660,3595,382380,42,8914
1331,10,0,19,6,32012400,3594,382380,42,8924
1332,13,0,17,8,32066880,3594,382380,42,8937
1333,4,0,13,12,32094840,3594,382380,42,8941
1334,10,0,19,6,32124360,3596,382380,42,8951
1335,6,0,19,6,32147700,3596,382380,42,8957
1336,7,0,16,9,32187120,3597,382380,42,8964
1337,5,0,15,10,32225460,3599,382380,42,8969
1338,7,0,16,9,32254500,3599,382380,42,8976
1339,7,0,13,12,32279640,3598,382380,42,8983
1340,7,0,16,9,32295600,3598,382380,42,8990
1341,1,0,14,11,32304660,3598,382380,42,8991
1342,6,0,18,7,32313300,3598,382380,42,8997
1343,7,0,15,10,32366820,3600,383040,42,9004
1344,4,0,13,12,32395200,3601,383040,42,9008
1345,7,0,20,5,32395200,3601,383040,42,9015
1346,6,0,19,6,32415060,3600,383040,42,9021
1347,3,0,15,10,32442960,3601,383040,42,9024
1348,3,0,15,10,32463720,3602,383040,42,9027
1349,6,0,16,9,32479320,3602,383040,42,9033
1350,2,0,15,10,32495220,3602,383040,42,9035
1351,6,0,17,8,32507040,3602,383040,42,9041
1352,7,0,22,3,32517420,3602,383040,42,9048
1353,6,0,19,6,32548800,3602,383040,42,9054
1354,8,0,20,5,32578140,3602,383040,42,9062
1355,11,0,23,2,32607480,3603,383340,42,9073
1356,0,0,15,10,32638200,3603,383340,42,9073
1357,9,0,20,5,32660340,3604,383340,42,9082
1358,2,0,18,7,32678940,3604,383340,42,9084
1359,10,0,20,5,32713140,3605,383340,42,9094
1360,12,0,24,1,32741760,3605,383340,42,9106
1361,6,0,20,5,32783940,3605,390120,42,9112
1362,4,0,18,7,32807520,3606,390120,42,9116
1363,8,0,18,7,32847720,3607,390120,42,9124
1364,6,0,19,6,32863800,3607,390120,42,9130
1365,5,0,19,6,32887920,3607,390120,42,9135
1366,5,0,19,6,32914620,3608,390120,42,9140
1367,5,0,17,8,32939160,3608,390120,42,9145
1368,4,0,18,7,32955120,3609,390120,42,9149
1369,4,0,14,11,32979060,3608,390120,42,9153
1370,6,0,16,9,32986200,3607,390120,42,9159
1371,7,0,19,6,32994480,3607,390120,42,9166
1372,8,0,19,6,33027120,3607,390120,42,9174
1373,6,0,20,5,33049140,3607,391920,42,9180
1374,6,0,18,7,33077880,3607,391920,42,9186
1375,4,0,16,9,33095100,3607,391920,42,9190
1376,6,0,19,6,33111660,3608,391920,42,9196
1377,11,0,23,2,33131580,3607,391920,42,9207
1378,10,0,21,4,33159000,3605,391920,42,9217
1379,9,0,18,7,33197940,3605,391920,42,9226
1380,8,0,21,4,33207900,3604,391920,42,9234
1381,9,0,21,4,33236100,3604,391920,42,9243
1382,7,0,20,5,33268980,3604,391920,42,9250
1383,7,0,19,6,33302880,3604,391920,42,9257
1384,12,0,25,0,33314700,3603,392220,42,9269
1385,6,0,21,4,33356280,3604,392820,42,9275
1386,6,0,18,7,33397020,3605,393180,42,9281
1387,7,4,20,5,33399000,3605,394740,42,9288
1388,7,7,19,6,33433320,3607,402900,43,9295
1389,2,5,19,6,33459420,3608,411060,44,9297
1390,4,0,22,3,33499800,3610,453240,48,9301
1391,5,0,18,7,33518940,3608,453240,48,9306
1392,4,0,18,7,33542340,3609,453240,48,9310
1393,3,0,17,8,33566580,3610,453240,48,9313
1394,8,0,18,7,33592080,3610,453240,48,9321
1395,2,0,14,11,33606300,3610,453240,48,9323
1396,9,0,16,9,33624840,3609,453240,48,9332
1397,3,0,15,10,33639240,3609,453240,48,9335
1398,0,0,13,12,33650880,3609,453240,48,9335
1399,6,0,17,8,33652680,3609,453240,48,9341
1400,8,0,20,5,33670500,3609,453240,48,9349
1401,11,0,19,6,33715800,3609,453480,48,9360
1402,4,0,17,8,33739020,3609,453480,48,9364
1403,12,0,22,3,33762060,3609,453480,48,9376
1404,11,0,22,3,33787620,3607,453480,48,9387
1405,9,0,21,4,33820980,3607,453540,48,9396
1406,9,0,22,3,33846240,3607,453540,48,9405
1407,8,0,20,5,33894240,3608,453540,48,9413
1408,9,0,21,4,33921240,3608,453540,48,9422
1409,7,1,19,6,33952800,3608,453780,48,9429
1410,8,7,18,7,33967500,3608,454920,48,9437
1411,6,12,17,8,33980460,3609,456840,48,9443
1412,9,17,17,8,34016940,3611,465600,49,9452
1413,5,22,17,8,34016940,3611,465600,49,9457
1414,6,26,17,8,34032360,3612,478620,50,9463
1415,9,32,18,7,34053660,3614,496860,52,9472
1416,3,33,19,6,34070160,3615,502740,53,9475
1417,4,33,18,7,34110420,3617,522540,55,9479
1418,5,31,23,2,34126080,3618,618480,65,9484
1419,7,28,25,0,34173780,3620,746700,78,9491
1420,4,22,25,0,34216620,3621,887220,93,9495
1421,10,13,25,0,34272900,3620,1202280,126,9505
1422,6,0,16,9,34330440,3615,1438380,151,9511
1423,10,0,20,5,34343040,3614,1438380,151,9521
1424,4,0,17,8,34362480,3614,1438380,151,9525
1425,12,0,21,4,34394160,3614,1438380,150,9537
1426,16,4,25,0,34416900,3613,1438800,150,9553
1427,7,0,22,3,34453200,3612,1445040,151,9560
1428,9,4,18,7,34500060,3613,1449120,151,9569
1429,7,2,24,1,34520640,3614,1454400,151,9576
1430,12,1,25,0,34563060,3614,1463940,152,9588
1431,10,0,23,2,34598580,3613,1465500,152,9598
1432,5,0,18,7,34647780,3614,1465500,152,9603
1433,6,0,17,8,34669980,3614,1465500,152,9609
1434,9,0,18,7,34698600,3614,1465500,152,9618
1435,4,0,15,10,34720500,3614,1465500,152,9622
1436,3,0,14,11,34734240,3614,1465500,152,9625
1437,6,0,16,9,34747080,3613,1465500,152,9631
1438,6,0,18,7,34756740,3613,1465500,152,9637
1439,4,0,15,10,34775340,3612,1465500,152,9641
1440,1,0,15,10,34781520,3612,1465500,151,9642
1441,4,0,16,9,34788420,3612,1465500,151,9646
1442,2,0,16,9,34793580,3612,1465500,151,9648
1443,1,0,16,9,34801500,3612,1465500,151,9649
1444,3,0,15,10,34821420,3613,1465500,151,9652
1445,3,0,14,11,34832400,3612,1465500,151,9655
1446,7,0,18,7,34834680,3612,1465500,151,9662
1447,3,0,16,9,34858320,3612,1465500,151,9665
1448,6,0,15,10,34875720,3611,1465500,151,9671
1449,4,0,17,8,34880640,3611,1465500,151,9675
1450,14,0,21,4,34904640,3610,1465500,151,9689
1451,10,0,20,5,34937820,3609,1465500,151,9699
1452,7,0,21,4,34952100,3608,1465500,150,9706
1453,6,0,17,8,34976340,3607,1465500,150,9712
1454,8,0,20,5,34997940,3608,1465500,150,9720
1455,3,0,14,11,35032920,3608,1465500,150,9723
1456,9,0,17,8,35052240,3608,1465500,150,9732
1457,11,0,22,3,35063040,3606,1465500,150,9743
1458,8,0,19,6,35103900,3607,1465500,150,9751
1459,8,0,21,4,35128320,3607,1465500,150,9759
1460,2,0,15,10,35159760,3607,1465500,150,9761
1461,4,0,14,11,35172420,3607,1465500,150,9765
1462,6,0,16,9,35186100,3606,1465500,149,9771
1463,5,0,16,9,35199840,3606,1465500,149,9776
1464,2,0,15,10,35211660,3606,1465500,149,9778
1465,6,0,17,8,35225220,3606,1465500,149,9784
1466,5,0,17,8,35231100,3605,1465500,149,9789
1467,6,0,18,7,35257080,3606,1465500,149,9795
1468,4,0,14,11,35282400,3605,1465500,149,9799
1469,4,0,17,8,35283060,3605,1465500,149,9803
1470,9,0,22,3,35296560,3605,1465500,149,9812
1471,4,0,19,6,35331180,3606,1465500,149,9816
1472,7,0,22,3,35349180,3606,1465500,149,9823
1473,8,0,20,5,35382180,3606,1465500,149,9831
1474,9,0,23,2,35400840,3606,1465500,148,9840
1475,7,0,19,6,35451600,3607,1465500,148,9847
1476,13,0,20,5,35480460,3605,1465500,148,9860
1477,12,0,23,2,35513640,3605,1465500,148,9872
1478,8,2,21,4,35551380,3606,1467600,148,9880
1479,13,0,24,1,35588760,3606,1473720,148,9893
1480,9,0,22,3,35623320,3605,1473720,148,9902
1481,8,0,21,4,35670360,3607,1473720,148,9910
1482,5,0,21,4,35688900,3607,1473720,148,9915
1483,9,0,20,5,35728620,3607,1473720,148,9924
1484,13,0,20,5,35772480,3607,1474380,148,9937
1485,2,0,16,9,35792520,3607,1474380,148,9939
1486,3,0,16,9,35809680,3607,1474380,148,9942
1487,5,0,14,11,35829960,3607,1474380,148,9947
1488,5,0,15,10,35836500,3606,1474380,148,9952
1489,1,0,13,12,35845680,3606,1474380,148,9953
1490,3,0,14,11,35849700,3605,1474380,148,9956
1491,5,0,14,11,35862900,3605,1474380,148,9961
1492,2,0,16,9,35862900,3605,1474380,147,9963
1493,3,0,17,8,35869920,3605,1474380,147,9966
1494,5,0,19,6,35887800,3606,1474380,147,9971
1495,10,0,20,5,35921940,3606,1474380,147,9981
1496,10,0,22,3,35936400,3604,1474380,147,9991
1497,5,0,20,5,35967000,3605,1474380,147,9996
1498,10,0,21,4,36002640,3605,1474380,147,10006
1499,8,0,23,2,36013980,3604,1474380,147,10014
1500,8,0,20,5,36061560,3605,1474380,147,10022
1501,10,0,19,6,36097500,3605,1474380,146,10032
1502,8,0,19,6,36117900,3604,1474380,146,10040
1503,6,0,20,5,36139020,3604,1474380,146,10046
1504,10,0,21,4,36170640,3604,1474380,146,10056
1505,4,0,15,10,36201660,3603,1474380,146,10060
1506,8,0,18,7,36212760,3603,1474380,146,10068
1507,11,0,22,3,36228720,3602,1474380,146,10079
1508,6,0,21,4,36257160,3602,1474980,146,10085
1509,9,0,20,5,36303000,3603,1474980,146,10094
1510,3,0,19,6,36325740,3604,1474980,146,10097
1511,7,0,17,8,36365160,3605,1474980,145,10104
1512,5,0,20,5,36370620,3604,1474980,145,10109
1513,6,0,19,6,36405060,3605,1474980,145,10115
1514,7,0,20,5,36428280,3606,1474980,145,10122
1515,4,0,18,7,36460260,3607,1474980,145,10126
1516,3,0,16,9,36486600,3607,1474980,145,10129
1517,3,0,15,10,36496200,3607,1474980,145,10132
1518,3,0,15,10,36507060,3607,1474980,145,10135
1519,8,0,19,6,36519720,3607,1474980,145,10143
1520,9,0,20,5,36539340,3606,1474980,145,10152
1521,5,0,19,6,36568020,3607,1474980,145,10157
1522,4,0,16,9,36604620,3608,1474980,145,10161
1523,9,0,22,3,36616140,3608,1474980,145,10170
1524,7,0,21,4,36643980,3608,1474980,144,10177
1525,9,0,20,5,36686580,3608,1474980,144,10186
1526,4,0,17,8,36717780,3609,1474980,144,10190
1527,12,0,23,2,36737400,3609,1474980,144,10202
1528,8,0,19,6,36777720,3608,1474980,144,10210
1529,6,0,20,5,36794040,3608,1474980,144,10216
1530,8,0,20,5,36820560,3608,1474980,144,10224
1531,4,0,17,8,36859740,3609,1474980,144,10228
1532,6,0,20,5,36883860,3611,1474980,144,10234
1533,5,0,20,5,36903240,3611,1474980,144,10239
1534,5,0,17,8,36934920,3611,1474980,143,10244
1535,4,0,17,8,36954240,3611,1474980,143,10248
1536,5,0,19,6,36976440,3613,1474980,143,10253
1537,2,0,15,10,37001640,3613,1474980,143,10255
1538,8,0,18,7,37011780,3612,1474980,143,10263
1539,3,0,16,9,37031340,3612,1474980,143,10266
1540,5,0,17,8,37050060,3613,1474980,143,10271
1541,0,0,16,9,37057980,3613,1474980,143,10271
1542,6,0,16,9,37083660,3614,1474980,143,10277
1543,5,0,18,7,37093200,3613,1474980,143,10282
1544,7,0,19,6,37118880,3614,1474980,143,10289
1545,8,0,21,4,37133340,3613,1474980,143,10297
1546,9,0,22,3,37166880,3614,1474980,143,10306
1547,11,1,23,2,37197240,3613,1478820,143,10317
1548,10,4,23,2,37217460,3613,1479000,143,10327
1549,13,1,25,0,37273980,3613,1494840,144,10340
1550,6,0,22,3,37303920,3613,1495560,144,10346
1551,10,0,20,5,37347600,3613,1495560,144,10356
1552,6,0,20,5,37368540,3613,1495560,144,10362
1553,8,0,17,8,37423920,3614,1495560,144,10370
1554,8,0,20,5,37431120,3613,1495560,144,10378
1555,7,0,18,7,37461900,3613,1495560,144,10385
1556,4,0,18,7,37469220,3612,1495560,143,10389
1557,3,0,16,9,37496400,3613,1495560,143,10392
1558,6,0,19,6,37502820,3613,1495560,143,10398
1559,8,0,19,6,37533780,3613,1495560,143,10406
1560,3,0,14,11,37559040,3613,1495560,143,10409
1561,6,0,16,9,37568100,3612,1495560,143,10415
1562,5,0,20,5,37568880,3612,1495560,143,10420
1563,5,2,17,8,37592580,3612,1496820,143,10425
1564,4,0,16,9,37620780,3612,1500840,143,10429
1565,8,0,18,7,37636020,3612,1500840,143,10437
1566,5,0,19,6,37655760,3612,1500840,143,10442
1567,7,0,19,6,37688640,3613,1500840,143,10449
1568,6,0,17,8,37706760,3612,1500840,143,10455
1569,10,0,20,5,37734420,3612,1500840,143,10465
1570,7,0,20,5,37760880,3612,1500840,143,10472
1571,10,0,22,3,37782300,3612,1500840,143,10482
1572,8,0,20,5,37829160,3613,1504440,143,10490
1573,6,0,21,4,37836240,3612,1504440,143,10496
1574,14,10,19,6,37870680,3613,1505220,143,10510
1575,3,4,22,3,37911600,3615,1529580,145,10513
1576,5,0,17,8,37951860,3614,1552980,147,10518
1577,9,0,21,4,37973160,3614,1552980,147,10527
1578,5,0,19,6,37998300,3614,1552980,147,10532
1579,6,0,19,6,38026560,3615,1552980,147,10538
1580,6,0,16,9,38054520,3614,1552980,147,10544
1581,2,0,15,10,38076540,3615,1552980,147,10546
1582,6,0,15,10,38093640,3615,1552980,147,10552
1583,7,0,16,9,38107920,3614,1552980,147,10559
1584,5,0,19,6,38114940,3614,1552980,147,10564
1585,3,0,17,8,38140920,3615,1552980,146,10567
1586,6,0,15,10,38163600,3614,1552980,146,10573
1587,5,0,18,7,38167920,3614,1552980,146,10578
1588,5,0,19,6,38180940,3614,1552980,146,10583
1589,3,0,16,9,38212320,3615,1552980,146,10586
1590,6,0,20,5,38217300,3614,1552980,146,10592
1591,6,0,20,5,38244840,3615,1552980,146,10598
1592,5,0,19,6,38256720,3614,1552980,146,10603
1593,9,0,21,4,38297040,3615,1552980,146,10612
1594,3,0,15,10,38340360,3617,1552980,146,10615
1595,4,0,16,9,38349060,3616,1552980,146,10619
1596,8,1,19,6,38360040,3616,1552980,146,10627
1597,6,0,21,4,38381340,3616,1556580,146,10633
1598,8,0,19,6,38415180,3616,1556580,146,10641
1599,10,0,20,5,38438580,3615,1556580,146,10651
1600,5,0,17,8,38476140,3616,1556580,146,10656
1601,8,0,18,7,38488200,3615,1556580,145,10664
1602,8,0,20,5,38513400,3615,1556580,145,10672
1603,6,0,19,6,38538360,3615,1556580,145,10678
1604,5,0,17,8,38570580,3616,1556580,145,10683
1605,8,0,18,7,38588400,3615,1556580,145,10691
1606,5,0,18,7,38604720,3615,1556580,145,10696
1607,4,0,17,8,38630400,3616,1556580,145,10700
1608,5,0,17,8,38648700,3616,1556580,145,10705
1609,7,0,17,8,38663280,3615,1556580,145,10712
1610,4,0,19,6,38674860,3615,1556580,145,10716
1611,3,0,15,10,38701980,3615,1556580,145,10719
1612,12,0,20,5,38725380,3615,1556580,145,10731
1613,11,0,19,6,38756700,3614,1556580,144,10742
1614,8,0,18,7,38785260,3613,1556580,144,10750
1615,3,0,15,10,38806680,3613,1556580,144,10753
1616,1,0,12,13,38824020,3614,1556580,144,10754
1617,5,0,15,10,38825220,3613,1556580,144,10759
1618,6,0,18,7,38832180,3613,1556580,144,10765
1619,7,0,20,5,38844000,3612,1556580,144,10772
1620,9,0,22,3,38864820,3612,1556580,144,10781
1621,5,0,19,6,38900160,3612,1556580,144,10786
1622,9,0,21,4,38922960,3612,1556580,144,10795
1623,6,0,23,2,38939220,3612,1556580,144,10801
1624,14,0,22,3,38996880,3613,1556580,143,10815
1625,8,0,17,8,39032400,3612,1556580,143,10823
1626,9,0,18,7,39051780,3611,1556580,143,10832
1627,6,0,19,6,39066600,3610,1556580,143,10838
1628,3,0,18,7,39089820,3611,1556580,143,10841
1629,5,0,17,8,39116100,3612,1556580,143,10846
1630,7,0,19,6,39133860,3612,1556580,143,10853
1631,4,0,17,8,39153180,3611,1556580,143,10857
1632,7,0,21,4,39164820,3611,1556580,143,10864
1633,5,0,16,9,39210300,3612,1556580,143,10869
1634,5,0,16,9,39222840,3612,1556580,143,10874
1635,3,0,13,12,39240480,3611,1556580,143,10877
1636,2,0,15,10,39240480,3611,1556580,143,10879
1637,4,0,16,9,39247260,3611,1556580,143,10883
1638,8,0,20,5,39253380,3610,1556580,142,10891
1639,6,0,18,7,39287820,3611,1556580,142,10897
1640,8,0,20,5,39307080,3611,1556580,142,10905
1641,3,0,14,11,39337680,3610,1556580,142,10908
1642,7,0,18,7,39348420,3610,1556580,142,10915
1643,9,0,19,6,39361260,3609,1556580,142,10924
1644,4,0,14,11,39396360,3609,1556580,142,10928
1645,9,0,21,4,39398940,3609,1556580,142,10937
1646,13,0,21,4,39435720,3608,1556580,142,10950
1647,7,0,17,8,39468180,3607,1556580,142,10957
1648,12,0,21,4,39490140,3607,1556580,141,10969
1649,7,0,18,7,39525120,3606,1556580,141,10976
1650,11,0,24,1,39536640,3606,1556580,141,10987
1651,7,0,23,2,39567060,3606,1556580,141,10994
1652,4,0,19,6,39602400,3607,1556580,141,10998
1653,8,0,18,7,39640620,3607,1556580,141,11006
1654,1,0,14,11,39661260,3607,1556580,141,11007
1655,7,0,15,10,39677640,3607,1556580,141,11014
1656,4,0,17,8,39680880,3607,1556580,141,11018
1657,5,0,19,6,39695820,3607,1556580,141,11023
1658,8,0,20,5,39714000,3606,1556580,141,11031
1659,3,0,16,9,39738600,3606,1556580,141,11034
1660,3,0,15,10,39754800,3606,1556580,141,11037
1661,8,0,19,6,39770520,3606,1556580,140,11045
1662,5,0,16,9,39792960,3606,1556580,140,11050
1663,8,0,17,8,39810060,3605,1556580,140,11058
1664,6,0,19,6,39825240,3605,1556580,140,11064
1665,3,0,16,9,39848460,3605,1556580,140,11067
1666,10,0,22,3,39855840,3605,1556580,140,11077
1667,11,0,20,5,39897480,3604,1556580,140,11088
1668,6,0,18,7,39925680,3604,1556580,140,11094
1669,9,0,22,3,39941160,3604,1556580,140,11103
1670,9,0,22,3,39963480,3603,1556580,140,11112
1671,14,0,24,1,40011780,3604,1556580,139,11126
1672,6,0,19,6,40042200,3603,1556580,139,11132
1673,13,0,21,4,40076160,3602,1556580,139,11145
1674,9,0,23,2,40098540,3602,1556580,139,11154
1675,8,0,21,4,40152060,3603,1556580,139,11162
1676,3,0,16,9,40182900,3604,1556580,139,11165
1677,4,0,15,10,40205700,3604,1556580,139,11169
1678,6,0,19,6,40210320,3604,1556580,139,11175
1679,2,0,16,9,40229280,3604,1556580,139,11177
1680,1,0,12,13,40255800,3605,1556580,139,11178
1681,5,0,16,9,40256700,3604,1556580,139,11183
1682,4,0,16,9,40266540,3604,1556580,139,11187
1683,5,0,16,9,40276380,3603,1556580,139,11192
1684,6,0,20,5,40284660,3603,1556580,139,11198
1685,8,0,22,3,40313040,3604,1556580,138,11206
1686,2,0,19,6,40334400,3604,1556580,138,11208
1687,4,0,17,8,40366920,3605,1556580,138,11212
1688,8,0,24,1,40374600,3606,1556580,138,11220
1689,6,0,19,6,40423440,3606,1556580,138,11226
1690,6,0,20,5,40444860,3607,1556580,138,11232
1691,9,0,18,7,40474500,3606,1556580,138,11241
1692,7,0,20,5,40496400,3606,1556580,138,11248
1693,8,0,20,5,40512240,3605,1556580,138,11256
1694,9,0,19,6,40556340,3606,1556580,138,11265
1695,11,0,22,3,40573320,3605,1556580,138,11276
1696,3,0,15,10,40609980,3605,1556580,138,11279
1697,12,0,19,6,40632540,3604,1556580,137,11291
1698,5,0,19,6,40656720,3605,1556580,137,11296
1699,5,0,17,8,40685040,3605,1556580,137,11301
1700,9,0,20,5,40706820,3605,1556580,137,11310
1701,8,0,21,4,40731840,3605,1556580,137,11318
1702,6,0,21,4,40751880,3605,1556580,137,11324
1703,4,0,17,8,40800720,3607,1556580,137,11328
1704,6,0,19,6,40812060,3606,1556580,137,11334
1705,9,0,20,5,40840680,3606,1556580,137,11343
1706,4,0,17,8,40873620,3607,1556580,137,11347
1707,0,0,13,12,40897620,3608,1556580,137,11347
1708,3,0,15,10,40903800,3608,1556580,137,11350
1709,9,0,19,6,40913760,3607,1556580,137,11359
1710,7,0,19,6,40929900,3607,1556580,136,11366
1711,10,0,14,11,40976100,3606,1556580,136,11376
1712,8,0,19,6,40986720,3606,1556580,136,11384
1713,9,0,19,6,41003340,3605,1556580,136,11393
1714,11,0,21,4,41039100,3605,1556580,136,11404
1715,12,0,24,1,41062380,3604,1556580,136,11416
1716,10,0,22,3,41093100,3603,1556580,136,11426
1717,12,0,20,5,41135340,3602,1556580,136,11438
1718,7,0,19,6,41163960,3602,1556580,136,11445
1719,12,6,19,6,41188200,3602,1556640,135,11457
1720,8,10,19,6,41215980,3604,1562820,136,11465
1721,8,16,19,6,41232960,3604,1567620,136,11473
1722,10,23,18,7,41271120,3606,1574940,137,11483
1723,6,25,20,5,41285520,3607,1593900,138,11489
1724,7,29,19,6,41312340,3608,1599480,139,11496
1725,5,26,24,1,41338200,3610,1677060,145,11501
1726,6,22,25,0,41385780,3611,1797480,156,11507
1727,4,15,25,0,41429040,3611,1911360,166,11511
1728,8,0,23,2,41497920,3609,2188260,189,11519
1729,7,0,18,7,41524500,3608,2188260,189,11526
1730,2,0,18,7,41531580,3608,2188260,189,11528
1731,7,0,15,10,41569200,3608,2188260,189,11535
1732,4,0,16,9,41575440,3608,2188260,189,11539
1733,4,0,16,9,41588100,3607,2188260,189,11543
1734,3,0,17,8,41601060,3608,2188260,189,11546
1735,9,0,20,5,41617260,3607,2188260,189,11555
1736,3,0,16,9,41645340,3608,2188260,189,11558
1737,8,0,16,9,41668020,3607,2188260,189,11566
1738,4,0,17,8,41680860,3607,2188260,189,11570
1739,4,0,18,7,41692560,3607,2188260,189,11574
1740,8,0,20,5,41707680,3607,2188260,188,11582
1741,8,0,18,7,41752320,3608,2188260,188,11590
1742,4,0,17,8,41761380,3607,2188260,188,11594
1743,11,0,21,4,41786100,3607,2188260,188,11605
1744,12,0,24,1,41812320,3606,2188260,188,11617
1745,7,0,23,2,41839080,3606,2188260,188,11624
1746,13,0,25,0,41879460,3606,2189640,188,11637
1747,6,0,21,4,41926320,3607,2189640,188,11643
1748,5,0,20,5,41954280,3608,2189640,187,11648
1749,4,0,15,10,41994840,3608,2189640,187,11652
1750,6,0,17,8,42017880,3609,2189640,187,11658
1751,5,0,15,10,42038580,3609,2189640,187,11663
1752,7,0,19,6,42049560,3609,2189640,187,11670
1753,8,0,22,3,42058080,3608,2189640,187,11678
1754,6,0,16,9,42111720,3609,2189640,187,11684
1755,4,0,15,10,42128760,3609,2189640,187,11688
1756,5,0,18,7,42132480,3608,2189640,187,11693
1757,9,0,22,3,42148860,3608,2189640,187,11702
1758,3,0,18,7,42173520,3608,2189640,187,11705
1759,8,0,15,10,42210960,3608,2189640,186,11713
1760,9,0,19,6,42223140,3607,2189640,186,11722
1761,12,0,25,0,42235980,3607,2190720,186,11734
1762,8,0,23,2,42278040,3607,2190960,186,11742
1763,8,0,22,3,42315600,3608,2190960,186,11750
1764,15,5,20,5,42366540,3608,2192340,186,11765
1765,8,12,17,8,42387060,3609,2194200,186,11773
1766,11,14,23,2,42413160,3610,2213160,187,11784
1767,9,14,23,2,42444000,3610,2224500,188,11793
1768,4,0,19,6,42501000,3608,2349180,199,11797
1769,7,0,20,5,42514740,3607,2349180,199,11804
1770,7,0,20,5,42539640,3607,2349180,198,11811
1771,8,0,18,7,42583380,3608,2349180,198,11819
1772,4,0,18,7,42595020,3608,2349180,198,11823
1773,8,0,21,4,42619980,3608,2349180,198,11831
1774,3,0,17,8,42643740,3608,2349180,198,11834
1775,2,0,15,10,42663660,3609,2349180,198,11836
1776,3,0,16,9,42678180,3609,2349180,198,11839
1777,4,0,17,8,42684600,3609,2349180,198,11843
1778,2,0,17,8,42696060,3609,2349180,198,11845
1779,3,0,17,8,42719820,3610,2349180,198,11848
1780,6,0,18,7,42737460,3610,2349180,198,11854
1781,7,0,20,5,42753780,3610,2349180,198,11861
1782,10,0,18,7,42794100,3610,2349180,197,11871
1783,9,0,23,2,42809160,3610,2349180,197,11880
1784,9,0,25,0,42835140,3610,2349540,197,11889
1785,11,0,23,2,42892320,3611,2349960,197,11900
1786,12,0,23,2,42931200,3611,2349960,197,11912
1787,5,0,15,10,42973200,3610,2349960,197,11917
1788,9,0,18,7,42988080,3610,2349960,197,11926
1789,11,0,23,2,43003980,3609,2349960,196,11937
1790,9,0,21,4,43035360,3608,2349960,196,11946
1791,7,0,20,5,43065840,3608,2349960,196,11953
1792,3,0,12,13,43108560,3609,2349960,196,11956
1793,8,0,18,7,43109760,3608,2349960,196,11964
1794,9,0,23,2,43116900,3608,2349960,196,11973
1795,13,0,22,3,43159800,3607,2349960,196,11986
1796,6,3,19,6,43180620,3607,2350740,196,11992
1797,6,5,19,6,43207680,3608,2357040,196,11998
1798,6,0,18,7,43251300,3608,2373180,197,12004
1799,3,0,12,13,43283580,3608,2373180,197,12007
1800,3,0,14,11,43286460,3608,2373180,197,12010
1801,2,0,13,12,43294860,3608,2373180,197,12012
1802,6,0,18,7,43299000,3608,2373180,197,12018
1803,7,0,19,6,43314780,3607,2373180,197,12025
1804,6,0,20,5,43339320,3608,2373180,197,12031
1805,2,0,14,11,43369920,3608,2373180,197,12033
1806,11,0,22,3,43380360,3608,2373180,197,12044
1807,10,5,19,6,43401720,3607,2373660,196,12054
1808,5,0,23,2,43440180,3609,2388780,198,12059
1809,10,7,18,7,43467600,3609,2389080,198,12069
1810,6,7,22,3,43483320,3609,2402460,198,12075
1811,14,5,25,0,43542960,3610,2419740,200,12089
1812,7,0,18,7,43582620,3608,2450880,202,12096
1813,6,0,17,8,43601820,3607,2450880,202,12102
1814,10,0,21,4,43616760,3607,2450880,202,12112
1815,12,0,24,1,43646760,3607,2451000,202,12124
1816,12,0,24,1,43703760,3608,2452680,202,12136
1817,11,0,22,3,43745520,3607,2453940,202,12147
1818,6,0,19,6,43776360,3607,2453940,201,12153
1819,6,0,18,7,43796520,3607,2453940,201,12159
1820,5,0,18,7,43825260,3608,2453940,201,12164
1821,6,2,18,7,43844340,3608,2454000,201,12170
1822,6,0,21,4,43863780,3608,2457840,201,12176
1823,6,0,19,6,43889940,3608,2457840,201,12182
1824,4,0,16,9,43929540,3609,2457840,201,12186
1825,2,0,16,9,43936080,3609,2457840,201,12188
1826,2,0,15,10,43950780,3609,2457840,201,12190
1827,6,0,18,7,43959660,3609,2457840,201,12196
1828,8,0,18,7,43988700,3609,2457840,201,12204
1829,6,0,17,8,44005440,3609,2457840,201,12210
1830,5,0,16,9,44020620,3608,2457840,201,12215
1831,6,0,18,7,44031480,3608,2457840,201,12221
1832,10,0,20,5,44048640,3607,2457840,200,12231
1833,4,0,19,6,44070180,3607,2457840,200,12235
1834,7,0,18,7,44109060,3608,2457840,200,12242
1835,8,0,20,5,44131320,3608,2457840,200,12250
1836,11,0,21,4,44157420,3607,2457840,200,12261
1837,14,3,24,1,44192220,3608,2462340,200,12275
1838,8,6,23,2,44222520,3608,2468400,200,12283
1839,6,0,20,5,44284620,3609,2491140,202,12289
1840,5,0,17,8,44323140,3610,2491140,202,12294
1841,3,0,16,9,44339340,3610,2491140,202,12297
1842,5,0,15,10,44366040,3610,2491140,202,12302
1843,5,0,18,7,44369100,3610,2491140,202,12307
1844,7,0,17,8,44398380,3610,2491140,202,12314
1845,2,0,16,9,44408100,3610,2491140,202,12316
1846,1,0,13,12,44424300,3610,2491140,202,12317
1847,3,0,15,10,44434320,3611,2491140,202,12320
1848,7,0,18,7,44440140,3610,2491140,202,12327
1849,3,0,17,8,44460240,3610,2491140,202,12330
1850,3,0,13,12,44486580,3610,2491140,201,12333
1851,2,0,14,11,44491380,3611,2491140,201,12335
1852,4,0,16,9,44493060,3610,2491140,201,12339
1853,7,0,20,5,44501640,3610,2491140,201,12346
1854,6,0,21,4,44520360,3610,2491140,201,12352
1855,6,0,18,7,44564760,3611,2491140,201,12358
1856,7,0,17,8,44582100,3610,2491140,201,12365
1857,8,0,18,7,44598000,3609,2491140,201,12373
1858,5,0,19,6,44612640,3609,2491140,201,12378
1859,9,0,20,5,44633880,3609,2491140,201,12387
1860,5,0,19,6,44657940,3609,2491140,201,12392
1861,11,0,22,3,44689920,3609,2491140,200,12403
1862,3,0,19,6,44714700,3609,2491140,200,12406
1863,10,0,18,7,44756640,3609,2491140,200,12416
1864,12,0,22,3,44775840,3609,2491140,200,12428
1865,9,0,22,3,44811600,3609,2491140,200,12437
1866,6,0,15,10,44853720,3609,2491140,200,12443
1867,3,0,13,12,44872380,3609,2491140,200,12446
1868,7,0,18,7,44876580,3608,2491140,200,12453
1869,8,0,21,4,44893020,3608,2491140,199,12461
1870,6,0,18,7,44923440,3608,2491140,199,12467
1871,1,0,16,9,44935200,3608,2491140,199,12468
1872,6,0,17,8,44959320,3609,2491140,199,12474
1873,4,0,17,8,44971620,3608,2491140,199,12478
1874,1,0,14,11,44992380,3609,2491140,199,12479
1875,4,0,16,9,45000420,3609,2491140,199,12483
1876,6,0,17,8,45016980,3609,2491140,199,12489
1877,5,0,18,7,45022920,3608,2491140,199,12494
1878,10,0,20,5,45049140,3608,2491140,199,12504
1879,5,0,17,8,45086280,3609,2491140,199,12509
1880,5,0,18,7,45100920,3609,2491140,199,12514
1881,2,0,17,8,45114540,3609,2491140,199,12516
1882,10,0,19,6,45137040,3608,2491140,198,12526
1883,9,0,21,4,45161280,3608,2491140,198,12535
1884,8,0,19,6,45190140,3608,2491140,198,12543
1885,9,0,17,8,45226200,3607,2491140,198,12552
1886,7,0,21,4,45239100,3608,2491140,198,12559
1887,8,0,21,4,45266160,3608,2491140,198,12567
1888,8,0,18,7,45306360,3608,2491140,198,12575
1889,8,2,21,4,45318960,3608,2491860,198,12583
1890,3,2,20,5,45345960,3609,2499780,198,12586
1891,8,0,24,1,45372480,3609,2502900,198,12594
1892,10,0,19,6,45430020,3609,2502900,198,12604
1893,4,0,18,7,45453420,3610,2502900,198,12608
1894,7,0,17,8,45490800,3610,2502900,198,12615
1895,4,0,15,10,45510060,3610,2502900,198,12619
1896,5,0,17,8,45521820,3610,2502900,198,12624
1897,4,0,14,11,45548340,3610,2502900,198,12628
1898,8,0,20,5,45551220,3610,2502900,198,12636
1899,3,0,17,8,45564360,3609,2502900,198,12639
1900,6,0,18,7,45588060,3610,2502900,197,12645
1901,7,0,18,7,45609180,3610,2502900,197,12652
1902,5,0,19,6,45617460,3609,2502900,197,12657
1903,3,0,15,10,45646500,3609,2502900,197,12660
1904,5,0,19,6,45647460,3609,2502900,197,12665
1905,9,0,20,5,45683160,3610,2502900,197,12674
1906,14,0,22,3,45714960,3609,2504580,197,12688
1907,10,7,20,5,45739920,3609,2508540,197,12698
1908,8,2,25,0,45771660,3610,2526300,198,12706
1909,15,0,24,1,45823800,3609,2538900,199,12721
1910,10,0,22,3,45864600,3608,2538900,199,12731
1911,8,0,21,4,45900240,3609,2538900,199,12739
1912,8,0,20,5,45935100,3609,2538900,199,12747
1913,9,0,19,6,45972480,3609,2538900,199,12756
1914,5,0,16,9,46003680,3609,2538900,198,12761
1915,5,0,18,7,46016400,3609,2538900,198,12766
1916,9,0,21,4,46041900,3609,2538900,198,12775
1917,5,0,18,7,46070340,3609,2538900,198,12780
1918,1,0,17,8,46084680,3610,2538900,198,12781
1919,1,0,14,11,46106220,3611,2538900,198,12782
1920,4,0,14,11,46123800,3611,2538900,198,12786
1921,6,0,16,9,46129500,3610,2538900,198,12792
1922,4,0,15,10,46145040,3610,2538900,198,12796
1923,6,0,17,8,46155840,3610,2538900,198,12802
1924,2,0,15,10,46172760,3610,2538900,198,12804
1925,8,0,18,7,46192740,3610,2538900,198,12812
1926,5,0,17,8,46208880,3610,2538900,198,12817
1927,9,0,21,4,46228440,3610,2538900,197,12826
1928,8,1,21,4,46245420,3609,2539200,197,12834
1929,8,3,21,4,46277580,3610,2543220,198,12842
1930,7,0,18,7,46330800,3610,2549940,198,12849
1931,13,0,20,5,46356480,3609,2549940,198,12862
1932,10,0,21,4,46374060,3608,2549940,198,12872
1933,8,0,21,4,46408320,3609,2549940,197,12880
1934,7,0,22,3,46425120,3608,2549940,197,12887
1935,6,0,16,9,46478880,3609,2549940,197,12893
1936,4,0,16,9,46490220,3609,2549940,197,12897
1937,14,0,25,0,46503840,3608,2550300,197,12911
1938,7,0,22,3,46535160,3608,2550300,197,12918
1939,3,0,14,11,46578600,3608,2550300,197,12921
1940,12,0,18,7,46599780,3608,2550300,197,12933
1941,4,0,21,4,46603500,3608,2550300,197,12937
1942,5,0,17,8,46649160,3609,2550300,197,12942
1943,7,0,16,9,46667640,3608,2550300,196,12949
1944,5,0,14,11,46691100,3608,2550300,196,12954
1945,5,0,19,6,46691100,3608,2550300,196,12959
1946,7,0,17,8,46723380,3608,2550300,196,12966
1947,2,0,15,10,46732620,3607,2550300,196,12968
1948,8,0,17,8,46746480,3607,2550300,196,12976
1949,6,0,20,5,46750020,3606,2550300,196,12982
1950,6,0,19,6,46774680,3606,2550300,196,12988
1951,4,0,17,8,46804380,3607,2550300,196,12992
1952,10,0,16,9,46836960,3606,2550300,196,13002
1953,8,0,20,5,46842180,3606,2550300,196,13010
1954,10,0,24,1,46862400,3605,2550300,195,13020
1955,9,0,21,4,46910460,3606,2554140,196,13029
1956,7,0,21,4,46932900,3606,2554140,195,13036
1957,8,0,21,4,46964340,3606,2554140,195,13044
1958,13,0,23,2,47002140,3606,2554140,195,13057
1959,9,0,22,3,47037780,3606,2554260,195,13066
1960,10,0,24,1,47065920,3606,2556060,195,13076
1961,3,0,16,9,47110260,3606,2556060,195,13079
1962,11,0,24,1,47129340,3607,2556300,195,13090
1963,14,7,20,5,47164020,3606,2557020,195,13104
1964,3,7,19,6,47192760,3607,2566140,195,13107
1965,4,5,20,5,47219580,3608,2584380,197,13111
1966,6,0,20,5,47259420,3608,2624700,200,13117
1967,3,0,16,9,47284380,3608,2624700,200,13120
1968,5,0,17,8,47302080,3608,2624700,199,13125
1969,1,0,13,12,47322300,3608,2624700,199,13126
1970,6,0,18,7,47325660,3608,2624700,199,13132
1971,1,0,14,11,47343240,3608,2624700,199,13133
1972,2,0,14,11,47350440,3608,2624700,199,13135
1973,6,0,17,8,47353140,3608,2624700,199,13141
1974,6,0,20,5,47364240,3608,2624700,199,13147
1975,9,0,24,1,47395020,3609,2624700,199,13156
1976,18,4,24,1,47431200,3608,2627280,199,13174
1977,8,0,24,1,47472540,3607,2643180,200,13182
1978,16,0,25,0,47525460,3607,2644980,200,13198
1979,13,1,25,0,47560020,3607,2646600,200,13211
1980,12,8,19,6,47615940,3608,2653140,200,13223
1981,9,8,25,0,47636340,3609,2677440,202,13232
1982,9,0,22,3,47684220,3607,2707800,204,13241
1983,9,6,17,8,47707920,3606,2711040,204,13250
1984,9,1,25,0,47735040,3607,2728980,205,13259
1985,5,0,19,6,47767200,3606,2734920,206,13264
1986,5,0,16,9,47799840,3606,2734920,206,13269
1987,7,0,18,7,47822520,3607,2734920,206,13276
1988,5,0,18,7,47833440,3606,2734920,205,13281
1989,6,0,18,7,47863140,3607,2734920,205,13287
1990,4,0,14,11,47888580,3606,2734920,205,13291
1991,6,0,18,7,47890680,3606,2734920,205,13297
1992,8,0,22,3,47908260,3606,2734920,205,13305
1993,5,0,19,6,47938740,3606,2734920,205,13310
1994,5,0,18,7,47967240,3607,2734920,205,13315
1995,4,0,15,10,47995440,3607,2734920,205,13319
1996,9,0,19,6,48009720,3607,2734920,205,13328
1997,7,0,15,10,48040560,3606,2734920,205,13335
1998,7,0,18,7,48048960,3606,2735160,205,13342
1999,8,0,22,3,48068580,3606,2736360,204,13350
2000,9,4,19,6,48099300,3606,2739780,205,13359
2001,5,0,20,5,48124620,3606,2751660,205,13364
2002,6,0,18,7,48160200,3606,2751660,205,13370
2003,5,0,17,8,48176700,3606,2751660,205,13375
2004,9,0,20,5,48194700,3606,2751660,205,13384
2005,4,0,17,8,48217920,3606,2751660,205,13388
2006,10,0,25,0,48226380,3606,2752020,205,13398
2007,5,0,19,6,48270480,3606,2752020,205,13403
2008,8,0,18,7,48311820,3607,2752020,205,13411
2009,7,0,17,8,48334080,3606,2752020,205,13418
2010,7,0,19,6,48345660,3606,2752020,204,13425
2011,9,0,19,6,48372780,3605,2752020,204,13434
2012,9,0,17,8,48415440,3606,2752020,204,13443
2013,6,0,19,6,48425220,3605,2752020,204,13449
2014,2,0,16,9,48453480,3606,2752020,204,13451
2015,6,0,17,8,48469380,3606,2752020,204,13457
2016,3,0,16,9,48490500,3606,2752020,204,13460
2017,1,0,16,9,48491340,3606,2752020,204,13461
2018,8,0,22,3,48493860,3606,2752020,204,13469
2019,7,0,23,2,48510420,3605,2752020,204,13476
2020,5,0,22,3,48541320,3606,2752020,204,13481
2021,3,0,24,1,48544140,3606,2752020,204,13484
2022,8,0,22,3,48601740,3608,2752320,203,13492
2023,11,1,25,0,48626220,3608,2752380,203,13503
2024,4,0,25,0,48644340,3608,2758380,204,13507
2025,9,0,22,3,48694200,3608,2758980,204,13516
2026,11,6,22,3,48708000,3608,2759520,204,13527
2027,6,11,20,5,48737220,3609,2760600,204,13533
2028,11,17,21,4,48767220,3610,2778240,205,13544
2029,9,23,22,3,48778140,3611,2805360,206,13553
2030,9,25,25,0,48814560,3612,2826180,208,13562
2031,5,23,25,0,48842580,3612,2854860,210,13567
2032,7,21,25,0,48879060,3613,2907840,214,13574
2033,8,17,25,0,48929640,3613,2970900,218,13582
2034,13,21,25,0,48957060,3613,3031320,223,13595
2035,7,21,25,0,48987360,3613,3040260,223,13602
2036,2,12,25,0,49031340,3614,3164940,232,13604
2037,5,0,18,7,49074420,3610,3465840,254,13609
2038,11,0,23,2,49085700,3610,3465840,254,13620
2039,3,0,20,5,49102320,3609,3465840,254,13623
2040,7,0,23,2,49125060,3610,3465840,254,13630
2041,6,0,22,3,49143180,3609,3465840,254,13636
2042,3,0,19,6,49172700,3610,3465840,254,13639
2043,7,0,22,3,49188240,3610,3465840,253,13646
2044,4,0,19,6,49207920,3610,3465840,253,13650
2045,7,0,19,6,49234680,3610,3465840,253,13657
2046,8,0,20,5,49248840,3609,3465840,253,13665
2047,8,0,22,3,49257420,3608,3465840,253,13673
2048,10,0,21,4,49293540,3608,3465840,253,13683
2049,9,0,24,1,49308420,3607,3465840,253,13692
2050,6,0,17,8,49351020,3607,3466200,253,13698
2051,5,0,19,6,49357740,3606,3466200,252,13703
2052,10,0,24,1,49374840,3606,3466200,252,13713
2053,12,4,25,0,49393440,3606,3467160,252,13725
2054,9,3,25,0,49431660,3606,3474720,253,13734
2055,6,0,23,2,49464840,3606,3485040,253,13740
2056,11,0,24,1,49505640,3606,3485040,253,13751
2057,14,3,25,0,49532520,3605,3490500,253,13765
2058,10,3,25,0,49558800,3605,3493800,253,13775
2059,14,10,24,1,49592040,3605,3497280,253,13789
2060,4,9,24,1,49626600,3606,3507960,254,13793
2061,7,9,25,0,49658700,3607,3524940,255,13800
2062,1,0,20,5,49707240,3606,3595560,260,13801
2063,8,0,23,2,49729380,3607,3595560,260,13809
2064,4,0,18,7,49750260,3606,3595560,260,13813
2065,6,0,20,5,49758300,3605,3595560,260,13819
2066,3,0,18,7,49783440,3606,3595560,260,13822
2067,2,0,16,9,49798200,3606,3595560,260,13824
2068,3,0,17,8,49802340,3606,3595560,260,13827
2069,12,0,24,1,49810020,3605,3595560,259,13839
2070,7,0,24,1,49831860,3605,3595560,259,13846
2071,4,0,19,6,49866600,3605,3595680,259,13850
2072,9,0,23,2,49890540,3605,3595680,259,13859
2073,5,0,23,2,49902240,3605,3595680,259,13864
2074,5,0,18,7,49935000,3605,3595680,259,13869
2075,4,0,19,6,49944720,3605,3595680,259,13873
2076,5,0,21,4,49950060,3604,3595680,259,13878
2077,4,0,18,7,49978020,3604,3595680,259,13882
2078,10,0,22,3,49993620,3604,3595680,258,13892
2079,16,6,25,0,50010480,3603,3596760,258,13908
2080,15,14,25,0,50043300,3604,3601860,258,13923
2081,6,17,21,4,50083680,3605,3613320,259,13929
2082,7,18,25,0,50095500,3605,3636480,260,13936
2083,6,12,25,0,50156820,3607,3702300,265,13942
2084,8,3,25,0,50186280,3604,3822480,274,13950
2085,6,0,19,6,50213640,3602,3845160,275,13956
2086,2,0,19,6,50218860,3602,3845160,275,13958
2087,7,0,21,4,50247600,3603,3845160,275,13965
2088,3,0,20,5,50256480,3603,3845160,275,13968
2089,14,5,25,0,50269860,3603,3846780,275,13982
2090,5,6,25,0,50291340,3603,3849120,275,13987
2091,8,6,25,0,50344740,3605,3859500,275,13995
2092,7,1,25,0,50385180,3605,3905700,278,14002
2093,6,0,19,6,50419800,3604,3907620,278,14008
2094,5,0,19,6,50434980,3604,3907620,278,14013
2095,4,0,17,8,50448000,3603,3907620,278,14017
2096,7,0,22,3,50451540,3603,3907620,278,14024
2097,6,0,22,3,50466720,3602,3907620,278,14030
2098,5,0,22,3,50493540,3603,3907620,278,14035
2099,7,0,21,4,50522400,3603,3908040,278,14042
2100,9,0,21,4,50545560,3602,3908760,278,14051
2101,10,1,25,0,50575140,3603,3909060,278,14061
2102,10,1,25,0,50610180,3603,3914400,278,14071
2103,7,0,23,2,50644200,3603,3914880,278,14078
2104,6,0,21,4,50670780,3603,3915000,277,14084
2105,14,4,25,0,50693760,3603,3915300,277,14098
2106,6,2,25,0,50730960,3603,3927840,278,14104
2107,8,0,25,0,50765340,3603,3935160,278,14112
2108,4,0,19,6,50809800,3604,3935160,278,14116
2109,5,0,19,6,50825340,3604,3935160,278,14121
2110,7,0,17,8,50852820,3603,3935160,278,14128
2111,6,0,19,6,50862780,3603,3935160,278,14134
2112,5,0,20,5,50874900,3603,3935160,278,14139
2113,3,0,20,5,50880060,3602,3935160,278,14142
2114,2,0,20,5,50895840,3603,3935160,278,14144
2115,6,0,21,4,50920620,3603,3935160,278,14150
2116,8,0,23,2,50935620,3603,3935160,277,14158
2117,8,0,21,4,50971560,3603,3935160,277,14166
2118,7,0,21,4,50991540,3603,3935160,277,14173
2119,7,0,20,5,51015780,3602,3935160,277,14180
2120,5,0,21,4,51030300,3602,3935160,277,14185
2121,12,0,23,2,51066720,3602,3935160,277,14197
2122,14,4,25,0,51088860,3602,3936900,277,14211
2123,9,5,25,0,51119160,3602,3938820,277,14220
2124,5,6,22,3,51153660,3603,3943380,277,14225
2125,7,0,21,4,51199500,3602,3977400,279,14232
2126,6,0,20,5,51228480,3603,3977400,279,14238
2127,8,0,24,1,51240120,3602,3977400,279,14246
2128,9,0,23,2,51263940,3602,3977400,279,14255
2129,6,0,23,2,51288420,3602,3977400,278,14261
2130,7,0,21,4,51307080,3601,3977400,278,14268
2131,11,0,23,2,51342600,3601,3977940,278,14279
2132,4,0,21,4,51365640,3601,3977940,278,14283
2133,7,0,20,5,51404340,3602,3979440,278,14290
2134,5,0,19,6,51431280,3602,3979440,278,14295
2135,8,0,24,1,51448980,3603,3979440,278,14303
2136,3,0,19,6,51477660,3603,3979440,278,14306
2137,8,0,22,3,51499380,3603,3979440,278,14314
2138,6,0,19,6,51516240,3602,3979440,277,14320
2139,6,0,18,7,51534480,3601,3979440,277,14326
2140,6,0,19,6,51548340,3601,3979440,277,14332
2141,10,0,25,0,51557100,3601,3979680,277,14342
2142,6,0,22,3,51582720,3600,3979680,277,14348
2143,11,3,25,0,51603480,3600,3979680,277,14359
2144,2,0,20,5,51642780,3601,3982680,277,14361
2145,8,0,23,2,51664680,3601,3982680,277,14369
2146,11,0,25,0,51684120,3600,3982680,276,14380
2147,10,6,23,2,51710100,3600,3985080,276,14390
2148,9,8,25,0,51741540,3601,3998580,277,14399
2149,12,13,25,0,51773640,3602,4009020,278,14411
2150,8,12,25,0,51819720,3603,4028460,279,14419
2151,11,14,25,0,51849900,3602,4056420,281,14430
2152,6,0,24,1,51899520,3601,4176780,289,14436
2153,11,0,23,2,51921120,3599,4177200,289,14447
2154,8,0,23,2,51941940,3599,4177200,288,14455
2155,6,0,22,3,51964440,3598,4177200,288,14461
2156,7,0,19,6,51998460,3598,4177200,288,14468
2157,6,0,22,3,52004580,3598,4177200,288,14474
2158,3,0,19,6,52031160,3598,4177200,288,14477
2159,6,0,19,6,52050540,3598,4177200,288,14483
2160,8,0,21,4,52064340,3598,4177200,288,14491
2161,4,0,19,6,52083180,3597,4177200,288,14495
2162,4,0,20,5,52093320,3597,4177200,288,14499
2163,5,0,19,6,52109880,3597,4177200,288,14504
2164,2,0,18,7,52126440,3597,4177200,287,14506
2165,6,0,21,4,52138260,3597,4177200,287,14512
2166,10,1,25,0,52151280,3597,4177380,287,14522
2167,9,0,22,3,52190400,3597,4178220,287,14531
2168,8,0,22,3,52215480,3596,4178220,287,14539
2169,9,1,25,0,52237860,3597,4178220,287,14548
2170,4,0,22,3,52263180,3596,4178280,287,14552
2171,7,0,22,3,52299840,3597,4178280,286,14559
2172,4,0,22,3,52319460,3598,4178280,286,14563
2173,8,0,24,1,52356060,3599,4178280,286,14571
2174,6,0,22,3,52382040,3598,4178280,286,14577
2175,10,1,25,0,52407540,3599,4178280,286,14587
2176,9,1,25,0,52444680,3599,4180440,286,14596
2177,4,0,21,4,52478700,3599,4180440,286,14600
2178,4,0,20,5,52498680,3599,4180440,286,14604
2179,7,0,21,4,52517700,3599,4180440,286,14611
2180,7,0,19,6,52550820,3599,4180440,285,14618
2181,6,0,21,4,52564380,3599,4180440,285,14624
2182,3,0,18,7,52583520,3599,4180440,285,14627
2183,2,0,16,9,52603620,3599,4180440,285,14629
2184,3,0,17,8,52606860,3599,4180440,285,14632
2185,5,0,21,4,52609740,3599,4180440,285,14637
2186,4,0,20,5,52625760,3599,4180440,285,14641
2187,7,0,22,3,52641240,3599,4180440,285,14648
2188,4,0,21,4,52660140,3599,4180440,285,14652
2189,7,0,21,4,52687260,3599,4180440,285,14659
2190,5,0,21,4,52702500,3599,4180440,285,14664
2191,7,0,23,2,52715640,3598,4180440,284,14671
2192,9,0,25,0,52743900,3599,4180560,284,14680
2193,5,0,22,3,52775280,3599,4181100,284,14685
2194,5,0,22,3,52802040,3599,4181100,284,14690
2195,7,0,21,4,52828380,3599,4181100,284,14697
2196,8,0,23,2,52847700,3599,4181100,284,14705
2197,9,1,25,0,52875420,3599,4181220,284,14714
2198,11,3,25,0,52912440,3600,4181760,284,14725
2199,8,4,25,0,52938900,3600,4187280,284,14733
2200,2,0,20,5,52977060,3600,4200180,285,14735
2201,7,0,20,5,53010600,3600,4200180,284,14742
2202,12,1,25,0,53024280,3600,4200420,284,14754
2203,9,0,25,0,53050620,3599,4203360,284,14763
2204,3,0,19,6,53093160,3600,4203600,284,14766
2205,8,0,22,3,53115360,3600,4203600,284,14774
2206,5,0,23,2,53126700,3600,4203600,284,14779
2207,3,0,20,5,53157900,3600,4203600,284,14782
2208,10,0,24,1,53175540,3600,4204740,284,14792
2209,6,0,21,4,53209620,3600,4204740,284,14798
2210,3,0,18,7,53237220,3601,4204740,284,14801
2211,1,0,18,7,53238360,3601,4204740,284,14802
2212,7,0,19,6,53258940,3601,4204740,283,14809
2213,7,0,21,4,53268180,3600,4204740,283,14816
2214,6,0,23,2,53279340,3600,4204740,283,14822
2215,6,0,23,2,53305080,3600,4204920,283,14828
2216,10,0,24,1,53347560,3601,4204920,283,14838
2217,8,0,24,1,53364420,3600,4204920,283,14846
2218,15,4,25,0,53398680,3600,4205760,283,14861
2219,10,4,25,0,53438220,3600,4213740,283,14871
2220,8,1,25,0,53484360,3600,4238340,284,14879
2221,9,0,25,0,53512920,3600,4240380,284,14888
2222,6,0,24,1,53542860,3600,4246980,285,14894
2223,11,1,25,0,53587500,3601,4254480,285,14905
2224,9,0,25,0,53620260,3601,4260120,285,14914
2225,14,1,25,0,53652120,3600,4263060,285,14928
2226,12,3,25,0,53693520,3600,4268640,285,14940
2227,8,5,24,1,53714100,3600,4276140,286,14948
2228,5,6,24,1,53739900,3601,4281540,286,14953
2229,7,7,25,0,53783340,3602,4298880,287,14960
2230,3,0,21,4,53835180,3602,4340640,290,14963
2231,8,0,25,0,53847480,3602,4340940,289,14971
2232,7,0,21,4,53884080,3602,4340940,289,14978
2233,5,0,20,5,53899560,3602,4340940,289,14983
2234,2,0,17,8,53911860,3601,4340940,289,14985
2235,7,0,20,5,53926860,3601,4340940,289,14992
2236,2,0,20,5,53932740,3601,4340940,289,14994
2237,9,0,23,2,53960880,3602,4342320,289,15003
2238,11,2,25,0,53979840,3601,4343400,289,15014
2239,5,0,24,1,54007800,3601,4346040,289,15019
2240,5,0,22,3,54045060,3602,4346040,289,15024
2241,8,0,20,5,54085800,3602,4346040,289,15032
2242,5,0,21,4,54099840,3602,4346040,289,15037
2243,6,0,21,4,54109140,3601,4346040,288,15043
2244,10,0,22,3,54146400,3602,4346040,288,15053
2245,6,0,24,1,54163020,3602,4346040,288,15059
2246,12,5,25,0,54187800,3602,4353240,288,15071
2247,12,11,25,0,54228420,3603,4358280,288,15083
2248,12,14,25,0,54269880,3604,4391400,290,15095
2249,8,12,25,0,54305640,3604,4407060,291,15103
2250,6,7,25,0,54337860,3604,4445940,294,15109
2251,4,0,22,3,54370740,3602,4533060,299,15113
2252,5,0,19,6,54402120,3603,4533060,299,15118
2253,6,0,20,5,54419760,3603,4533060,299,15124
2254,8,0,20,5,54445140,3602,4533060,299,15132
2255,7,0,19,6,54458700,3601,4533060,299,15139
2256,2,0,18,7,54471300,3601,4533060,299,15141
2257,6,0,21,4,54481920,3601,4533060,299,15147
2258,5,0,22,3,54507600,3602,4533060,299,15152
2259,4,0,20,5,54527280,3602,4533060,299,15156
2260,2,0,18,7,54544500,3602,4533060,299,15158
2261,1,0,16,9,54566640,3603,4533060,299,15159
2262,7,0,19,6,54573900,3602,4533060,298,15166
2263,4,0,20,5,54585660,3603,4533060,298,15170
2264,7,0,25,0,54590700,3602,4533060,298,15177
2265,9,0,20,5,54639600,3602,4533480,298,15186
2266,3,0,21,4,54647760,3602,4533480,298,15189
2267,9,0,21,4,54682080,3602,4533480,298,15198
2268,7,0,22,3,54697980,3602,4533480,298,15205
2269,9,0,22,3,54726960,3602,4536000,298,15214
2270,6,0,21,4,54753540,3602,4536000,298,15220
2271,6,0,22,3,54773340,3602,4536000,297,15226
2272,9,0,25,0,54798060,3602,4536000,297,15235
2273,7,1,25,0,54819660,3602,4536480,297,15242
2274,8,3,22,3,54852840,3602,4538640,297,15250
2275,10,3,25,0,54886620,3603,4544460,297,15260
2276,6,0,19,6,54923160,3602,4552680,298,15266
2277,9,0,22,3,54954120,3602,4552680,298,15275
2278,5,0,19,6,54976080,3602,4552680,297,15280
2279,2,0,18,7,54985320,3602,4552680,297,15282
2280,6,0,20,5,55001220,3602,4552680,297,15288
2281,1,0,16,9,55019040,3602,4552680,297,15289
2282,3,0,16,9,55024380,3602,4552680,297,15292
2283,7,0,19,6,55027980,3601,4552680,297,15299
2284,4,0,21,4,55031220,3601,4552680,297,15303
2285,6,0,20,5,55056720,3601,4552680,297,15309
2286,6,0,18,7,55076820,3600,4552680,297,15315
2287,9,0,21,4,55092360,3600,4552680,297,15324
2288,10,2,25,0,55100700,3599,4553460,296,15334
2289,6,0,25,0,55139220,3600,4557060,297,15340
2290,9,0,23,2,55182720,3600,4557060,296,15349
2291,5,0,22,3,55198620,3600,4557060,296,15354
2292,13,3,24,1,55224180,3600,4558860,296,15367
2293,9,10,20,5,55258620,3600,4559220,296,15376
2294,7,13,22,3,55276080,3601,4567080,296,15383
2295,5,10,25,0,55307340,3602,4592040,298,15388
2296,7,7,25,0,55350720,3602,4646640,301,15395
2297,11,1,25,0,55391220,3601,4701720,305,15406
2298,9,3,25,0,55416420,3601,4706580,305,15415
2299,7,2,25,0,55461480,3602,4721100,306,15422
2300,4,0,21,4,55488960,3602,4729500,306,15426
2301,4,0,19,6,55520700,3602,4729500,306,15430
2302,6,0,21,4,55535100,3602,4729500,306,15436
2303,2,0,19,6,55553400,3602,4729500,306,15438
2304,1,0,15,10,55579140,3603,4729500,306,15439
2305,6,0,19,6,55583400,3603,4729500,306,15445
2306,5,0,20,5,55591920,3602,4729500,306,15450
2307,0,0,16,9,55609680,3603,4729500,306,15450
2308,3,0,18,7,55618920,3603,4729500,306,15453
2309,3,0,16,9,55627680,3602,4729500,305,15456
2310,8,0,22,3,55630080,3602,4729500,305,15464
2311,6,0,24,1,55643640,3602,4729500,305,15470
2312,8,0,23,2,55678080,3602,4729500,305,15478
2313,2,0,18,7,55715580,3603,4729500,305,15480
2314,7,0,20,5,55728300,3603,4729500,305,15487
2315,10,1,25,0,55734420,3602,4731300,305,15497
2316,9,0,25,0,55767120,3602,4732080,305,15506
2317,14,6,25,0,55799940,3602,4735440,305,15520
2318,7,2,25,0,55838040,3602,4750620,305,15527
2319,10,1,25,0,55870200,3601,4759920,306,15537
2320,5,0,19,6,55911240,3601,4759920,306,15542
2321,7,0,20,5,55919280,3600,4759920,306,15549
2322,8,0,23,2,55936620,3600,4759920,305,15557
2323,9,0,23,2,55959780,3600,4759920,305,15566
2324,7,0,22,3,55986540,3600,4760580,305,15573
2325,3,0,18,7,56018100,3600,4760580,305,15576
2326,3,0,17,8,56038140,3600,4760580,305,15579
2327,4,0,21,4,56038140,3600,4760580,305,15583
2328,1,0,19,6,56052600,3601,4760580,305,15584
2329,2,0,19,6,56056260,3600,4760580,305,15586
2330,5,0,19,6,56089560,3601,4760580,305,15591
2331,5,0,20,5,56096940,3601,4760580,305,15596
2332,6,0,21,4,56117460,3601,4760580,305,15602
2333,6,0,19,6,56134620,3600,4760580,305,15608
2334,8,0,21,4,56147640,3600,4760580,304,15616
2335,8,0,24,1,56167920,3600,4760580,304,15624
2336,8,0,24,1,56206020,3601,4761240,304,15632
2337,8,2,25,0,56228400,3601,4765440,304,15640
2338,5,0,22,3,56266020,3601,4766460,304,15645
2339,11,0,25,0,56290020,3601,4766760,304,15656
2340,8,0,23,2,56329620,3601,4766760,304,15664
2341,9,0,24,1,56352480,3601,4766760,304,15673
2342,14,5,25,0,56387460,3601,4770720,304,15687
2343,5,1,25,0,56417580,3601,4783800,304,15692
2344,6,0,21,4,56453520,3601,4790160,305,15698
2345,4,0,19,6,56474400,3600,4790160,305,15702
2346,4,0,17,8,56495400,3600,4790160,304,15706
2347,6,0,21,4,56507520,3601,4790160,304,15712
2348,6,0,23,2,56524200,3601,4790640,304,15718
2349,4,0,20,5,56560560,3602,4790640,304,15722
2350,3,0,18,7,56579940,3602,4790640,304,15725
2351,6,0,21,4,56584620,3601,4790640,304,15731
2352,7,0,21,4,56600040,3601,4790640,304,15738
2353,10,1,25,0,56626080,3601,4790640,304,15748
2354,4,0,21,4,56649120,3601,4790940,304,15752
2355,4,0,19,6,56677620,3601,4790940,304,15756
2356,4,0,19,6,56684520,3601,4790940,303,15760
2357,8,0,22,3,56705460,3601,4790940,303,15768
2358,6,0,22,3,56728320,3601,4790940,303,15774
2359,2,0,18,7,56754240,3601,4790940,303,15776
2360,7,0,17,8,56778780,3601,4790940,303,15783
2361,9,1,22,3,56781480,3600,4790940,303,15792
2362,6,2,22,3,56808960,3601,4796220,303,15798
2363,16,7,24,1,56837400,3601,4805640,303,15814
2364,9,6,25,0,56865960,3600,4814160,304,15823
2365,10,4,25,0,56899080,3600,4843680,305,15833
2366,12,4,25,0,56940360,3600,4849080,306,15845
2367,9,0,22,3,56977860,3598,4872660,307,15854
2368,4,0,19,6,57007800,3599,4872660,307,15858
2369,6,0,17,8,57033960,3599,4872660,307,15864
2370,9,0,24,1,57038280,3598,4872660,306,15873
2371,6,0,20,5,57069900,3598,4872660,306,15879
2372,5,0,18,7,57096360,3598,4872660,306,15884
2373,7,0,22,3,57104160,3598,4872660,306,15891
2374,6,0,22,3,57124140,3598,4872660,306,15897
2375,4,0,18,7,57149460,3598,4872660,306,15901
2376,6,0,21,4,57164820,3598,4872660,306,15907
2377,4,0,20,5,57175200,3597,4872660,306,15911
2378,4,0,20,5,57191700,3598,4872660,306,15915
2379,2,0,16,9,57214020,3598,4872660,306,15917
2380,5,0,20,5,57217140,3598,4872660,306,15922
2381,4,0,23,2,57223620,3598,4872660,305,15926
2382,5,0,21,4,57252480,3598,4872660,305,15931
2383,9,0,22,3,57279720,3598,4872660,305,15940
2384,6,0,21,4,57298320,3598,4872660,305,15946
2385,5,0,20,5,57329460,3598,4872660,305,15951
2386,9,0,23,2,57343860,3598,4872660,305,15960
2387,8,0,24,1,57364140,3597,4872840,305,15968
2388,13,0,24,1,57406620,3597,4873860,304,15981
2389,8,0,22,3,57439080,3597,4877100,305,15989
2390,9,2,25,0,57457080,3597,4877100,304,15998
2391,10,0,25,0,57508860,3598,4888380,305,16008
2392,3,0,20,5,57528120,3597,4888380,305,16011
2393,10,3,25,0,57536340,3597,4888680,305,16021
2394,12,12,22,3,57570120,3598,4894260,305,16033
2395,2,13,20,5,57586860,3598,4898940,305,16035
2396,4,12,22,3,57612900,3599,4907400,305,16039
2397,5,10,25,0,57638760,3600,4925340,306,16044
2398,7,12,25,0,57668820,3601,4959360,308,16051
2399,7,11,25,0,57713640,3602,5038320,313,16058

