Hour,Arrivals,Waiting,Treating,Available Rooms,Total Treatment Time,Average Treatment Time,Total Wait Time,Average Wait Time,Total Arrivals
1,2,0,2,23,0,0,0,0,2
2,5,0,3,22,8760,2190,0,0,7
3,5,0,4,21,15720,1965,0,0,12
4,6,0,4,21,29700,2121,0,0,18
5,3,0,6,19,33120,2208,0,0,21
6,11,0,11,14,55740,2654,0,0,32
7,8,0,9,16,93120,3003,0,0,40
8,4,0,3,22,134160,3272,0,0,44
9,8,0,8,17,142500,3238,0,0,52
10,10,0,12,13,165600,3312,0,0,62
11,9,0,7,18,210780,3293,0,0,71
12,10,0,7,18,244920,3309,0,0,81
13,14,0,12,13,264960,3192,0,0,95
14,13,0,13,12,296100,3116,0,0,108
15,11,0,11,14,346320,3206,0,0,119
16,19,0,17,8,384180,3175,0,0,138
17,9,0,12,13,458460,3396,0,0,147
18,11,0,11,14,498540,3391,0,0,158
19,4,0,7,18,541740,3495,0,0,162
20,8,0,10,15,564000,3525,0,0,170
21,6,0,4,21,617160,3588,0,0,176
22,6,0,6,19,633540,3599,0,0,182
23,3,0,4,21,648720,3584,0,0,185
24,4,0,3,22,662220,3560,0,0,189
25,3,0,1,24,684900,3585,0,0,192
26,3,0,4,21,684900,3585,0,0,195
27,7,0,9,16,686820,3558,0,0,202
28,10,0,12,13,710700,3553,0,0,212
29,8,0,8,17,765060,3608,0,0,220
30,13,0,12,13,788460,3567,0,0,233
31,8,0,7,18,830460,3548,0,0,241
32,4,0,5,20,852840,3553,0,0,245
33,10,0,10,15,870180,3551,0,0,255
34,11,0,11,14,913320,3581,0,0,266
35,6,0,8,17,949860,3597,0,0,272
36,15,0,14,11,981480,3595,0,0,287
37,5,0,10,15,1011900,3588,0,0,292
38,7,0,6,19,1066560,3640,0,0,299
39,6,0,8,17,1084920,3652,0,0,305
40,12,0,10,15,1114320,3629,0,0,317
41,9,0,8,17,1143120,3594,0,0,326
42,11,0,11,14,1169040,3586,0,0,337
43,5,0,9,16,1198920,3600,0,0,342
44,6,0,4,21,1240620,3606,0,0,348
45,4,0,4,21,1250340,3592,0,0,352
46,7,0,3,22,1270260,3568,0,0,359
47,8,0,5,20,1285440,3550,0,0,367
48,4,0,5,20,1293540,3534,0,0,371
49,5,0,8,17,1296480,3523,0,0,376
50,7,0,7,18,1334700,3549,0,0,383
51,5,0,3,22,1371240,3561,0,0,388
52,7,0,8,17,1380180,3566,0,0,395
53,4,0,5,20,1403100,3561,0,0,399
54,7,0,6,19,1432320,3580,0,0,406
55,8,0,8,17,1440540,3548,0,0,414
56,9,0,10,15,1466280,3550,0,0,423
57,10,0,8,17,1498680,3526,0,0,433
58,12,0,13,12,1516080,3509,0,0,445
59,8,0,10,15,1555260,3510,0,0,453
60,9,0,13,12,1594500,3551,0,0,462
61,7,0,7,18,1629600,3527,0,0,469
62,9,0,10,15,1650180,3526,0,0,478
63,8,0,8,17,1688220,3531,0,0,486
64,16,0,19,6,1702860,3525,0,0,502
65,5,0,8,17,1769100,3545,0,0,507
66,12,0,7,18,1814340,3543,0,0,519
67,16,0,12,13,1847340,3532,0,0,535
68,3,0,9,16,1864260,3524,0,0,538
69,7,0,3,22,1929660,3560,0,0,545
70,6,0,5,20,1938000,3549,0,0,551
71,3,0,4,21,1958160,3560,0,0,554
72,3,0,3,22,1976160,3567,0,0,557
73,6,0,5,20,1988640,3563,0,0,563
74,6,0,5,20,2008320,3560,0,0,569
75,4,0,5,20,2015220,3547,0,0,573
76,6,0,5,20,2043060,3559,0,0,579
77,1,0,0,25,2068380,3566,0,0,580
78,7,0,3,22,2073600,3550,0,0,587
79,6,0,5,20,2079900,3537,0,0,593
80,12,0,12,13,2090700,3525,0,0,605
81,13,0,15,10,2125980,3525,0,0,618
82,9,0,12,13,2175840,3537,0,0,627
83,10,0,10,15,2223720,3546,0,0,637
84,11,0,13,12,2231880,3514,0,0,648
85,13,0,9,16,2309520,3542,0,0,661
86,11,0,13,12,2328900,3533,0,0,672
87,15,0,17,8,2377080,3547,0,0,687
88,6,0,7,18,2434200,3548,0,0,693
89,7,0,5,20,2465220,3547,0,0,700
90,12,0,12,13,2477100,3538,0,0,712
91,9,0,11,14,2515920,3543,0,0,721
92,8,0,8,17,2561160,3552,0,0,729
93,10,0,9,16,2605080,3568,0,0,739
94,9,0,9,16,2626740,3554,0,0,748
95,5,0,7,18,2655060,3559,0,0,753
96,8,0,6,19,2682480,3552,0,0,761
97,8,0,8,17,2711760,3563,0,0,769
98,3,0,4,21,2730120,3554,0,0,772
99,8,0,4,21,2756760,3552,0,0,780
100,3,0,4,21,2761980,3545,0,0,783
101,6,0,7,18,2770800,3543,0,0,789
102,12,0,10,15,2795040,3533,0,0,801
103,6,0,7,18,2831940,3539,0,0,807
104,10,0,8,17,2858100,3532,0,0,817
105,12,0,5,20,2885100,3501,0,0,829
106,9,0,9,16,2895420,3492,0,0,838
107,12,0,15,10,2922420,3499,0,0,850
108,10,0,11,14,2984580,3515,0,0,860
109,9,0,7,18,3017760,3500,0,0,869
110,18,0,13,12,3052560,3492,0,0,887
111,19,0,20,5,3081180,3477,0,0,906
112,8,0,15,10,3136680,3489,0,0,914
113,5,0,11,14,3187620,3510,0,0,919
114,8,0,9,16,3244020,3533,0,0,927
115,14,0,8,17,3276120,3511,0,0,941
116,10,0,9,16,3307800,3511,0,0,951
117,10,0,9,16,3341400,3509,0,0,961
118,6,0,8,17,3362760,3506,0,0,967
119,5,0,5,20,3407820,3524,0,0,972
120,5,0,2,23,3426060,3513,0,0,977
121,5,0,3,22,3435180,3508,0,0,982
122,5,0,5,20,3441120,3504,0,0,987
123,9,0,8,17,3458160,3500,0,0,996
124,8,0,7,18,3486300,3496,0,0,1004
125,7,0,8,17,3509700,3499,0,0,1011
126,3,0,3,22,3553200,3514,0,0,1014
127,7,0,7,18,3558000,3508,0,0,1021
128,14,0,14,11,3581700,3508,0,0,1035
129,7,0,12,13,3613980,3508,0,0,1042
130,10,0,12,13,3652080,3511,0,0,1052
131,15,0,13,12,3696180,3506,0,0,1067
132,8,0,11,14,3738180,3513,0,0,1075
133,8,0,10,15,3774900,3518,0,0,1083
134,13,0,10,15,3807060,3505,0,0,1096
135,9,0,14,11,3824160,3505,0,0,1105
136,14,0,11,14,3895020,3515,0,0,1119
137,7,0,4,21,3941820,3513,0,0,1126
138,9,0,8,17,3953820,3508,0,0,1135
139,10,0,11,14,3984120,3513,0,0,1145
140,7,0,9,16,4021320,3518,0,0,1152
141,9,0,9,16,4056180,3520,0,0,1161
142,11,0,13,12,4084500,3524,0,0,1172
143,10,0,11,14,4135020,3531,0,0,1182
144,6,0,9,16,4170780,3537,0,0,1188
145,6,0,9,16,4210440,3553,0,0,1194
146,4,0,7,18,4248480,3567,0,0,1198
147,5,0,6,19,4281060,3576,0,0,1203
148,7,0,9,16,4295400,3576,0,0,1210
149,7,0,9,16,4319340,3575,0,0,1217
150,8,0,6,19,4367940,3583,0,0,1225
151,6,0,8,17,4384080,3584,0,0,1231
152,7,0,9,16,4406520,3585,0,0,1238
153,9,0,11,14,4439340,3591,0,0,1247
154,8,0,8,17,4482840,3594,0,0,1255
155,7,0,8,17,4507380,3594,0,0,1262
156,11,0,11,14,4534080,3592,0,0,1273
157,6,0,8,17,4569300,3595,0,0,1279
158,12,0,12,13,4600080,3596,0,0,1291
159,14,0,14,11,4637880,3592,0,0,1305
160,18,0,21,4,4673520,3589,0,0,1323
161,4,0,10,15,4763460,3616,0,0,1327
162,4,0,7,18,4800720,3625,0,0,1331
163,13,0,13,12,4830420,3629,0,0,1344
164,4,0,3,22,4879560,3627,0,0,1348
165,8,0,7,18,4893660,3627,0,0,1356
166,7,0,6,19,4919460,3625,0,0,1363
167,5,0,8,17,4929900,3624,0,0,1368
168,3,0,5,20,4960260,3631,0,0,1371
169,3,0,3,22,4988580,3638,0,0,1374
170,5,0,5,20,4998300,3637,0,0,1379
171,2,0,5,20,5005500,3637,0,0,1381
172,5,0,6,19,5022300,3639,0,0,1386
173,5,0,3,22,5050260,3638,0,0,1391
174,8,0,7,18,5057580,3633,0,0,1399
175,9,0,12,13,5072280,3633,0,0,1408
176,11,0,15,10,5102040,3633,0,0,1419
177,15,0,10,15,5180760,3638,0,0,1434
178,8,0,9,16,5211780,3636,0,0,1442
179,10,0,10,15,5250900,3641,0,0,1452
180,6,0,9,16,5289480,3650,0,0,1458
181,15,0,12,13,5332980,3650,0,0,1473
182,15,0,13,12,5368140,3639,0,0,1488
183,9,0,10,15,5421720,3646,0,0,1497
184,5,0,7,18,5455680,3649,0,0,1502
185,11,0,11,14,5492640,3656,0,0,1513
186,9,0,12,13,5515380,3652,0,0,1522
187,15,0,12,13,5564460,3648,0,0,1537
188,12,0,11,14,5604720,3644,0,0,1549
189,12,0,10,15,5649180,3642,0,0,1561
190,8,0,9,16,5686980,3645,0,0,1569
191,8,0,9,16,5718060,3646,0,0,1577
192,5,0,5,20,5754660,3649,0,0,1582
193,6,0,6,19,5767680,3645,0,0,1588
194,8,0,6,19,5792160,3642,0,0,1596
195,7,0,9,16,5807700,3643,0,0,1603
196,4,0,3,22,5845620,3644,0,0,1607
197,9,0,9,16,5854020,3642,0,0,1616
198,3,0,3,22,5877300,3636,0,0,1619
199,12,0,12,13,5885520,3635,0,0,1631
200,9,0,6,19,5944740,3638,0,0,1640
201,8,0,5,20,5975520,3636,0,0,1648
202,10,0,8,17,5994660,3633,0,0,1658
203,15,0,16,9,6022980,3634,0,0,1673
204,14,0,18,7,6075540,3640,0,0,1687
205,10,0,11,14,6137220,3640,0,0,1697
206,14,0,14,11,6183780,3643,0,0,1711
207,7,0,10,15,6237840,3652,0,0,1718
208,16,0,13,12,6281520,3649,0,0,1734
209,7,0,10,15,6316440,3649,0,0,1741
210,10,0,7,18,6372300,3653,0,0,1751
211,6,0,8,17,6388380,3652,0,0,1757
212,7,0,7,18,6419760,3653,0,0,1764
213,7,0,9,16,6447420,3659,0,0,1771
214,2,0,4,21,6468960,3656,0,0,1773
215,1,0,3,22,6484140,3661,0,0,1774
216,1,0,4,21,6484140,3661,0,0,1775
217,4,0,5,20,6505200,3666,0,0,1779
218,9,0,9,16,6516780,3663,0,0,1788
219,7,0,8,17,6537480,3658,0,0,1795
220,8,0,4,21,6579780,3657,0,0,1803
221,10,0,8,17,6593280,3652,0,0,1813
222,5,0,6,19,6608160,3646,0,0,1818
223,11,0,5,20,6654120,3648,0,0,1829
224,13,0,12,13,6669600,3644,0,0,1842
225,10,0,10,15,6699600,3637,0,0,1852
226,7,0,7,18,6749040,3644,0,0,1859
227,10,0,12,13,6769440,3645,0,0,1869
228,11,0,13,12,6811020,3648,0,0,1880
229,13,0,12,13,6843480,3638,0,0,1893
230,10,0,15,10,6860160,3633,0,0,1903
231,9,0,13,12,6928860,3648,480,0,1912
232,12,0,11,14,7001400,3659,480,0,1924
233,11,0,10,15,7037100,3655,480,0,1935
234,6,0,7,18,7074240,3657,480,0,1941
235,9,0,8,17,7092600,3652,480,0,1950
236,5,0,2,23,7144920,3658,480,0,1955
237,10,0,9,16,7147320,3654,480,0,1965
238,9,0,9,16,7176000,3651,480,0,1974
239,4,0,4,21,7208880,3651,480,0,1978
240,3,0,4,21,7219380,3651,480,0,1981
241,2,0,2,23,7241100,3655,480,0,1983
242,6,0,7,18,7246380,3656,480,0,1989
243,1,0,2,23,7267860,3655,480,0,1990
244,6,0,4,21,7276260,3652,480,0,1996
245,3,0,5,20,7280460,3651,480,0,1999
246,9,0,9,16,7298100,3650,480,0,2008
247,9,0,10,15,7332060,3653,480,0,2017
248,11,0,12,13,7362000,3651,480,0,2028
249,8,0,9,16,7413360,3657,480,0,2036
250,10,0,7,18,7452060,3654,480,0,2046
251,8,0,7,18,7475940,3652,480,0,2054
252,14,0,11,14,7500300,3646,480,0,2068
253,12,0,6,19,7550100,3640,480,0,2080
254,8,0,3,22,7583280,3637,480,0,2088
255,8,0,8,17,7589460,3634,480,0,2096
256,4,0,4,21,7623540,3637,480,0,2100
257,19,0,13,12,7639740,3627,480,0,2119
258,8,0,11,14,7668060,3623,480,0,2127
259,7,0,10,15,7705260,3627,480,0,2134
260,3,0,4,21,7746420,3631,480,0,2137
261,7,0,4,21,7770000,3630,480,0,2144
262,8,0,6,19,7785900,3628,480,0,2152
263,3,0,2,23,7807560,3626,480,0,2155
264,9,0,7,18,7817640,3624,480,0,2164
265,3,0,4,21,7842000,3625,480,0,2167
266,5,0,6,19,7859460,3628,480,0,2172
267,8,0,11,14,7872060,3629,480,0,2180
268,5,0,5,20,7918140,3632,480,0,2185
269,8,0,7,18,7930680,3627,480,0,2193
270,10,0,7,18,7961760,3625,480,0,2203
271,9,0,8,17,7989060,3624,480,0,2212
272,7,0,5,20,8012340,3618,480,0,2219
273,10,0,7,18,8034420,3615,480,0,2229
274,14,0,16,9,8042220,3611,480,0,2243
275,12,0,16,9,8105580,3620,480,0,2255
276,9,0,10,15,8166540,3623,480,0,2264
277,14,0,8,17,8212740,3617,480,0,2278
278,12,0,12,13,8229180,3612,480,0,2290
279,14,0,12,13,8279280,3612,480,0,2304
280,14,0,12,13,8320140,3608,480,0,2318
281,9,0,8,17,8366100,3607,480,0,2327
282,5,0,4,21,8408160,3611,480,0,2332
283,6,0,3,22,8437020,3613,480,0,2338
284,6,0,6,19,8442420,3610,480,0,2344
285,12,0,13,12,8467380,3613,480,0,2356
286,8,0,7,18,8507100,3609,480,0,2364
287,3,0,5,20,8535900,3613,480,0,2367
288,4,0,5,20,8555280,3615,480,0,2371
289,5,0,6,19,8568060,3615,480,0,2376
290,8,0,7,18,8581260,3610,480,0,2384
291,7,0,5,20,8604720,3606,480,0,2391
292,6,0,4,21,8633940,3607,480,0,2397
293,4,0,2,23,8648940,3605,480,0,2401
294,4,0,5,20,8651820,3604,480,0,2405
295,6,0,4,21,8672760,3603,480,0,2411
296,12,0,9,16,8682120,3596,480,0,2423
297,10,0,10,15,8717340,3597,480,0,2433
298,10,0,12,13,8746080,3597,480,0,2443
299,10,0,14,11,8786820,3602,480,0,2453
300,13,0,12,13,8842320,3603,480,0,2466
301,10,0,10,15,8869980,3596,480,0,2476
302,12,0,10,15,8902980,3592,480,0,2488
303,14,0,8,17,8959080,3592,480,0,2502
304,6,0,7,18,8981100,3591,480,0,2508
305,9,0,5,20,9026460,3593,480,0,2517
306,15,0,12,13,9038760,3586,480,0,2532
307,7,0,9,16,9075240,3587,480,0,2539
308,3,0,4,21,9107040,3588,480,0,2542
309,5,0,3,22,9136140,3591,480,0,2547
310,3,0,4,21,9147900,3593,480,0,2550
311,3,0,3,22,9163920,3593,480,0,2553
312,6,0,6,19,9174660,3593,480,0,2559
313,5,0,4,21,9190440,3590,480,0,2564
314,11,0,10,15,9217560,3593,480,0,2575
315,3,0,7,18,9232440,3590,480,0,2578
316,4,0,5,20,9259860,3593,480,0,2582
317,8,0,9,16,9279180,3595,480,0,2590
318,10,0,11,14,9316560,3598,480,0,2600
319,4,0,8,17,9343260,3599,480,0,2604
320,15,0,13,12,9377820,3598,480,0,2619
321,9,0,8,17,9430620,3599,480,0,2628
322,9,0,7,18,9473640,3602,480,0,2637
323,5,0,6,19,9490080,3600,480,0,2642
324,11,0,10,15,9510720,3598,480,0,2653
325,11,0,12,13,9541620,3597,480,0,2664
326,12,0,11,14,9580560,3594,480,0,2676
327,8,0,9,16,9614760,3594,480,0,2684
328,3,0,5,20,9642420,3595,480,0,2687
329,9,0,6,19,9675240,3596,480,0,2696
330,10,0,12,13,9680820,3593,480,0,2706
331,10,0,8,17,9726600,3591,480,0,2716
332,14,0,13,12,9753840,3589,480,0,2730
333,4,0,7,18,9787200,3588,480,0,2734
334,6,0,4,21,9825540,3591,480,0,2740
335,4,0,2,23,9837780,3587,480,0,2744
336,6,0,4,21,9845160,3585,480,0,2750
337,6,0,7,18,9851940,3583,480,0,2756
338,1,0,3,22,9879900,3587,480,0,2757
339,7,0,4,21,9899820,3586,480,0,2764
340,4,0,3,22,9914820,3585,480,0,2768
341,5,0,4,21,9927660,3585,480,0,2773
342,6,0,5,20,9945900,3585,480,0,2779
343,11,0,10,15,9962940,3583,480,0,2790
344,6,0,8,17,9990300,3583,480,0,2796
345,9,0,11,14,10015980,3584,480,0,2805
346,13,0,13,12,10048680,3582,480,0,2818
347,14,0,19,6,10074420,3581,480,0,2832
348,8,0,11,14,10156980,3590,480,0,2840
349,9,0,8,17,10212180,3594,480,0,2849
350,16,0,13,12,10242660,3591,480,0,2865
351,8,0,10,15,10275240,3588,480,0,2873
352,11,0,8,17,10321980,3589,480,0,2884
353,9,0,12,13,10336380,3587,480,0,2893
354,8,0,10,15,10373040,3588,480,0,2901
355,7,0,6,19,10415460,3589,480,0,2908
356,9,0,5,20,10445820,3587,480,0,2917
357,16,0,13,12,10466100,3584,480,0,2933
358,6,0,7,18,10500000,3581,480,0,2939
359,8,0,6,19,10522140,3577,480,0,2947
360,2,0,5,20,10540680,3580,480,0,2949
361,4,0,6,19,10556820,3582,480,0,2953
362,5,0,6,19,10571700,3581,480,0,2958
363,4,0,4,21,10599180,3583,480,0,2962
364,9,0,8,17,10609200,3580,480,0,2971
365,10,0,9,16,10631460,3577,480,0,2981
366,5,0,8,17,10667700,3582,480,0,2986
367,10,0,13,12,10680180,3580,480,0,2996
368,10,0,8,17,10750920,3586,480,0,3006
369,10,0,11,14,10778160,3586,480,0,3016
370,7,0,8,17,10814220,3586,480,0,3023
371,15,0,12,13,10848600,3585,480,0,3038
372,13,0,9,16,10891320,3580,480,0,3051
373,7,0,8,17,10921620,3580,480,0,3058
374,10,0,7,18,10947000,3576,480,0,3068
375,7,0,7,18,10974540,3577,480,0,3075
376,6,0,6,19,10996380,3576,480,0,3081
377,3,0,5,20,11008260,3575,480,0,3084
378,16,0,10,15,11036160,3571,480,0,3100
379,6,0,6,19,11067000,3570,480,0,3106
380,8,0,5,20,11099280,3570,480,0,3114
381,5,0,4,21,11111580,3567,480,0,3119
382,5,0,5,20,11126100,3567,480,0,3124
383,4,0,4,21,11140860,3566,480,0,3128
384,9,0,9,16,11157480,3566,480,0,3137
385,9,0,13,12,11167560,3564,480,0,3146
386,8,0,5,20,11223960,3564,480,0,3154
387,6,0,6,19,11237580,3562,480,0,3160
388,10,0,11,14,11256180,3563,480,0,3170
389,5,0,8,17,11282460,3562,480,0,3175
390,4,0,6,19,11309580,3564,480,0,3179
391,7,0,8,17,11334180,3566,480,0,3186
392,5,0,6,19,11360280,3566,480,0,3191
393,9,0,8,17,11376840,3564,480,0,3200
394,9,0,13,12,11389440,3563,480,0,3209
395,5,0,4,21,11434800,3562,480,0,3214
396,13,0,7,18,11460780,3559,480,0,3227
397,13,0,10,15,11490480,3557,480,0,3240
398,5,0,5,20,11533080,3559,480,0,3245
399,9,0,5,20,11554680,3556,480,0,3254
400,5,0,6,19,11579220,3559,480,0,3259
401,8,0,6,19,11608920,3559,480,0,3267
402,13,0,9,16,11626800,3554,480,0,3280
403,12,0,12,13,11651580,3552,480,0,3292
404,5,0,8,17,11700780,3557,480,0,3297
405,12,0,8,17,11737980,3555,480,0,3309
406,6,0,9,16,11748960,3553,480,0,3315
407,8,0,5,20,11797380,3555,480,0,3323
408,5,0,4,21,11812380,3553,480,0,3328
409,4,0,4,21,11832000,3555,480,0,3332
410,9,0,7,18,11850540,3554,480,0,3341
411,8,0,8,17,11865360,3551,480,0,3349
412,1,0,4,21,11885880,3552,480,0,3350
413,8,0,10,15,11904480,3555,480,0,3358
414,8,0,12,13,11924220,3555,480,0,3366
415,10,0,7,18,11980200,3556,480,0,3376
416,9,0,6,19,12010200,3554,480,0,3385
417,10,0,9,16,12025560,3551,480,0,3395
418,8,0,11,14,12047400,3551,480,0,3403
419,8,0,7,18,12095040,3553,480,0,3411
420,8,0,6,19,12135960,3555,480,0,3419
421,17,0,12,13,12163920,3552,480,0,3436
422,17,0,19,6,12195420,3551,480,0,3453
423,10,0,11,14,12268080,3553,480,0,3463
424,9,0,13,12,12293340,3554,480,0,3472
425,13,0,15,10,12351540,3559,480,0,3485
426,8,0,11,14,12387600,3557,480,0,3493
427,11,0,12,13,12420300,3556,480,0,3504
428,6,0,7,18,12462840,3557,480,0,3510
429,5,0,4,21,12493920,3558,480,0,3515
430,7,0,6,19,12504600,3556,480,0,3522
431,7,0,6,19,12528840,3556,480,0,3529
432,2,0,4,21,12540720,3555,480,0,3531
433,2,0,2,23,12558840,3556,480,0,3533
434,2,0,0,25,12571440,3556,480,0,3535
435,4,0,3,22,12572160,3555,480,0,3539
436,6,0,6,19,12577860,3554,480,0,3545
437,7,0,5,20,12604860,3553,480,0,3552
438,10,0,8,17,12617940,3550,480,0,3562
439,6,0,6,19,12654300,3552,480,0,3568
440,10,0,7,18,12673380,3548,480,0,3578
441,7,0,9,16,12688920,3548,480,0,3585
442,9,0,9,16,12732240,3551,480,0,3594
443,8,0,11,14,12755820,3552,480,0,3602
444,14,0,15,10,12793140,3552,480,0,3616
445,10,0,11,14,12840360,3551,480,0,3626
446,11,0,10,15,12886800,3553,480,0,3637
447,9,0,11,14,12916380,3553,480,0,3646
448,15,0,11,14,12970140,3553,480,0,3661
449,11,0,11,14,13011360,3554,480,0,3672
450,7,0,10,15,13042320,3554,480,0,3679
451,11,0,11,14,13082400,3555,480,0,3690
452,10,0,10,15,13121340,3555,480,0,3700
453,8,0,9,16,13163640,3558,480,0,3708
454,3,0,2,23,13199640,3558,480,0,3711
455,9,0,6,19,13214940,3558,480,0,3720
456,9,0,7,18,13230600,3554,480,0,3729
457,7,0,4,21,13257120,3552,480,0,3736
458,5,0,7,18,13265340,3552,480,0,3741
459,7,0,9,16,13281180,3552,480,0,3748
460,9,0,9,16,13311120,3551,480,0,3757
461,6,0,8,17,13338360,3552,480,0,3763
462,3,0,4,21,13372980,3554,480,0,3766
463,17,0,12,13,13392840,3551,480,0,3783
464,6,0,10,15,13424820,3552,480,0,3789
465,9,0,6,19,13471080,3552,480,0,3798
466,8,0,8,17,13489140,3551,480,0,3806
467,10,0,13,12,13515360,3553,480,0,3816
468,8,0,11,14,13554360,3554,480,0,3824
469,12,0,12,13,13601160,3556,480,0,3836
470,12,0,15,10,13630380,3556,480,0,3848
471,8,0,11,14,13688580,3560,480,0,3856
472,11,0,9,16,13731840,3559,480,0,3867
473,11,0,7,18,13776360,3558,480,0,3878
474,19,0,15,10,13803360,3555,480,0,3897
475,13,0,13,12,13838880,3551,480,0,3910
476,10,0,12,13,13886280,3553,480,0,3920
477,8,0,8,17,13937220,3555,480,0,3928
478,3,0,3,22,13967340,3555,480,0,3931
479,7,0,3,22,13985040,3554,480,0,3938
480,9,0,4,21,14009640,3553,480,0,3947
481,4,0,5,20,14018940,3552,480,0,3951
482,8,0,9,16,14025000,3550,480,0,3959
483,4,0,4,21,14067900,3553,480,0,3963
484,8,0,7,18,14081880,3552,480,0,3971
485,7,0,7,18,14111340,3553,480,0,3978
486,3,0,5,20,14126580,3552,480,0,3981
487,10,0,7,18,14151000,3551,480,0,3991
488,7,0,8,17,14164140,3549,480,0,3998
489,18,0,12,13,14204760,3547,480,0,4016
490,15,0,15,10,14241960,3546,480,0,4031
491,9,0,10,15,14275140,3542,480,0,4040
492,12,0,11,14,14320080,3543,480,0,4052
493,12,0,13,12,14370720,3547,480,0,4064
494,17,0,17,8,14418960,3547,480,0,4081
495,12,0,17,8,14454600,3546,480,0,4093
496,9,0,11,14,14536980,3553,480,0,4102
497,8,0,9,16,14578860,3554,480,0,4110
498,10,0,4,21,14620320,3552,480,0,4120
499,5,0,6,19,14633520,3552,480,0,4125
500,5,0,6,19,14659500,3554,480,0,4130
501,9,0,9,16,14675640,3553,480,0,4139
502,7,0,7,18,14715780,3555,480,0,4146
503,8,0,9,16,14737500,3555,480,0,4154
504,10,0,12,13,14756700,3554,480,0,4164
505,5,0,7,18,14804880,3557,480,0,4169
506,4,0,5,20,14844960,3561,480,0,4173
507,7,0,4,21,14862900,3559,480,0,4180
508,4,0,5,20,14877000,3559,480,0,4184
509,4,0,5,20,14888460,3559,480,0,4188
510,7,0,2,23,14913600,3556,480,0,4195
511,5,0,2,23,14921400,3554,480,0,4200
512,8,0,8,17,14927040,3554,480,0,4208
513,9,0,13,12,14940900,3553,480,0,4217
514,8,0,10,15,14982360,3554,480,0,4225
515,6,0,8,17,15011700,3554,480,0,4231
516,10,0,10,15,15050040,3557,480,0,4241
517,8,0,9,16,15089100,3558,480,0,4249
518,10,0,10,15,15120480,3558,480,0,4259
519,10,0,11,14,15159120,3560,480,0,4269
520,6,0,9,16,15191520,3561,480,0,4275
521,12,0,11,14,15234360,3562,480,0,4287
522,5,0,9,16,15259440,3562,480,0,4292
523,12,0,12,13,15286740,3561,480,0,4304
524,12,0,13,12,15332640,3563,480,0,4316
525,8,0,10,15,15378360,3564,480,0,4324
526,8,0,8,17,15423780,3567,480,0,4332
527,8,0,8,17,15456420,3567,480,0,4340
528,8,0,4,21,15497460,3567,480,0,4348
529,8,0,7,18,15511380,3566,480,0,4356
530,9,0,8,17,15525600,3563,480,0,4365
531,9,0,8,17,15555540,3562,480,0,4374
532,5,0,5,20,15586980,3563,480,0,4379
533,8,0,7,18,15599040,3561,480,0,4387
534,9,0,6,19,15631380,3560,480,0,4396
535,9,0,9,16,15640980,3558,480,0,4405
536,7,0,8,17,15679200,3560,480,0,4412
537,6,0,8,17,15697140,3559,480,0,4418
538,15,0,14,11,15738120,3561,480,0,4433
539,11,0,14,11,15776400,3561,480,0,4444
540,8,0,10,15,15840600,3566,480,0,4452
541,11,0,9,16,15880500,3565,480,0,4463
542,9,0,9,16,15907200,3564,480,0,4472
543,12,0,12,13,15948360,3566,480,0,4484
544,12,0,14,11,15980340,3565,480,0,4496
545,6,0,5,20,16042140,3567,480,0,4502
546,8,0,8,17,16061460,3567,480,0,4510
547,7,0,6,19,16097280,3568,480,0,4517
548,10,0,7,18,16123620,3567,480,0,4527
549,6,0,6,19,16142880,3565,480,0,4533
550,7,0,7,18,16159620,3564,480,0,4540
551,1,0,2,23,16178460,3564,480,0,4541
552,4,0,2,23,16190160,3563,480,0,4545
553,1,0,1,24,16194360,3563,480,0,4546
554,5,0,4,21,16202460,3563,480,0,4551
555,6,0,6,19,16212960,3562,480,0,4557
556,6,0,4,21,16237140,3561,480,0,4563
557,9,0,9,16,16255740,3562,480,0,4572
558,4,0,7,18,16279740,3563,480,0,4576
559,9,0,9,16,16308600,3563,480,0,4585
560,4,0,7,18,16332660,3564,480,0,4589
561,9,0,6,19,16372260,3565,480,0,4598
562,13,0,10,15,16397280,3563,480,0,4611
563,16,0,13,12,16433760,3561,480,0,4627
564,13,0,10,15,16477980,3558,480,0,4640
565,8,0,10,15,16508280,3559,480,0,4648
566,18,0,15,10,16555740,3559,480,0,4666
567,16,0,19,6,16593420,3558,480,0,4682
568,12,0,10,15,16674060,3559,480,0,4694
569,11,0,13,12,16698540,3558,480,0,4705
570,13,0,11,14,16750320,3558,480,0,4718
571,10,0,12,13,16786380,3559,480,0,4728
572,6,0,10,15,16829040,3562,480,0,4734
573,6,0,6,19,16866300,3562,480,0,4740
574,7,0,5,20,16896960,3563,480,0,4747
575,5,0,4,21,16917900,3563,480,0,4752
576,5,0,4,21,16938000,3563,480,0,4757
577,4,0,6,19,16943820,3563,480,0,4761
578,5,0,6,19,16969080,3564,480,0,4766
579,5,0,5,20,16995060,3565,480,0,4771
580,6,0,8,17,17005980,3565,480,0,4777
581,4,0,7,18,17030220,3567,480,0,4781
582,3,0,4,21,17062980,3569,480,0,4784
583,9,0,10,15,17068080,3568,480,0,4793
584,9,0,11,14,17097300,3568,480,0,4802
585,10,0,10,15,17148840,3571,480,0,4812
586,12,0,13,12,17177100,3570,480,0,4824
587,12,0,14,11,17227980,3572,480,0,4836
588,16,0,14,11,17271180,3569,480,0,4852
589,5,0,8,17,17307960,3569,480,0,4857
590,13,0,10,15,17351880,3570,480,0,4870
591,12,0,10,15,17377800,3566,480,0,4882
592,14,0,13,12,17424540,3568,480,0,4896
593,13,0,12,13,17468640,3567,480,0,4909
594,6,0,7,18,17510160,3567,480,0,4915
595,6,0,6,19,17537940,3568,480,0,4921
596,3,0,5,20,17550660,3567,480,0,4924
597,3,0,3,22,17579880,3570,480,0,4927
598,2,0,1,24,17592840,3569,480,0,4929
599,4,0,2,23,17597520,3568,480,0,4933
600,5,0,5,20,17601240,3568,480,0,4938
601,4,0,3,22,17618400,3567,480,0,4942
602,4,0,4,21,17630280,3567,480,0,4946
603,3,0,1,24,17640960,3565,480,0,4949
604,5,0,4,21,17644860,3564,480,0,4954
605,10,0,7,18,17660520,3562,480,0,4964
606,8,0,4,21,17691240,3561,480,0,4972
607,5,0,3,22,17712720,3561,480,0,4977
608,11,0,10,15,17722800,3560,480,0,4988
609,9,0,7,18,17761920,3559,480,0,4997
610,5,0,8,17,17779560,3560,480,0,5002
611,8,0,7,18,17812200,3560,480,0,5010
612,10,0,12,13,17841060,3562,480,0,5020
613,14,0,14,11,17871720,3560,480,0,5034
614,16,0,14,11,17928900,3560,480,0,5050
615,18,0,16,9,17980740,3559,480,0,5068
616,8,0,13,12,18032160,3561,480,0,5076
617,6,0,9,16,18083700,3564,480,0,5082
618,8,0,9,16,18124680,3567,480,0,5090
619,5,0,8,17,18156540,3569,480,0,5095
620,4,0,3,22,18195600,3570,480,0,5099
621,8,0,7,18,18210180,3570,480,0,5107
622,5,0,7,18,18231720,3571,480,0,5112
623,5,0,4,21,18261480,3571,480,0,5117
624,4,0,2,23,18292200,3573,480,0,5121
625,7,0,7,18,18294300,3572,480,0,5128
626,6,0,7,18,18314280,3572,480,0,5134
627,6,0,7,18,18341820,3573,480,0,5140
628,8,0,5,20,18376620,3573,480,0,5148
629,8,0,7,18,18395700,3572,480,0,5156
630,7,0,6,19,18414600,3570,480,0,5163
631,13,0,10,15,18442080,3569,480,0,5176
632,10,0,10,15,18479640,3570,480,0,5186
633,4,0,4,21,18520320,3571,480,0,5190
634,13,0,13,12,18538920,3572,480,0,5203
635,5,0,7,18,18579720,3572,480,0,5208
636,20,0,13,12,18611700,3568,480,0,5228
637,15,0,17,8,18653460,3569,480,0,5243
638,10,0,12,13,18705660,3569,480,0,5253
639,7,0,8,17,18753180,3570,480,0,5260
640,8,0,7,18,18789600,3571,480,0,5268
641,4,0,6,19,18813180,3572,480,0,5272
642,13,0,11,14,18836280,3571,480,0,5285
643,4,0,7,18,18862140,3571,480,0,5289
644,6,0,5,20,18911940,3575,480,0,5295
645,4,0,4,21,18931200,3575,480,0,5299
646,9,0,8,17,18942300,3574,480,0,5308
647,5,0,2,23,18975960,3572,480,0,5313
648,5,0,6,19,18977100,3572,480,0,5318
649,6,0,9,16,18988620,3572,480,0,5324
650,7,0,10,15,19020060,3574,480,0,5331
651,5,0,9,16,19046340,3575,480,0,5336
652,5,0,6,19,19085520,3577,480,0,5341
653,5,0,4,21,19107780,3576,480,0,5346
654,6,0,5,20,19128300,3577,480,0,5352
655,4,0,5,20,19145220,3577,480,0,5356
656,14,0,7,18,19174020,3575,480,0,5370
657,7,0,7,18,19198440,3575,480,0,5377
658,17,0,13,12,19226160,3572,480,0,5394
659,6,0,7,18,19258320,3570,480,0,5400
660,6,0,4,21,19290120,3570,480,0,5406
661,13,0,16,9,19296000,3571,480,0,5419
662,11,0,11,14,19345920,3570,480,0,5430
663,10,0,10,15,19394520,3571,480,0,5440
664,8,0,10,15,19420260,3571,480,0,5448
665,9,0,9,16,19461420,3572,480,0,5457
666,6,0,6,19,19499520,3573,480,0,5463
667,6,0,9,16,19507320,3572,480,0,5469
668,8,0,12,13,19534500,3574,480,0,5477
669,9,0,6,19,19597200,3576,480,0,5486
670,9,0,6,19,19625040,3575,480,0,5495
671,7,0,9,16,19640040,3575,480,0,5502
672,4,0,6,19,19671660,3576,480,0,5506
673,6,0,11,14,19672680,3576,480,0,5512
674,5,0,13,12,19681620,3575,480,0,5517
675,5,0,11,14,19709280,3576,480,0,5522
676,7,0,14,11,19720980,3575,480,0,5529
677,9,0,16,9,19745880,3575,480,0,5538
678,9,0,14,11,19794720,3577,480,0,5547
679,4,0,12,13,19825620,3579,480,0,5551
680,6,0,10,15,19851060,3578,480,0,5557
681,7,0,12,13,19872180,3579,480,0,5564
682,12,0,10,15,19913880,3577,480,0,5576
683,4,0,10,15,19921800,3576,480,0,5580
684,13,0,16,9,19943100,3575,480,0,5593
685,13,0,20,5,19976460,3576,480,0,5606
686,6,0,13,12,20021220,3575,480,0,5612
687,8,0,16,9,20042640,3576,1320,0,5620
688,10,0,16,9,20082960,3577,1320,0,5630
689,9,0,13,12,20127840,3577,1320,0,5639
690,7,0,14,11,20154180,3578,1320,0,5646
691,7,0,12,13,20190540,3579,1320,0,5653
692,8,0,11,14,20215860,3578,1320,0,5661
693,3,0,8,17,20238060,3578,1320,0,5664
694,10,0,14,11,20250000,3577,1320,0,5674
695,3,0,9,16,20280360,3578,1320,0,5677
696,4,0,9,16,20299500,3578,1320,0,5681
697,7,0,12,13,20319240,3579,1320,0,5688
698,8,0,17,8,20326380,3579,1320,0,5696
699,4,0,12,13,20358420,3579,1320,0,5700
700,5,0,10,15,20389920,3580,1320,0,5705
701,5,0,8,17,20416140,3580,1320,0,5710
702,6,0,10,15,20425020,3579,1320,0,5716
703,7,0,9,16,20451240,3579,1320,0,5723
704,7,0,9,16,20476800,3579,1320,0,5730
705,9,0,14,11,20484720,3578,1320,0,5739
706,11,0,15,10,20516400,3577,1320,0,5750
707,10,0,13,12,20551380,3576,1320,0,5760
708,11,0,15,10,20593260,3577,1320,0,5771
709,14,0,21,4,20612160,3576,1320,0,5785
710,11,0,16,9,20669520,3576,1320,0,5796
711,4,0,16,9,20689080,3576,2220,0,5800
712,11,0,14,11,20746440,3578,2220,0,5811
713,6,0,13,12,20777700,3579,2220,0,5817
714,12,0,18,7,20802660,3579,2220,0,5829
715,11,3,15,10,20847780,3580,4560,0,5840
716,14,9,18,7,20882400,3583,11880,2,5854
717,6,9,17,8,20924760,3586,17340,2,5860
718,5,0,17,8,20990100,3589,83880,14,5865
719,3,0,11,14,21010560,3587,83880,14,5868
720,7,0,10,15,21050220,3589,83880,14,5875
721,11,0,17,8,21063480,3588,83880,14,5886
722,4,0,14,11,21087480,3588,83880,14,5890
723,0,0,6,19,21133140,3591,83880,14,5890
724,4,0,8,17,21141540,3591,83880,14,5894
725,8,0,10,15,21149880,3589,83880,14,5902
726,6,0,11,14,21166140,3589,83880,14,5908
727,4,0,9,16,21190440,3589,83880,14,5912
728,5,0,9,16,21210360,3590,83880,14,5917
729,8,0,12,13,21222600,3589,83880,14,5925
730,7,0,12,13,21243000,3588,83880,14,5932
731,8,0,15,10,21262140,3588,83880,14,5940
732,9,0,11,14,21299580,3586,83880,14,5949
733,12,0,17,8,21314220,3585,83880,14,5961
734,5,0,11,14,21360960,3587,83880,14,5966
735,12,0,15,10,21389880,3587,83880,14,5978
736,9,0,13,12,21417240,3585,83880,14,5987
737,8,1,16,9,21438600,3586,83880,13,5995
738,13,6,14,11,21490380,3588,87660,14,6008
739,8,0,16,9,21528600,3588,108120,17,6016
740,9,0,15,10,21566520,3588,108120,17,6025
741,4,0,8,17,21627000,3591,108120,17,6029
742,2,0,7,18,21639240,3592,108120,17,6031
743,9,0,13,12,21650880,3592,108120,17,6040
744,5,0,12,13,21666960,3591,108120,17,6045
745,5,0,13,12,21686280,3592,108120,17,6050
746,5,0,13,12,21712020,3593,108120,17,6055
747,11,0,13,12,21746580,3592,108120,17,6066
748,5,0,11,14,21776640,3593,108120,17,6071
749,7,0,9,16,21798240,3591,108120,17,6078
750,2,0,7,18,21811440,3591,108120,17,6080
751,4,0,9,16,21819900,3591,108120,17,6084
752,7,0,10,15,21840180,3591,108120,17,6091
753,9,0,15,10,21847560,3590,108120,17,6100
754,11,0,16,9,21885900,3590,108120,17,6111
755,9,0,14,11,21925860,3590,108120,17,6120
756,8,0,10,15,21962880,3589,108120,17,6128
757,11,0,16,9,21983700,3590,108120,17,6139
758,11,0,18,7,22009380,3589,108120,17,6150
759,13,0,14,11,22073160,3589,108120,17,6163
760,11,0,15,10,22098600,3588,108120,17,6174
761,10,0,15,10,22129440,3587,108120,17,6184
762,10,0,14,11,22173840,3588,108120,17,6194
763,7,0,12,13,22199280,3586,108120,17,6201
764,3,0,9,16,22232940,3588,108120,17,6204
765,10,0,14,11,22250580,3588,108120,17,6214
766,6,0,14,11,22269840,3588,108120,17,6220
767,6,0,13,12,22301400,3589,108120,17,6226
768,3,0,9,16,22331760,3590,108120,17,6229
769,2,0,8,17,22348500,3591,108120,17,6231
770,7,0,11,14,22361880,3591,108120,17,6238
771,8,0,16,9,22369440,3590,108120,17,6246
772,5,0,12,13,22400760,3590,108120,17,6251
773,9,0,15,10,22428360,3591,108120,17,6260
774,8,0,13,12,22475580,3593,108120,17,6268
775,4,0,9,16,22504860,3593,108120,17,6272
776,9,0,12,13,22527060,3593,108120,17,6281
777,10,0,13,12,22544040,3590,108120,17,6291
778,8,0,12,13,22573260,3590,108120,17,6299
779,13,0,15,10,22597200,3588,108120,17,6312
780,14,0,19,6,22627620,3587,108120,17,6326
781,9,0,15,10,22685640,3589,108120,17,6335
782,8,0,14,11,22720380,3589,108120,17,6343
783,15,0,14,11,22764780,3588,108120,17,6358
784,14,0,19,6,22790520,3587,108120,16,6372
785,12,0,22,3,22812600,3585,108120,16,6384
786,9,1,16,9,22870080,3586,108720,17,6393
787,8,0,15,10,22915260,3588,110160,17,6401
788,8,0,16,9,22943820,3588,110160,17,6409
789,8,0,14,11,22986120,3589,110160,17,6417
790,9,0,10,15,23025900,3588,110160,17,6426
791,9,0,11,14,23050500,3588,110160,17,6435
792,6,0,11,14,23077080,3588,110160,17,6441
793,3,0,8,17,23105220,3589,110160,17,6444
794,3,0,8,17,23116200,3590,110160,17,6447
795,3,0,8,17,23129220,3590,110160,17,6450
796,3,0,7,18,23143980,3590,110160,17,6453
797,8,0,13,12,23146320,3589,110160,17,6461
798,10,0,13,12,23172360,3588,110160,17,6471
799,8,0,13,12,23203620,3588,110160,17,6479
800,5,0,10,15,23234220,3588,110160,16,6484
801,10,0,14,11,23247300,3587,110160,16,6494
802,21,0,24,1,23289780,3588,110160,16,6515
803,12,1,18,7,23340900,3586,110580,16,6527
804,10,0,18,7,23397480,3589,112440,17,6537
805,9,0,13,12,23444940,3588,112440,17,6546
806,7,0,11,14,23474580,3588,112440,17,6553
807,8,0,12,13,23488800,3586,112440,17,6561
808,9,0,17,8,23512200,3588,112440,17,6570
809,8,0,12,13,23560200,3588,112440,17,6578
810,5,0,10,15,23579820,3587,112440,17,6583
811,5,0,12,13,23594100,3587,112440,17,6588
812,4,0,8,17,23623500,3588,112440,17,6592
813,4,0,8,17,23634060,3587,112440,17,6596
814,4,0,8,17,23639640,3586,112440,17,6600
815,4,0,9,16,23653440,3586,112440,17,6604
816,6,0,11,14,23659860,3585,112440,17,6610
817,7,0,15,10,23671920,3585,112440,16,6617
818,6,0,14,11,23702040,3586,112440,16,6623
819,6,0,13,12,23732220,3587,112440,16,6629
820,8,0,13,12,23751840,3585,112440,16,6637
821,8,0,10,15,23790960,3585,112440,16,6645
822,6,0,11,14,23809200,3585,112440,16,6651
823,5,0,11,14,23823060,3585,112440,16,6656
824,10,0,17,8,23841480,3585,112440,16,6666
825,9,0,18,7,23867460,3585,112440,16,6675
826,9,0,11,14,23927820,3585,112440,16,6684
827,9,0,13,12,23962380,3587,112440,16,6693
828,10,0,17,8,23980560,3586,112440,16,6703
829,12,0,18,7,24017340,3586,112440,16,6715
830,5,0,10,15,24078720,3588,112440,16,6720
831,9,0,12,13,24105360,3588,112440,16,6729
832,6,0,12,13,24130440,3589,112440,16,6735
833,10,0,11,14,24168840,3589,112440,16,6745
834,11,0,16,9,24186000,3588,112440,16,6756
835,10,0,20,5,24211620,3589,112440,16,6766
836,9,0,14,11,24265620,3589,112440,16,6775
837,5,0,8,17,24318960,3591,112440,16,6780
838,3,0,9,16,24321120,3590,112440,16,6783
839,1,0,9,16,24327540,3590,112440,16,6784
840,2,0,9,16,24347040,3592,112440,16,6786
841,11,0,12,13,24365520,3591,112440,16,6797
842,6,0,11,14,24398160,3592,112440,16,6803
843,5,0,9,16,24412980,3590,112440,16,6808
844,6,0,7,18,24437520,3590,112440,16,6814
845,5,0,9,16,24446160,3589,112440,16,6819
846,5,0,13,12,24451020,3589,112440,16,6824
847,9,0,13,12,24482760,3589,112440,16,6833
848,4,0,12,13,24501840,3590,112440,16,6837
849,12,0,13,12,24535800,3589,112440,16,6849
850,13,0,16,9,24564900,3588,112440,16,6862
851,11,0,15,10,24606240,3587,112440,16,6873
852,6,0,10,15,24643980,3587,112440,16,6879
853,10,0,15,10,24655320,3586,112440,16,6889
854,10,0,16,9,24680100,3585,112440,16,6899
855,14,0,18,7,24726000,3586,112440,16,6913
856,9,0,17,8,24753900,3584,112440,16,6922
857,8,1,15,10,24795300,3586,114540,16,6930
858,13,9,15,10,24825360,3587,115860,16,6943
859,6,6,19,6,24863940,3590,133320,19,6949
860,6,0,16,9,24914100,3590,168180,24,6955
861,4,0,10,15,24965700,3592,168180,24,6959
862,5,0,11,14,24981840,3592,168180,24,6964
863,6,0,8,17,25011000,3592,168180,24,6970
864,5,0,11,14,25015140,3592,168180,24,6975
865,4,0,9,16,25040460,3592,168180,24,6979
866,2,0,7,18,25047600,3591,168180,24,6981
867,8,0,14,11,25050960,3591,168180,24,6989
868,8,0,12,13,25088220,3591,168180,24,6997
869,8,0,14,11,25113600,3592,168180,24,7005
870,8,0,16,9,25132560,3591,168180,23,7013
871,9,0,14,11,25170960,3591,168180,23,7022
872,12,0,18,7,25198800,3591,168180,23,7034
873,8,0,14,11,25246800,3592,169680,24,7042
874,17,10,14,11,25278600,3593,171720,24,7059
875,7,7,18,7,25324200,3596,191040,27,7066
876,8,0,18,7,25362960,3594,224700,31,7074
877,10,0,16,9,25419600,3596,224700,31,7084
878,13,0,20,5,25456980,3597,224700,31,7097
879,8,0,16,9,25506120,3597,224700,31,7105
880,10,0,14,11,25564440,3600,224700,31,7115
881,10,0,17,8,25591980,3600,224700,31,7125
882,10,0,17,8,25615980,3598,224700,31,7135
883,11,2,17,8,25662900,3600,230280,32,7146
884,7,0,17,8,25700280,3601,233160,32,7153
885,8,0,10,15,25756920,3601,233160,32,7161
886,5,0,8,17,25779600,3601,233160,32,7166
887,5,0,12,13,25780980,3601,233160,32,7171
888,4,0,10,15,25799100,3600,233160,32,7175
889,3,0,9,16,25815960,3601,233160,32,7178
890,3,0,8,17,25831080,3601,233160,32,7181
891,6,0,9,16,25853100,3601,233160,32,7187
892,4,0,8,17,25863240,3600,233160,32,7191
893,4,0,10,15,25870380,3600,233160,32,7195
894,5,0,8,17,25890480,3599,233160,32,7200
895,8,0,12,13,25902720,3599,233160,32,7208
896,6,0,11,14,25931040,3600,233160,32,7214
897,4,0,9,16,25946460,3599,233160,32,7218
898,7,0,13,12,25966080,3600,233160,32,7225
899,12,0,17,8,25982700,3598,233160,32,7237
900,8,0,11,14,26041620,3599,233160,32,7245
901,12,0,15,10,26056260,3597,233160,32,7257
902,7,0,11,14,26088420,3596,233160,32,7264
903,9,0,11,14,26120940,3596,233160,32,7273
904,8,0,13,12,26133900,3595,233160,32,7281
905,8,0,14,11,26160300,3595,233160,31,7289
906,10,0,17,8,26182020,3595,233160,31,7299
907,5,0,12,13,26224680,3596,233160,31,7304
908,7,0,11,14,26258340,3597,233160,31,7311
909,7,0,11,14,26282280,3596,233160,31,7318
910,6,0,11,14,26300880,3596,233160,31,7324
911,6,0,12,13,26311560,3595,233160,31,7330
912,4,0,11,14,26333460,3595,233160,31,7334
913,3,0,10,15,26360340,3597,233160,31,7337
914,2,0,10,15,26372100,3598,233160,31,7339
915,2,0,9,16,26384820,3598,233160,31,7341
916,7,0,11,14,26407020,3599,233160,31,7348
917,9,0,17,8,26414340,3598,233160,31,7357
918,5,0,11,14,26462220,3599,233160,31,7362
919,4,0,8,17,26486100,3599,233160,31,7366
920,14,0,17,8,26507340,3600,233160,31,7380
921,4,0,9,16,26549340,3599,233160,31,7384
922,10,0,11,14,26572560,3599,233160,31,7394
923,14,0,22,3,26577180,3598,233160,31,7408
924,19,1,25,0,26627520,3597,233280,31,7427
925,8,0,21,4,26688960,3599,233940,31,7435
926,15,0,18,7,26753820,3599,234060,31,7450
927,12,0,20,5,26813460,3602,234060,31,7462
928,5,0,12,13,26863740,3603,234060,31,7467
929,7,0,9,16,26904840,3604,234060,31,7474
930,10,0,11,14,26914740,3601,234060,31,7484
931,6,0,12,13,26937720,3602,234060,31,7490
932,3,0,11,14,26955360,3602,234060,31,7493
933,5,0,9,16,26997720,3604,234060,31,7498
934,8,0,12,13,27018300,3605,234060,31,7506
935,4,0,10,15,27037680,3605,234060,31,7510
936,4,0,10,15,27050760,3604,234060,31,7514
937,2,0,8,17,27077520,3606,234060,31,7516
938,12,0,15,10,27090600,3605,234060,31,7528
939,6,0,12,13,27111000,3604,234060,31,7534
940,6,0,13,12,27143160,3606,234060,31,7540
941,5,0,10,15,27179460,3607,234060,31,7545
942,7,0,10,15,27201660,3606,234060,30,7552
943,9,0,12,13,27222600,3606,234060,30,7561
944,8,0,14,11,27244560,3606,234060,30,7569
945,5,0,15,10,27267480,3607,234060,30,7574
946,10,0,14,11,27307020,3607,234060,30,7584
947,10,0,9,16,27349980,3605,234060,30,7594
948,8,0,13,12,27355920,3604,234060,30,7602
949,13,0,17,8,27396720,3605,234060,30,7615
950,10,0,15,10,27429720,3604,234060,30,7625
951,3,0,9,16,27470400,3605,234060,30,7628
952,3,0,7,18,27494400,3606,234060,30,7631
953,15,0,17,8,27509460,3605,234060,30,7646
954,10,6,13,12,27538680,3605,234240,30,7656
955,7,1,19,6,27581700,3608,253800,33,7663
956,4,0,12,13,27620340,3608,259080,33,7667
957,7,0,12,13,27664680,3610,259080,33,7674
958,4,0,12,13,27680700,3610,259080,33,7678
959,8,0,10,15,27712860,3610,259080,33,7686
960,7,0,14,11,27727380,3610,259080,33,7693
961,4,0,10,15,27761400,3611,259080,33,7697
962,6,0,13,12,27779280,3612,259080,33,7703
963,5,0,12,13,27796860,3611,259080,33,7708
964,15,0,20,5,27826140,3612,259140,33,7723
965,6,0,15,10,27872340,3613,264240,34,7729
966,5,0,13,12,27909480,3614,264240,34,7734
967,13,0,15,10,27956820,3615,264240,34,7747
968,10,0,15,10,27982800,3614,264240,34,7757
969,5,0,10,15,28012020,3613,264240,34,7762
970,9,0,13,12,28036140,3613,264240,34,7771
971,12,0,15,10,28061460,3612,264240,33,7783
972,9,0,15,10,28095300,3612,264240,33,7792
973,12,0,18,7,28133700,3613,264240,33,7804
974,11,0,14,11,28176240,3611,264240,33,7815
975,7,0,13,12,28199220,3611,264240,33,7822
976,15,0,16,9,28229760,3609,264240,33,7837
977,10,0,17,8,28253640,3608,264240,33,7847
978,8,0,14,11,28294560,3608,264240,33,7855
979,5,0,10,15,28335480,3609,264240,33,7860
980,8,0,12,13,28359540,3609,264240,33,7868
981,8,0,16,9,28371360,3609,264240,33,7876
982,4,0,12,13,28400340,3609,264240,33,7880
983,5,0,8,17,28436220,3610,264240,33,7885
984,3,0,9,16,28439220,3609,264240,33,7888
985,8,0,11,14,28459200,3609,264240,33,7896
986,8,0,14,11,28480020,3609,264240,33,7904
987,6,0,10,15,28517040,3609,264240,33,7910
988,5,0,10,15,28536960,3609,264240,33,7915
989,8,0,11,14,28558980,3609,264240,33,7923
990,7,0,13,12,28574580,3609,264240,33,7930
991,10,0,17,8,28599000,3609,264240,33,7940
992,5,0,8,17,28638120,3608,264240,33,7945
993,11,0,16,9,28647720,3608,264240,33,7956
994,6,0,12,13,28678920,3607,264240,33,7962
995,10,0,12,13,28716960,3607,264240,33,7972
996,8,0,13,12,28735620,3606,264240,33,7980
997,14,0,17,8,28764240,3605,264240,33,7994
998,8,0,19,6,28790700,3606,264240,33,8002
999,11,0,14,11,28853400,3607,264240,32,8013
1000,13,0,16,9,28892400,3607,264240,32,8026
1001,12,0,19,6,28915440,3605,264240,32,8038
1002,7,0,14,11,28971360,3607,264240,32,8045
1003,8,0,11,14,29011500,3607,264240,32,8053
1004,5,0,10,15,29038980,3608,264240,32,8058
1005,9,0,11,14,29063760,3607,264240,32,8067
1006,7,0,14,11,29079660,3607,264240,32,8074
1007,5,0,11,14,29104620,3607,264240,32,8079
1008,6,0,9,16,29141280,3608,264240,32,8085
1009,3,0,9,16,29149860,3608,264240,32,8088
1010,4,0,8,17,29167860,3608,264240,32,8092
1011,10,0,15,10,29172840,3607,264240,32,8102
1012,7,0,16,9,29199540,3607,264240,32,8109
1013,4,0,10,15,29252520,3610,264240,32,8113
1014,16,0,16,9,29266800,3607,264240,32,8129
1015,13,0,16,9,29308860,3606,264240,32,8142
1016,9,0,11,14,29354640,3606,264240,32,8151
1017,10,0,15,10,29375520,3606,264240,32,8161
1018,12,0,18,7,29404080,3605,264240,32,8173
1019,9,0,17,8,29453640,3607,264240,32,8182
1020,10,0,16,9,29495160,3607,264240,32,8192
1021,16,0,17,8,29562000,3609,264240,32,8208
1022,9,0,17,8,29587320,3608,264240,32,8217
1023,13,0,17,8,29649540,3610,264240,32,8230
1024,4,0,13,12,29676060,3609,264240,32,8234
1025,6,0,10,15,29710260,3609,264240,32,8240
1026,8,0,13,12,29732640,3610,264240,32,8248
1027,11,0,19,6,29750400,3610,264240,31,8259
1028,5,0,13,12,29790840,3610,264240,31,8264
1029,9,0,11,14,29844480,3612,264240,31,8273
1030,9,0,12,13,29873280,3612,264240,31,8282
1031,5,0,10,15,29895240,3611,264240,31,8287
1032,3,0,10,15,29914020,3612,264240,31,8290
1033,7,0,10,15,29932620,3611,264240,31,8297
1034,6,0,10,15,29951640,3611,264240,31,8303
1035,7,0,11,14,29978040,3612,264240,31,8310
1036,8,0,10,15,30001140,3611,264240,31,8318
1037,7,0,7,18,30031980,3610,264240,31,8325
1038,7,0,11,14,30035280,3609,264240,31,8332
1039,6,0,11,14,30051060,3608,264240,31,8338
1040,5,0,8,17,30077820,3608,264240,31,8343
1041,9,0,12,13,30093960,3608,264240,31,8352
1042,13,0,17,8,30116760,3607,264240,31,8365
1043,10,0,16,9,30149640,3606,264240,31,8375
1044,13,0,18,7,30189180,3606,264240,31,8388
1045,11,0,18,7,30233760,3607,264240,31,8399
1046,12,0,13,12,30300120,3608,264240,31,8411
1047,10,0,16,9,30321000,3607,264240,31,8421
1048,10,0,15,10,30360420,3607,264240,31,8431
1049,10,0,15,10,30393420,3607,264240,31,8441
1050,6,0,13,12,30424020,3607,264240,31,8447
1051,5,0,11,14,30457080,3608,264240,31,8452
1052,10,0,15,10,30470400,3607,264240,31,8462
1053,11,0,14,11,30497040,3605,264240,31,8473
1054,1,0,6,19,30543720,3606,264240,31,8474
1055,3,0,8,17,30550080,3607,264240,31,8477
1056,5,0,11,14,30553560,3606,264240,31,8482
1057,6,0,13,12,30565200,3606,264240,31,8488
1058,4,0,6,19,30607620,3606,264240,31,8492
1059,5,0,10,15,30608160,3606,264240,31,8497
1060,6,0,11,14,30622680,3606,264240,31,8503
1061,7,0,11,14,30648660,3606,264240,31,8510
1062,7,0,14,11,30658020,3605,264240,31,8517
1063,5,0,9,16,30696300,3605,264240,31,8522
1064,8,0,13,12,30711120,3605,264240,30,8530
1065,9,0,17,8,30732120,3606,264240,30,8539
1066,5,0,9,16,30779880,3606,264240,30,8544
1067,14,0,15,10,30803100,3605,264240,30,8558
1068,10,0,14,11,30843420,3605,264240,30,8568
1069,14,0,15,10,30873840,3603,264240,30,8582
1070,15,0,19,6,30912120,3603,264240,30,8597
1071,9,2,19,6,30939600,3603,264600,30,8606
1072,15,6,23,2,30979800,3605,273180,31,8621
1073,13,1,25,0,31046460,3606,287100,33,8634
1074,4,0,14,11,31121580,3608,287220,33,8638
1075,11,0,13,12,31174920,3609,287220,33,8649
1076,7,0,12,13,31198740,3609,287220,33,8656
1077,7,0,12,13,31215840,3608,287220,33,8663
1078,7,0,11,14,31238040,3607,287220,33,8670
1079,4,0,8,17,31271460,3608,287220,33,8674
1080,8,0,11,14,31286280,3608,287220,33,8682
1081,7,0,13,12,31296960,3607,287220,33,8689
1082,1,0,6,19,31324500,3607,287220,33,8690
1083,8,0,12,13,31328760,3606,287220,33,8698
1084,6,0,10,15,31350300,3605,287220,32,8704
1085,8,0,16,9,31359000,3606,287220,32,8712
1086,9,0,16,9,31396740,3606,287220,32,8721
1087,9,0,14,11,31442340,3607,287220,32,8730
1088,9,0,17,8,31459320,3606,287220,32,8739
1089,11,0,13,12,31518060,3607,287220,32,8750
1090,4,0,10,15,31544700,3607,287220,32,8754
1091,8,0,12,13,31574700,3608,287220,32,8762
1092,12,0,19,6,31584240,3607,287220,32,8774
1093,9,0,14,11,31629000,3606,287220,32,8783
1094,7,0,12,13,31676280,3608,287220,32,8790
1095,9,0,15,10,31699440,3608,287220,32,8799
1096,8,0,13,12,31729680,3608,287220,32,8807
1097,10,0,14,11,31757760,3607,287220,32,8817
1098,2,0,9,16,31791480,3608,287220,32,8819
1099,6,0,11,14,31806360,3608,287220,32,8825
1100,6,0,10,15,31832160,3608,287220,32,8831
1101,3,0,9,16,31851300,3609,287220,32,8834
1102,7,0,10,15,31863180,3608,287220,32,8841
1103,2,0,8,17,31887720,3609,287220,32,8843
1104,7,0,12,13,31899960,3609,287220,32,8850
1105,3,0,9,16,31915140,3608,287220,32,8853
1106,4,0,8,17,31941120,3609,287220,32,8857
1107,4,0,10,15,31950000,3609,287220,32,8861
1108,8,0,14,11,31959840,3609,287220,32,8869
1109,4,0,12,13,31980480,3609,287220,32,8873
1110,10,0,13,12,32016360,3609,287220,32,8883
1111,12,0,14,11,32060220,3609,287220,32,8895
1112,12,0,17,8,32085240,3609,287220,32,8907
1113,13,0,17,8,32126520,3608,287220,32,8920
1114,11,0,15,10,32172300,3608,287520,32,8931
1115,5,0,12,13,32202900,3608,287760,32,8936
1116,7,0,12,13,32239260,3609,287760,32,8943
1117,14,0,17,8,32269860,3609,287760,32,8957
1118,10,0,14,11,32299800,3607,287760,32,8967
1119,16,5,16,9,32332260,3607,289080,32,8983
1120,4,8,12,13,32355300,3608,291000,32,8987
1121,12,15,13,12,32388000,3610,301860,33,8999
1122,14,25,13,12,32417280,3611,311640,34,9013
1123,4,24,13,12,32460660,3614,339360,37,9017
1124,10,20,23,2,32483580,3615,446400,49,9027
1125,4,0,20,5,32548020,3612,648180,71,9031
1126,6,0,12,13,32603220,3612,648180,71,9037
1127,6,0,15,10,32613540,3612,648180,71,9043
1128,3,0,10,15,32657160,3614,648180,71,9046
1129,3,0,9,16,32674080,3614,648180,71,9049
1130,5,0,10,15,32688360,3614,648180,71,9054
1131,5,0,10,15,32709960,3614,648180,71,9059
1132,6,0,9,16,32727060,3613,648180,71,9065
1133,3,0,8,17,32738820,3613,648180,71,9068
1134,8,0,10,15,32757360,3613,648180,71,9076
1135,6,0,11,14,32772240,3612,648180,71,9082
1136,6,0,9,16,32801400,3612,648180,71,9088
1137,11,0,13,12,32814660,3611,648180,71,9099
1138,1,0,8,17,32833020,3611,648180,71,9100
1139,15,0,12,13,32853060,3609,648180,71,9115
1140,10,0,15,10,32868720,3607,648180,71,9125
1141,8,0,13,12,32904480,3607,648180,70,9133
1142,10,0,14,11,32947920,3609,648180,70,9143
1143,9,0,17,8,32961180,3608,648180,70,9152
1144,11,0,18,7,33005400,3609,648360,70,9163
1145,12,0,17,8,33052680,3609,648360,70,9175
1146,6,0,17,8,33088260,3610,649500,70,9181
1147,6,0,16,9,33121920,3611,649500,70,9187
1148,6,0,13,12,33169440,3613,649500,70,9193
1149,4,0,11,14,33195420,3613,649500,70,9197
1150,6,0,12,13,33220920,3614,649500,70,9203
1151,7,0,12,13,33246720,3614,649500,70,9210
1152,7,0,11,14,33267840,3613,649500,70,9217
1153,5,0,11,14,33286320,3613,649500,70,9222
1154,7,0,11,14,33305760,3613,649500,70,9229
1155,6,0,9,16,33335760,3613,649500,70,9235
1156,4,0,8,17,33350340,3612,649500,70,9239
1157,8,0,11,14,33360480,3612,649500,70,9247
1158,3,0,10,15,33382380,3612,649500,70,9250
1159,9,0,16,9,33397320,3613,649500,70,9259
1160,17,0,21,4,33438240,3612,649500,70,9276
1161,3,0,8,17,33515640,3615,649500,69,9279
1162,7,0,11,14,33529680,3615,649500,69,9286
1163,6,0,13,12,33542640,3614,649500,69,9292
1164,12,0,16,9,33574980,3614,649500,69,9304
1165,13,0,13,12,33616620,3613,649500,69,9317
1166,9,0,10,15,33645420,3611,649500,69,9326
1167,10,0,12,13,33683100,3612,649500,69,9336
1168,9,0,16,9,33698580,3612,649500,69,9345
1169,16,0,16,9,33742440,3610,649500,69,9361
1170,8,0,13,12,33778440,3610,649500,69,9369
1171,1,0,6,19,33812340,3610,649500,69,9370
1172,7,0,8,17,33824340,3610,649500,69,9377
1173,3,0,11,14,33824340,3610,649500,69,9380
1174,5,0,11,14,33848700,3610,649500,69,9385
1175,11,0,15,10,33873360,3610,649500,69,9396
1176,7,0,11,14,33913080,3610,649500,69,9403
1177,6,0,11,14,33935760,3610,649500,69,9409
1178,4,0,9,16,33964440,3611,649500,69,9413
1179,7,0,12,13,33976020,3611,649500,68,9420
1180,5,0,12,13,33990180,3610,649500,68,9425
1181,4,0,9,16,34019340,3611,649500,68,9429
1182,6,0,11,14,34033860,3611,649500,68,9435
1183,13,0,17,8,34046460,3610,649500,68,9448
1184,6,0,16,9,34079220,3610,649500,68,9454
1185,7,0,15,10,34109640,3611,649500,68,9461
1186,10,0,15,10,34162980,3612,649500,68,9471
1187,13,0,16,9,34197540,3611,649500,68,9484
1188,7,0,16,9,34231500,3612,649500,68,9491
1189,18,0,23,2,34283220,3614,649500,68,9509
1190,10,0,15,10,34346400,3613,649680,68,9519
1191,14,0,21,4,34391220,3615,649680,68,9533
1192,12,0,17,8,34444200,3615,649680,68,9545
1193,11,0,14,11,34504620,3616,649680,67,9556
1194,10,0,13,12,34541340,3615,649680,67,9566
1195,9,0,10,15,34575780,3614,649680,67,9575
1196,8,0,11,14,34600980,3614,649680,67,9583
1197,5,0,10,15,34613580,3613,649680,67,9588
1198,6,0,11,14,34620540,3612,649680,67,9594
1199,6,0,12,13,34644060,3613,649680,67,9600
1200,11,0,18,7,34662540,3613,649680,67,9611
1201,4,0,14,11,34693380,3613,649680,67,9615
1202,7,0,13,12,34731600,3614,649680,67,9622
1203,2,0,8,17,34769280,3615,649680,67,9624
1204,3,0,7,18,34779240,3615,649680,67,9627
1205,6,0,10,15,34795800,3615,649680,67,9633
1206,8,0,12,13,34809300,3615,649680,67,9641
1207,6,0,10,15,34827420,3613,649680,67,9647
1208,9,0,15,10,34852020,3614,649680,67,9656
1209,8,0,11,14,34889700,3614,649680,67,9664
1210,14,0,16,9,34920840,3614,649680,67,9678
1211,12,2,17,8,34941660,3613,649740,67,9690
1212,11,10,13,12,34975200,3613,651840,67,9701
1213,9,12,16,9,35014800,3616,671280,69,9710
1214,7,7,23,2,35049720,3618,712440,73,9717
1215,17,1,25,0,35129340,3618,767340,78,9734
1216,8,0,16,9,35186460,3617,767340,78,9742
1217,14,0,16,9,35250900,3619,767340,78,9756
1218,6,0,11,14,35279580,3618,767340,78,9762
1219,6,0,12,13,35294100,3617,767340,78,9768
1220,5,0,12,13,35306460,3617,767340,78,9773
1221,4,0,7,18,35348400,3618,767340,78,9777
1222,10,0,13,12,35354160,3617,767340,78,9787
1223,3,0,9,16,35379000,3617,767340,78,9790
1224,3,0,8,17,35391900,3616,767340,78,9793
1225,5,0,10,15,35401860,3616,767340,78,9798
1226,3,0,7,18,35427120,3617,767340,78,9801
1227,4,0,8,17,35430300,3616,767340,78,9805
1228,7,0,11,14,35443620,3616,767340,78,9812
1229,5,0,9,16,35456940,3615,767340,78,9817
1230,7,0,12,13,35476800,3615,767340,78,9824
1231,9,0,15,10,35491260,3614,767340,78,9833
1232,8,0,12,13,35534520,3615,767340,77,9841
1233,9,0,18,7,35553960,3616,767340,77,9850
1234,7,0,13,12,35602260,3616,767340,77,9857
1235,11,0,12,13,35636340,3615,767340,77,9868
1236,10,0,17,8,35658240,3616,767340,77,9878
1237,8,0,16,9,35684220,3615,767340,77,9886
1238,9,0,16,9,35738400,3617,767340,77,9895
1239,16,0,18,7,35785980,3617,767340,77,9911
1240,7,3,14,11,35812860,3617,769560,77,9918
1241,6,0,15,10,35849040,3617,774900,78,9924
1242,13,0,14,11,35911080,3618,774900,77,9937
1243,5,0,11,14,35935380,3618,774900,77,9942
1244,5,0,8,17,35961900,3618,774900,77,9947
1245,12,0,14,11,35980620,3617,774900,77,9959
1246,12,0,17,8,36000780,3616,774900,77,9971
1247,6,0,16,9,36022500,3616,774900,77,9977
1248,7,0,12,13,36067620,3616,774900,77,9984
1249,1,0,7,18,36098640,3617,774900,77,9985
1250,6,0,9,16,36105780,3617,774900,77,9991
1251,8,0,12,13,36125460,3617,774900,77,9999
1252,6,0,9,16,36150480,3616,774900,77,10005
1253,8,0,12,13,36159600,3615,774900,77,10013
1254,3,0,11,14,36174060,3615,774900,77,10016
1255,6,0,10,15,36213960,3617,774900,77,10022
1256,4,0,8,17,36226500,3616,774900,77,10026
1257,14,0,14,11,36246780,3615,774900,77,10040
1258,14,0,21,4,36261780,3614,774900,77,10054
1259,17,2,18,7,36332580,3614,776220,77,10071
1260,6,4,15,10,36363660,3615,782220,77,10077
1261,17,6,22,3,36412680,3617,792300,78,10094
1262,12,14,16,9,36454980,3618,804180,79,10106
1263,6,10,20,5,36493560,3619,841500,83,10112
1264,8,0,11,14,36565140,3617,908880,89,10120
1265,12,0,13,12,36587820,3615,908880,89,10132
1266,11,0,17,8,36618000,3616,908880,89,10143
1267,11,0,20,5,36651780,3616,908880,89,10154
1268,4,0,11,14,36702840,3617,908880,89,10158
1269,7,0,12,13,36728340,3617,908880,89,10165
1270,4,0,12,13,36745680,3617,908880,89,10169
1271,8,0,14,11,36779220,3618,908880,89,10177
1272,5,0,12,13,36810180,3619,908880,89,10182
1273,4,0,11,14,36830400,3619,908880,89,10186
1274,7,0,12,13,36848100,3619,908880,89,10193
1275,7,0,13,12,36872640,3619,908880,89,10200
1276,8,0,11,14,36901680,3618,908880,89,10208
1277,6,0,13,12,36921840,3619,908880,88,10214
1278,5,0,11,14,36947220,3619,908880,88,10219
1279,15,0,16,9,36976740,3618,908880,88,10234
1280,2,0,9,16,37009920,3618,908880,88,10236
1281,12,0,15,10,37033200,3618,908880,88,10248
1282,12,0,19,6,37056120,3618,908880,88,10260
1283,11,0,21,4,37092120,3618,908880,88,10271
1284,11,0,19,6,37153500,3620,908880,88,10282
1285,14,0,22,3,37189680,3619,908880,88,10296
1286,11,0,18,7,37265040,3621,908880,88,10307
1287,7,0,10,15,37325340,3622,908880,88,10314
1288,13,0,17,8,37348500,3622,908880,88,10327
1289,4,0,17,8,37362960,3622,908880,87,10331
1290,11,0,13,12,37430760,3623,908880,87,10342
1291,2,0,7,18,37455780,3623,908880,87,10344
1292,9,0,12,13,37459440,3622,908880,87,10353
1293,7,0,12,13,37476540,3621,908880,87,10360
1294,8,0,11,14,37512300,3621,908880,87,10368
1295,5,0,10,15,37529700,3621,908880,87,10373
1296,8,0,12,13,37555080,3621,908880,87,10381
1297,5,0,11,14,37567500,3620,908880,87,10386
1298,9,0,16,9,37597560,3622,908880,87,10395
1299,4,0,11,14,37630740,3622,908880,87,10399
1300,7,0,12,13,37658100,3623,908880,87,10406
1301,5,0,11,14,37684500,3623,908880,87,10411
1302,6,0,11,14,37700160,3622,908880,87,10417
1303,11,0,16,9,37717800,3622,908880,87,10428
1304,21,0,24,1,37761780,3622,908880,86,10449
1305,7,0,18,7,37808700,3622,908880,86,10456
1306,9,0,14,11,37874640,3624,908880,86,10465
1307,10,0,14,11,37913340,3624,908880,86,10475
1308,8,0,15,10,37936080,3624,908880,86,10483
1309,10,0,12,13,37984560,3624,908880,86,10493
1310,7,0,13,12,38000820,3623,908880,86,10500
1311,12,0,19,6,38026320,3623,908880,86,10512
1312,15,0,19,6,38078760,3623,908880,86,10527
1313,10,0,16,9,38128440,3624,908880,86,10537
1314,6,0,12,13,38162580,3623,909780,86,10543
1315,7,0,14,11,38191500,3624,909780,86,10550
1316,2,0,7,18,38233740,3625,909780,86,10552
1317,5,0,7,18,38247120,3625,909780,86,10557
1318,5,0,10,15,38250780,3624,909780,86,10562
1319,4,0,12,13,38257920,3624,909780,86,10566
1320,6,0,13,12,38277900,3625,909780,86,10572
1321,8,0,14,11,38300820,3624,909780,85,10580
1322,5,0,8,17,38347080,3625,909780,85,10585
1323,7,0,10,15,38364720,3625,909780,85,10592
1324,1,0,8,17,38371200,3625,909780,85,10593
1325,6,0,12,13,38381400,3625,909780,85,10599
1326,6,0,16,9,38388120,3625,909780,85,10605
1327,9,0,14,11,38424000,3624,909780,85,10614
1328,8,0,10,15,38458140,3624,909780,85,10622
1329,5,0,10,15,38483520,3624,909780,85,10627
1330,7,0,12,13,38503680,3624,909780,85,10634
1331,8,0,11,14,38527440,3624,909780,85,10642
1332,14,0,17,8,38549700,3623,909780,85,10656
1333,10,1,17,8,38571120,3622,909780,85,10666
1334,14,4,16,9,38633280,3624,916320,85,10680
1335,10,0,15,10,38680320,3623,927960,86,10690
1336,10,0,12,13,38733600,3624,927960,86,10700
1337,16,0,20,5,38754480,3623,927960,86,10716
1338,11,2,18,7,38793120,3623,928020,86,10727
1339,10,0,21,4,38836980,3624,931920,86,10737
1340,4,0,10,15,38902140,3625,931920,86,10741
1341,5,0,10,15,38924700,3625,931920,86,10746
1342,4,0,10,15,38936820,3625,931920,86,10750
1343,1,0,8,17,38947320,3625,931920,86,10751
1344,7,0,11,14,38962560,3625,931920,86,10758
1345,7,0,14,11,38965920,3624,931920,86,10765
1346,13,0,18,7,38980980,3622,931920,86,10778
1347,7,0,15,10,39010200,3622,931920,86,10785
1348,12,6,17,8,39022260,3621,932100,86,10797
1349,5,9,15,10,39045660,3622,937020,86,10802
1350,6,6,21,4,39063000,3623,965160,89,10808
1351,7,0,15,10,39106680,3620,996420,92,10815
1352,5,0,14,11,39131880,3621,996420,92,10820
1353,12,0,20,5,39142920,3620,996420,91,10832
1354,9,0,23,2,39169980,3620,997560,92,10841
1355,11,4,16,9,39216780,3620,997680,91,10852
1356,10,11,16,9,39232680,3620,1000620,92,10862
1357,4,9,19,6,39253920,3621,1011780,93,10866
1358,11,9,25,0,39282720,3622,1056180,97,10877
1359,13,0,21,4,39353700,3620,1101060,101,10890
1360,6,0,18,7,39383700,3620,1101060,101,10896
1361,6,0,17,8,39415320,3621,1101060,100,10902
1362,8,0,14,11,39447000,3620,1101060,100,10910
1363,12,0,20,5,39462240,3619,1101060,100,10922
1364,10,0,23,2,39491700,3620,1101060,100,10932
1365,4,0,21,4,39521460,3620,1101060,100,10936
1366,5,0,18,7,39553560,3621,1101060,100,10941
1367,6,0,16,9,39602760,3622,1101060,100,10947
1368,5,0,15,10,39629340,3623,1101060,100,10952
1369,9,0,18,7,39645600,3622,1101060,100,10961
1370,4,0,16,9,39666720,3622,1101060,100,10965
1371,2,0,14,11,39691380,3623,1101060,100,10967
1372,9,0,19,6,39708300,3624,1101060,100,10976
1373,4,0,15,10,39728280,3623,1101060,100,10980
1374,7,0,16,9,39751920,3623,1101060,100,10987
1375,9,0,20,5,39769740,3623,1101060,100,10996
1376,7,0,17,8,39807180,3623,1101060,100,11003
1377,11,0,20,5,39844740,3624,1101060,99,11014
1378,4,0,16,9,39870780,3623,1101060,99,11018
1379,11,0,19,6,39890820,3623,1101060,99,11029
1380,11,0,22,3,39910800,3622,1101060,99,11040
1381,13,0,18,7,39972960,3622,1101060,99,11053
1382,9,0,20,5,40003920,3622,1101060,99,11062
1383,4,0,14,11,40041600,3623,1101060,99,11066
1384,10,0,18,7,40059660,3622,1101060,99,11076
1385,5,0,14,11,40084920,3622,1101060,99,11081
1386,10,0,18,7,40107720,3622,1101060,99,11091
1387,10,0,18,7,40132620,3621,1101060,99,11101
1388,9,0,20,5,40162380,3621,1101060,99,11110
1389,5,0,20,5,40171380,3620,1101060,99,11115
1390,4,0,14,11,40229820,3622,1101060,99,11119
1391,11,1,19,6,40242360,3622,1101060,98,11130
1392,7,6,16,9,40267080,3622,1104180,99,11137
1393,6,10,13,12,40305060,3624,1110960,99,11143
1394,9,18,14,11,40305060,3624,1115340,100,11152
1395,11,28,14,11,40311120,3624,1121100,100,11163
1396,7,29,17,8,40344780,3626,1157040,103,11170
1397,8,25,25,0,40362000,3627,1232160,110,11178
1398,6,19,25,0,40420560,3628,1349760,120,11184
1399,6,5,25,0,40475880,3626,1520160,135,11190
1400,8,0,17,8,40509480,3623,1621620,144,11198
1401,14,4,20,5,40537980,3623,1622700,144,11212
1402,11,14,19,6,40551120,3623,1624920,144,11223
1403,16,26,17,8,40597140,3626,1636500,145,11239
1404,9,29,17,8,40631460,3627,1661520,147,11248
1405,13,40,17,8,40637700,3627,1664100,147,11261
1406,14,39,25,0,40668300,3628,1734960,153,11275
1407,18,37,25,0,40723380,3630,1790520,158,11293
1408,6,29,25,0,40774260,3630,1929600,170,11299
1409,20,31,21,4,40831740,3628,2030880,179,11319
1410,8,38,18,7,40858260,3629,2034240,179,11327
1411,7,34,21,4,40909440,3631,2060460,182,11334
1412,3,23,24,1,40939080,3630,2223600,196,11337
1413,5,0,13,12,41003820,3623,2854500,251,11342
1414,2,0,11,14,41025540,3624,2854500,251,11344
1415,9,0,16,9,41032860,3623,2854500,251,11353
1416,6,0,17,8,41044140,3623,2854500,251,11359
1417,4,0,17,8,41062380,3623,2854500,251,11363
1418,5,0,15,10,41089080,3623,2854500,251,11368
1419,6,0,14,11,41115720,3623,2854500,251,11374
1420,9,0,14,11,41127720,3621,2854500,251,11383
1421,2,0,13,12,41144040,3622,2854500,251,11385
1422,7,0,16,9,41158260,3622,2854500,250,11392
1423,8,0,13,12,41187480,3621,2854500,250,11400
1424,5,0,17,8,41190840,3621,2854500,250,11405
1425,9,0,20,5,41213640,3621,2854500,250,11414
1426,7,0,18,7,41239440,3620,2854500,250,11421
1427,14,0,23,2,41277960,3621,2854500,249,11435
1428,15,0,24,1,41316000,3620,2854500,249,11450
1429,7,0,19,6,41365200,3620,2855520,249,11457
1430,7,0,17,8,41413140,3622,2855520,249,11464
1431,12,0,17,8,41442180,3620,2855520,249,11476
1432,10,0,18,7,41474280,3620,2855520,248,11486
1433,11,0,20,5,41505060,3620,2855520,248,11497
1434,7,0,16,9,41533440,3619,2855520,248,11504
1435,5,0,13,12,41556900,3619,2855520,248,11509
1436,7,0,16,9,41571360,3619,2855520,248,11516
1437,7,0,19,6,41585640,3619,2855520,248,11523
1438,6,0,15,10,41618460,3618,2855520,247,11529
1439,6,0,16,9,41643780,3619,2855520,247,11535
1440,4,0,14,11,41663160,3619,2855520,247,11539
1441,3,0,13,12,41684340,3620,2855520,247,11542
1442,4,0,15,10,41690160,3619,2855520,247,11546
1443,7,0,15,10,41704020,3618,2855520,247,11553
1444,1,0,11,14,41729340,3619,2855520,247,11554
1445,4,0,12,13,41733840,3618,2855520,247,11558
1446,10,0,17,8,41742540,3618,2855520,247,11568
1447,9,0,21,4,41755800,3617,2855520,246,11577
1448,6,2,19,6,41782440,3618,2858280,247,11583
1449,11,0,21,4,41822160,3618,2860140,246,11594
1450,16,0,22,3,41871480,3617,2860140,246,11610
1451,10,0,24,1,41891760,3616,2860140,246,11620
1452,14,1,23,2,41952600,3617,2864340,246,11634
1453,6,4,16,9,41989680,3617,2868840,246,11640
1454,11,5,22,3,42013620,3618,2883480,247,11651
1455,9,0,22,3,42045600,3617,2899620,248,11660
1456,11,5,17,8,42083700,3616,2900520,248,11671
1457,10,2,24,1,42118080,3618,2914740,249,11681
1458,11,0,20,5,42173100,3617,2929560,250,11692
1459,8,0,20,5,42198180,3617,2929560,250,11700
1460,4,0,18,7,42232560,3618,2929560,250,11704
1461,9,0,15,10,42282060,3618,2929560,250,11713
1462,6,0,18,7,42295920,3619,2929560,250,11719
1463,5,0,17,8,42324000,3619,2929560,250,11724
1464,7,0,17,8,42344940,3619,2929560,250,11731
1465,5,0,18,7,42360360,3619,2929560,249,11736
1466,3,0,16,9,42390000,3620,2929560,249,11739
1467,4,0,12,13,42433440,3621,2929560,249,11743
1468,3,0,14,11,42434340,3621,2929560,249,11746
1469,8,0,16,9,42458640,3621,2929560,249,11754
1470,9,1,18,7,42470040,3620,2929560,249,11763
1471,10,7,18,7,42491460,3621,2931720,249,11773
1472,5,1,23,2,42528060,3622,2953860,251,11778
1473,5,0,20,5,42556440,3622,2958120,251,11783
1474,8,0,12,13,42617040,3622,2958120,251,11791
1475,12,0,20,5,42627960,3622,2958120,250,11803
1476,6,0,18,7,42647580,3621,2958120,250,11809
1477,18,3,25,0,42668040,3620,2958420,250,11827
1478,9,0,21,4,42717960,3619,2960940,250,11836
1479,13,1,20,5,42768240,3620,2961540,250,11849
1480,6,0,16,9,42812100,3620,2962440,250,11855
1481,8,0,16,9,42841440,3620,2962440,250,11863
1482,6,0,15,10,42861360,3620,2962440,249,11869
1483,7,0,17,8,42881880,3620,2962440,249,11876
1484,7,0,16,9,42907620,3619,2962440,249,11883
1485,5,0,14,11,42929040,3619,2962440,249,11888
1486,7,0,15,10,42943140,3619,2962440,249,11895
1487,2,0,12,13,42957060,3618,2962440,249,11897
1488,9,0,18,7,42963180,3618,2962440,249,11906
1489,7,0,21,4,42979080,3618,2962440,248,11913
1490,4,0,18,7,43002720,3618,2962440,248,11917
1491,6,0,17,8,43038300,3619,2962440,248,11923
1492,5,0,15,10,43066800,3619,2962440,248,11928
1493,3,0,14,11,43089060,3620,2962440,248,11931
1494,4,0,15,10,43097100,3619,2962440,248,11935
1495,7,0,16,9,43119900,3619,2962440,248,11942
1496,8,0,17,8,43142160,3619,2962440,248,11950
1497,9,0,16,9,43170960,3618,2962440,248,11959
1498,9,0,20,5,43186380,3618,2962440,247,11968
1499,10,0,19,6,43222080,3618,2962440,247,11978
1500,10,0,20,5,43245780,3617,2962440,247,11988
1501,5,0,18,7,43275600,3618,2962440,247,11993
1502,13,0,22,3,43312920,3618,2962440,247,12006
1503,15,0,22,3,43359960,3617,2962440,246,12021
1504,8,0,19,6,43396500,3617,2962440,246,12029
1505,12,0,23,2,43417440,3616,2962440,246,12041
1506,10,0,22,3,43463280,3617,2962440,246,12051
1507,6,1,18,7,43488660,3616,2962440,246,12057
1508,7,3,18,7,43521000,3618,2965920,246,12064
1509,9,0,20,5,43550280,3617,2978820,247,12073
1510,4,0,16,9,43579260,3617,2978820,246,12077
1511,7,0,17,8,43601280,3617,2978820,246,12084
1512,5,0,15,10,43621320,3617,2978820,246,12089
1513,7,0,17,8,43647960,3617,2978820,246,12096
1514,4,0,13,12,43678260,3617,2978820,246,12100
1515,4,0,15,10,43681140,3617,2978820,246,12104
1516,5,0,16,9,43697520,3617,2978820,246,12109
1517,8,0,17,8,43716960,3617,2978820,246,12117
1518,4,0,14,11,43754760,3618,2978820,246,12121
1519,6,0,14,11,43769700,3617,2978820,245,12127
1520,9,0,14,11,43793580,3616,2978820,245,12136
1521,13,0,19,6,43811280,3615,2978820,245,12149
1522,6,0,15,10,43836000,3615,2978820,245,12155
1523,10,0,20,5,43845300,3614,2978820,245,12165
1524,11,0,18,7,43886460,3613,2978820,244,12176
1525,11,0,21,4,43906200,3613,2978820,244,12187
1526,13,0,21,4,43952760,3613,2978820,244,12200
1527,8,0,18,7,43985520,3612,2978820,244,12208
1528,8,0,18,7,44019480,3612,2978820,244,12216
1529,12,0,20,5,44046720,3612,2978820,243,12228
1530,4,0,15,10,44083500,3612,2978820,243,12232
1531,13,0,23,2,44094360,3611,2978820,243,12245
1532,6,0,20,5,44133120,3612,2978820,243,12251
1533,4,0,16,9,44165160,3612,2978820,243,12255
1534,6,0,15,10,44200620,3613,2978820,243,12261
1535,4,0,17,8,44203620,3613,2978820,243,12265
1536,3,0,17,8,44224020,3613,2978820,243,12268
1537,7,0,16,9,44249460,3613,2978820,242,12275
1538,6,0,18,7,44262360,3613,2978820,242,12281
1539,4,0,18,7,44287260,3614,2978820,242,12285
1540,5,0,16,9,44322420,3615,2978820,242,12290
1541,5,0,17,8,44333700,3614,2978820,242,12295
1542,6,0,18,7,44354280,3615,2978820,242,12301
1543,6,0,18,7,44391000,3616,2978820,242,12307
1544,12,0,24,1,44422740,3617,2978820,242,12319
1545,11,0,21,4,44458380,3615,2978820,241,12330
1546,8,0,19,6,44505480,3616,2978820,241,12338
1547,9,0,21,4,44530560,3616,2978820,241,12347
1548,11,0,17,8,44572140,3615,2978820,241,12358
1549,16,0,23,2,44597880,3614,2978820,241,12374
1550,13,0,24,1,44634780,3614,2978820,240,12387
1551,13,0,20,5,44695500,3614,2978820,240,12400
1552,10,0,20,5,44717700,3613,2978820,240,12410
1553,7,0,16,9,44759880,3613,2978820,240,12417
1554,11,0,17,8,44789160,3612,2978820,239,12428
1555,14,0,23,2,44809920,3612,2978820,239,12442
1556,4,0,17,8,44851920,3612,2978820,239,12446
1557,8,0,17,8,44887440,3613,2978820,239,12454
1558,5,0,19,6,44904060,3613,2978820,239,12459
1559,6,0,21,4,44918640,3613,2978820,239,12465
1560,3,0,11,14,44982120,3615,2978820,239,12468
1561,0,0,10,15,44989440,3615,2978820,239,12468
1562,7,0,14,11,44993460,3614,2978820,239,12475
1563,3,0,13,12,45004740,3614,2978820,238,12478
1564,6,0,14,11,45018660,3614,2978820,238,12484
1565,5,0,15,10,45029700,3613,2978820,238,12489
1566,8,0,16,9,45044700,3613,2978820,238,12497
1567,3,0,13,12,45067380,3613,2978820,238,12500
1568,6,0,13,12,45084600,3612,2978820,238,12506
1569,8,0,17,8,45092520,3612,2978820,238,12514
1570,12,0,19,6,45108540,3610,2978820,238,12526
1571,10,0,21,4,45131760,3610,2978820,237,12536
1572,9,0,20,5,45172740,3610,2978820,237,12545
1573,14,1,22,3,45209760,3610,2979360,237,12559
1574,15,15,18,7,45226560,3610,2981820,237,12574
1575,7,15,21,4,45260580,3611,2996340,238,12581
1576,8,12,25,0,45304380,3613,3042000,241,12589
1577,3,0,23,2,45370800,3613,3135360,249,12592
1578,10,0,18,7,45413040,3612,3135360,249,12602
1579,7,0,18,7,45438600,3612,3135360,248,12609
1580,8,0,18,7,45469800,3613,3135360,248,12617
1581,5,0,17,8,45493380,3613,3135360,248,12622
1582,7,0,17,8,45523800,3613,3135360,248,12629
1583,9,0,19,6,45553980,3613,3135360,248,12638
1584,7,0,17,8,45583200,3613,3135360,248,12645
1585,6,0,16,9,45614160,3614,3135360,248,12651
1586,7,0,16,9,45643020,3614,3135360,247,12658
1587,7,0,13,12,45670080,3613,3135360,247,12665
1588,10,0,19,6,45679920,3613,3135360,247,12675
1589,2,0,13,12,45717180,3614,3135360,247,12677
1590,3,0,14,11,45730680,3614,3135360,247,12680
1591,9,0,17,8,45742560,3613,3135360,247,12689
1592,9,2,19,6,45772140,3614,3137640,247,12698
1593,2,0,15,10,45811320,3615,3140820,247,12700
1594,9,0,18,7,45837780,3615,3140820,247,12709
1595,6,0,15,10,45869040,3615,3140820,247,12715
1596,10,0,18,7,45884520,3614,3140820,247,12725
1597,12,0,20,5,45913140,3614,3140820,246,12737
1598,13,0,21,4,45959880,3614,3140820,246,12750
1599,14,12,17,8,45973740,3614,3141540,246,12764
1600,10,17,16,9,46022280,3616,3160560,247,12774
1601,11,26,17,8,46031340,3616,3162660,247,12785
1602,7,24,20,5,46069320,3617,3218940,251,12792
1603,10,27,25,0,46076880,3617,3232200,252,12802
1604,7,18,25,0,46153560,3619,3360420,262,12809
1605,14,18,25,0,46197720,3618,3417000,266,12823
1606,2,0,22,3,46256760,3616,3652620,285,12825
1607,6,0,14,11,46309320,3617,3652620,284,12831
1608,5,0,13,12,46328100,3616,3652620,284,12836
1609,4,0,12,13,46336080,3616,3652620,284,12840
1610,4,0,12,13,46349640,3615,3652620,284,12844
1611,6,0,14,11,46357260,3615,3652620,284,12850
1612,6,0,15,10,46368360,3614,3652620,284,12856
1613,12,0,17,8,46400880,3614,3652620,284,12868
1614,7,0,14,11,46424880,3613,3652620,284,12875
1615,12,0,19,6,46439700,3612,3652620,283,12887
1616,6,0,16,9,46467240,3612,3652620,283,12893
1617,8,0,17,8,46487220,3612,3653340,283,12901
1618,11,0,22,3,46512420,3612,3653580,283,12912
1619,10,0,18,7,46556400,3611,3653580,283,12922
1620,10,0,21,4,46580160,3611,3653580,282,12932
1621,14,0,23,2,46609380,3610,3653580,282,12946
1622,11,1,22,3,46661640,3611,3658320,282,12957
1623,6,0,18,7,46689180,3610,3658980,282,12963
1624,11,0,17,8,46731780,3610,3658980,282,12974
1625,7,1,17,8,46742460,3609,3659220,282,12981
1626,11,7,18,7,46764180,3610,3666660,282,12992
1627,5,1,23,2,46796160,3611,3692160,284,12997
1628,11,0,21,4,46844580,3610,3699120,284,13008
1629,7,0,19,6,46888260,3611,3699120,284,13015
1630,4,0,15,10,46925760,3612,3699120,284,13019
1631,5,0,14,11,46941420,3611,3699120,284,13024
1632,7,0,17,8,46948200,3611,3699120,284,13031
1633,1,0,11,14,46980000,3611,3699120,284,13032
1634,6,0,16,9,46980840,3611,3699120,284,13038
1635,5,0,17,8,46989600,3611,3699120,283,13043
1636,6,0,13,12,47017620,3610,3699120,283,13049
1637,6,0,15,10,47024520,3610,3699120,283,13055
1638,2,0,12,13,47043720,3610,3699120,283,13057
1639,9,0,19,6,47052420,3610,3699120,283,13066
1640,11,0,21,4,47065020,3608,3699120,283,13077
1641,8,0,18,7,47104740,3608,3699120,283,13085
1642,10,4,18,7,47134500,3609,3700740,282,13095
1643,12,14,16,9,47157960,3610,3703620,283,13107
1644,7,11,23,2,47182080,3611,3741000,285,13114
1645,9,4,25,0,47240700,3611,3789960,289,13123
1646,11,0,18,7,47293080,3609,3817680,290,13134
1647,11,0,20,5,47320260,3609,3817680,290,13145
1648,9,1,19,6,47342280,3608,3817740,290,13154
1649,14,3,25,0,47369700,3608,3824280,290,13168
1650,15,2,25,0,47411700,3607,3831000,290,13183
1651,10,0,22,3,47466120,3607,3833160,290,13193
1652,10,0,20,5,47522100,3608,3833160,290,13203
1653,4,0,20,5,47536320,3608,3833160,290,13207
1654,8,0,16,9,47591220,3609,3833160,290,13215
1655,4,0,14,11,47605860,3608,3833160,290,13219
1656,4,0,14,11,47629020,3609,3833160,290,13223
1657,6,0,16,9,47638500,3609,3833160,290,13229
1658,8,0,16,9,47659260,3608,3833160,289,13237
1659,5,0,15,10,47680140,3608,3833160,289,13242
1660,2,0,13,12,47694060,3608,3833160,289,13244
1661,3,0,16,9,47694060,3608,3833160,289,13247
1662,4,0,15,10,47715960,3608,3833160,289,13251
1663,6,0,11,14,47744640,3608,3833160,289,13257
1664,5,0,15,10,47745360,3608,3833160,289,13262
1665,6,0,15,10,47758380,3607,3833160,289,13268
1666,9,0,19,6,47770680,3606,3833160,289,13277
1667,14,1,25,0,47797740,3607,3833400,288,13291
1668,12,9,18,7,47839860,3607,3835380,288,13303
1669,6,12,16,9,47877780,3608,3845520,289,13309
1670,6,6,22,3,47914020,3609,3881160,291,13315
1671,11,0,23,2,47946720,3608,3928200,295,13326
1672,13,0,22,3,48001440,3608,3928260,294,13339
1673,13,7,19,6,48025680,3607,3928320,294,13352
1674,6,3,22,3,48072780,3609,3942060,295,13358
1675,6,0,16,9,48108840,3607,3959520,296,13364
1676,6,1,17,8,48135480,3608,3959520,296,13370
1677,4,2,15,10,48164460,3609,3960840,296,13374
1678,12,12,15,10,48181500,3610,3965580,296,13386
1679,12,11,25,0,48206160,3611,3986280,297,13398
1680,5,8,25,0,48241920,3612,4017420,300,13403
1681,3,0,14,11,48312780,3611,4074960,304,13406
1682,7,0,15,10,48331500,3611,4074960,304,13413
1683,5,0,16,9,48347640,3611,4074960,304,13418
1684,7,0,16,9,48371400,3611,4074960,303,13425
1685,7,0,19,6,48382260,3610,4074960,303,13432
1686,5,0,13,12,48426540,3611,4074960,303,13437
1687,7,0,13,12,48442560,3610,4074960,303,13444
1688,10,0,20,5,48448800,3610,4074960,303,13454
1689,13,1,24,1,48480900,3610,4075980,303,13467
1690,5,1,20,5,48519660,3610,4081920,303,13472
1691,8,0,22,3,48549240,3611,4082880,303,13480
1692,5,0,13,12,48617220,3612,4082880,303,13485
1693,13,0,18,7,48627000,3611,4082880,302,13498
1694,15,0,24,1,48660300,3611,4084260,302,13513
1695,12,0,20,5,48707760,3610,4084260,302,13525
1696,11,0,21,4,48744000,3610,4084560,302,13536
1697,7,0,16,9,48793380,3610,4084560,301,13543
1698,9,0,20,5,48809580,3610,4084560,301,13552
1699,9,0,19,6,48847740,3610,4084560,301,13561
1700,10,0,22,3,48878280,3611,4084560,301,13571
1701,6,0,18,7,48916680,3611,4084560,301,13577
1702,6,0,14,11,48957960,3611,4084560,301,13583
1703,8,0,18,7,48964860,3611,4084560,300,13591
1704,8,0,18,7,48994740,3611,4084560,300,13599
1705,2,0,14,11,49021560,3611,4084560,300,13601
1706,5,0,14,11,49045680,3612,4084560,300,13606
1707,9,0,19,6,49056960,3611,4084560,300,13615
1708,5,0,19,6,49074180,3611,4084560,300,13620
1709,8,5,17,8,49099920,3612,4087980,300,13628
1710,5,4,17,8,49144320,3614,4105200,301,13633
1711,11,5,25,0,49151580,3614,4114200,301,13644
1712,10,4,23,2,49212300,3615,4131540,302,13654
1713,7,0,18,7,49254480,3613,4158900,304,13661
1714,12,0,21,4,49287300,3613,4158900,304,13673
1715,13,0,20,5,49319160,3612,4158900,304,13686
1716,16,0,23,2,49361400,3612,4158960,303,13702
1717,13,11,17,8,49387260,3612,4159320,303,13715
1718,12,18,16,9,49428000,3613,4170840,304,13727
1719,13,24,21,4,49441020,3613,4189920,305,13740
1720,9,30,15,10,49493640,3615,4197480,305,13749
1721,7,35,16,9,49501860,3615,4202100,305,13756
1722,11,40,16,9,49516860,3616,4208280,306,13767
1723,11,40,15,10,49532400,3616,4212720,306,13778
1724,11,37,25,0,49567260,3618,4364400,317,13789
1725,4,35,25,0,49593720,3618,4415040,320,13793
1726,2,16,25,0,49680300,3619,4798680,348,13795
1727,8,0,17,8,49732020,3614,5180460,376,13803
1728,5,0,17,8,49747560,3614,5180460,375,13808
1729,1,0,14,11,49761540,3614,5180460,375,13809
1730,5,0,12,13,49793460,3615,5180460,375,13814
1731,6,0,14,11,49800720,3614,5180460,375,13820
1732,8,0,19,6,49803600,3613,5180460,375,13828
1733,8,0,21,4,49834380,3614,5180460,375,13836
1734,8,0,18,7,49869420,3614,5180460,374,13844
1735,11,0,22,3,49900020,3614,5180460,374,13855
1736,9,0,20,5,49939080,3614,5180460,374,13864
1737,17,0,25,0,49966140,3613,5182380,374,13881
1738,11,0,17,8,50034720,3613,5182380,373,13892
1739,5,0,17,8,50047680,3613,5182380,373,13897
1740,8,0,18,7,50078040,3613,5182380,373,13905
1741,17,0,21,4,50115300,3612,5182380,372,13922
1742,11,0,19,6,50147160,3611,5182380,372,13933
1743,6,0,17,8,50184960,3611,5182380,372,13939
1744,13,0,23,2,50205420,3611,5182380,372,13952
1745,9,1,23,2,50236020,3611,5188740,372,13961
1746,15,1,25,0,50294940,3612,5200140,372,13976
1747,12,0,22,3,50344620,3612,5202540,372,13988
1748,11,0,20,5,50391960,3612,5202900,372,13999
1749,8,0,20,5,50424060,3612,5202900,372,14007
1750,5,0,17,8,50449500,3612,5202900,372,14012
1751,7,0,14,11,50491320,3612,5202900,371,14019
1752,7,0,18,7,50502840,3612,5202900,371,14026
1753,3,0,15,10,50530620,3612,5202900,371,14029
1754,8,0,18,7,50547000,3612,5202900,371,14037
1755,8,0,16,9,50578260,3612,5202900,371,14045
1756,6,0,17,8,50604000,3613,5202900,371,14051
1757,4,0,17,8,50620740,3613,5202900,370,14055
1758,3,0,15,10,50650920,3614,5202900,370,14058
1759,10,0,16,9,50679660,3613,5202900,370,14068
1760,8,0,16,9,50697720,3613,5202900,370,14076
1761,10,0,19,6,50722020,3612,5202900,370,14086
1762,9,0,17,8,50754960,3612,5202900,369,14095
1763,7,0,18,7,50772960,3612,5202900,369,14102
1764,12,0,23,2,50792580,3611,5202900,369,14114
1765,14,2,25,0,50828400,3611,5207760,369,14128
1766,12,0,23,2,50895000,3612,5216820,369,14140
1767,15,9,21,4,50924340,3612,5219940,369,14155
1768,6,1,25,0,50986500,3614,5249460,371,14161
1769,15,2,25,0,51032040,3613,5260200,371,14176
1770,11,2,21,4,51086880,3613,5264640,371,14187
1771,8,1,20,5,51123360,3613,5272380,372,14195
1772,7,0,21,4,51156840,3614,5273160,372,14202
1773,4,0,15,10,51201900,3615,5273160,371,14206
1774,7,0,16,9,51220680,3614,5273160,371,14213
1775,6,0,18,7,51234540,3614,5273160,371,14219
1776,6,0,19,6,51264420,3615,5273160,371,14225
1777,5,1,17,8,51277500,3615,5274360,371,14230
1778,4,0,18,7,51300360,3615,5276220,371,14234
1779,11,0,22,3,51341520,3616,5276220,371,14245
1780,5,0,14,11,51389340,3616,5276220,370,14250
1781,7,0,18,7,51397260,3616,5276220,370,14257
1782,2,0,15,10,51416100,3616,5276220,370,14259
1783,5,0,15,10,51438660,3617,5276220,370,14264
1784,7,0,18,7,51454920,3617,5276220,370,14271
1785,8,0,18,7,51492480,3617,5276220,370,14279
1786,8,0,22,3,51509580,3618,5276220,370,14287
1787,17,0,25,0,51557940,3617,5276220,369,14304
1788,18,5,25,0,51606480,3617,5281140,369,14322
1789,12,2,25,0,51662280,3618,5297640,370,14334
1790,7,0,17,8,51713580,3617,5299860,370,14341
1791,9,0,18,7,51749640,3617,5299860,370,14350
1792,6,0,17,8,51778680,3618,5299860,369,14356
1793,9,0,17,8,51806460,3617,5299860,369,14365
1794,8,0,17,8,51832680,3617,5299860,369,14373
1795,6,0,14,11,51862140,3617,5299860,369,14379
1796,6,0,15,10,51875640,3617,5299860,369,14385
1797,3,0,14,11,51894960,3617,5299860,369,14388
1798,8,0,15,10,51919740,3617,5299860,368,14396
1799,6,0,17,8,51938700,3617,5299860,368,14402
1800,6,0,17,8,51955260,3617,5299860,368,14408
1801,5,0,17,8,51988440,3618,5299860,368,14413
1802,7,0,16,9,52011780,3617,5299860,368,14420
1803,3,0,15,10,52028280,3618,5299860,368,14423
1804,10,0,19,6,52044900,3617,5299860,367,14433
1805,9,0,19,6,52068420,3617,5299860,367,14442
1806,7,0,19,6,52109220,3618,5299860,367,14449
1807,7,0,18,7,52141560,3618,5299860,367,14456
1808,6,0,19,6,52166760,3618,5299860,367,14462
1809,7,0,15,10,52207980,3619,5299860,367,14469
1810,6,0,15,10,52232580,3619,5299860,366,14475
1811,13,0,24,1,52246260,3619,5299860,366,14488
1812,11,0,21,4,52291380,3618,5299860,366,14499
1813,16,0,25,0,52336740,3618,5299860,365,14515
1814,6,0,14,11,52386480,3618,5299860,365,14521
1815,11,0,17,8,52403280,3617,5299860,365,14532
1816,7,0,20,5,52416000,3617,5299860,365,14539
1817,11,0,20,5,52460700,3617,5299860,364,14550
1818,11,0,21,4,52495320,3617,5299860,364,14561
1819,11,0,24,1,52524540,3617,5299860,364,14572
1820,8,0,14,11,52582140,3616,5299860,364,14580
1821,10,0,18,7,52594320,3616,5299860,363,14590
1822,7,0,17,8,52628820,3616,5299860,363,14597
1823,10,0,18,7,52648560,3615,5299860,363,14607
1824,5,0,20,5,52663860,3616,5299860,363,14612
1825,5,0,17,8,52705620,3616,5299860,363,14617
1826,3,0,16,9,52724940,3617,5299860,363,14620
1827,3,0,15,10,52745160,3617,5299860,363,14623
1828,7,0,18,7,52759920,3617,5299860,362,14630
1829,8,0,18,7,52799400,3618,5300820,362,14638
1830,7,1,17,8,52827000,3618,5301180,362,14645
1831,11,9,17,8,52849020,3619,5305680,362,14656
1832,12,15,20,5,52872060,3620,5323500,363,14668
1833,13,15,25,0,52905240,3620,5350620,365,14681
1834,5,5,25,0,52975020,3621,5440740,371,14686
1835,10,0,17,8,53027940,3619,5471520,373,14696
1836,17,0,25,0,53049780,3618,5471520,372,14713
1837,10,0,25,0,53082120,3618,5472120,372,14723
1838,10,0,21,4,53133600,3618,5472120,372,14733
1839,12,2,21,4,53154300,3617,5472240,371,14745
1840,12,7,20,5,53212500,3619,5483940,372,14757
1841,5,5,24,1,53226840,3619,5496600,373,14762
1842,5,0,16,9,53283840,3619,5521500,374,14767
1843,7,0,15,10,53311440,3618,5521500,374,14774
1844,8,0,18,7,53332620,3619,5521500,374,14782
1845,11,0,18,7,53363580,3618,5521680,373,14793
1846,5,0,12,13,53412660,3619,5521680,373,14798
1847,6,0,13,12,53420880,3618,5521680,373,14804
1848,4,0,14,11,53428620,3618,5521680,373,14808
1849,5,0,14,11,53450580,3618,5521680,373,14813
1850,6,0,17,8,53461680,3618,5521680,373,14819
1851,6,0,14,11,53488500,3618,5521680,373,14825
1852,4,0,12,13,53512920,3618,5521680,373,14829
1853,6,0,17,8,53515260,3618,5521680,372,14835
1854,8,0,20,5,53525700,3617,5522040,372,14843
1855,5,0,17,8,53551440,3617,5522040,372,14848
1856,14,0,17,8,53594460,3617,5522040,372,14862
1857,5,0,18,7,53609940,3617,5522040,372,14867
1858,8,0,19,6,53640660,3617,5522040,371,14875
1859,10,0,17,8,53678520,3617,5522040,371,14885
1860,9,0,20,5,53697480,3616,5522040,371,14894
1861,14,6,17,8,53730960,3616,5525820,371,14908
1862,6,0,20,5,53762760,3616,5541780,372,14914
1863,9,0,18,7,53805180,3616,5541780,372,14923
1864,11,0,21,4,53828460,3616,5541780,371,14934
1865,7,0,19,6,53860500,3616,5541780,371,14941
1866,7,0,20,5,53883120,3616,5541780,371,14948
1867,12,0,23,2,53922840,3616,5542200,371,14960
1868,6,1,21,4,53943000,3616,5542200,371,14966
1869,7,0,20,5,53999940,3618,5542380,370,14973
1870,6,0,14,11,54026460,3616,5542380,370,14979
1871,6,0,15,10,54056820,3617,5542380,370,14985
1872,9,0,16,9,54069120,3616,5542380,370,14994
1873,3,0,13,12,54090480,3616,5542380,370,14997
1874,6,0,17,8,54098700,3616,5542380,370,15003
1875,8,0,19,6,54120000,3616,5542380,369,15011
1876,8,0,19,6,54145380,3616,5542380,369,15019
1877,5,0,14,11,54177480,3616,5542380,369,15024
1878,4,0,13,12,54194820,3616,5542380,369,15028
1879,14,0,19,6,54210360,3615,5542380,369,15042
1880,12,0,22,3,54231840,3614,5542380,368,15054
1881,6,0,18,7,54272160,3614,5544060,368,15060
1882,12,0,24,1,54293700,3614,5544060,368,15072
1883,10,0,19,6,54352500,3615,5545800,368,15082
1884,7,0,16,9,54395640,3615,5545800,368,15089
1885,13,0,21,4,54414780,3614,5545800,367,15102
1886,15,1,23,2,54442620,3613,5545980,367,15117
1887,11,0,24,1,54486180,3614,5555640,367,15128
1888,6,0,21,4,54524400,3614,5555640,367,15134
1889,9,0,19,6,54568080,3614,5555640,367,15143
1890,7,0,18,7,54600840,3614,5555640,367,15150
1891,12,0,22,3,54635580,3615,5555640,367,15162
1892,6,0,18,7,54666420,3615,5555640,366,15168
1893,12,0,21,4,54700860,3615,5555640,366,15180
1894,7,0,19,6,54731940,3615,5555640,366,15187
1895,4,0,15,10,54774660,3615,5555640,366,15191
1896,5,0,16,9,54784380,3615,5555640,366,15196
1897,6,0,19,6,54793080,3615,5555640,366,15202
1898,3,0,15,10,54825120,3615,5555640,366,15205
1899,4,0,14,11,54851640,3616,5555640,365,15209
1900,9,0,16,9,54869340,3616,5555640,365,15218
1901,4,0,15,10,54887520,3616,5555640,365,15222
1902,7,0,14,11,54911760,3615,5555640,365,15229
1903,7,0,16,9,54923940,3615,5555640,365,15236
1904,8,0,18,7,54938580,3614,5555640,365,15244
1905,9,0,22,3,54958860,3615,5555640,364,15253
1906,15,7,18,7,55002000,3614,5555700,364,15268
1907,5,10,16,9,55026540,3615,5564640,365,15273
1908,9,15,17,8,55052520,3616,5573100,365,15282
1909,11,24,17,8,55068900,3617,5574600,365,15293
1910,5,21,20,5,55107480,3618,5625060,368,15298
1911,9,17,25,0,55139400,3618,5683320,371,15307
1912,13,19,25,0,55188300,3619,5733480,374,15320
1913,5,14,25,0,55233540,3619,5826240,380,15325
1914,13,2,25,0,55298940,3618,6010260,392,15338
1915,5,0,17,8,55350300,3618,6021420,393,15343
1916,8,0,18,7,55377720,3618,6021420,392,15351
1917,6,0,16,9,55410900,3618,6021420,392,15357
1918,5,0,14,11,55432680,3618,6021420,392,15362
1919,6,0,18,7,55442880,3618,6021420,392,15368
1920,1,0,12,13,55476060,3619,6021420,392,15369
1921,5,0,15,10,55484400,3619,6021420,392,15374
1922,3,0,16,9,55493640,3619,6021420,392,15377
1923,8,0,16,9,55531860,3619,6021420,392,15385
1924,8,0,15,10,55554420,3619,6021420,391,15393
1925,9,0,18,7,55572720,3618,6021420,391,15402
1926,5,0,16,9,55598580,3618,6021420,391,15407
1927,10,0,24,1,55606920,3619,6021420,391,15417
1928,7,0,20,5,55657680,3619,6021420,391,15424
1929,16,3,25,0,55689780,3619,6022320,390,15440
1930,14,1,25,0,55747380,3619,6025680,390,15454
1931,5,0,19,6,55774080,3618,6025740,390,15459
1932,8,0,16,9,55824960,3619,6025740,390,15467
1933,14,0,20,5,55852860,3619,6025740,389,15481
1934,11,0,24,1,55873980,3618,6025740,389,15492
1935,17,3,25,0,55921200,3618,6026340,389,15509
1936,6,0,24,1,55965060,3619,6037380,389,15515
1937,10,0,20,5,56019120,3619,6037380,389,15525
1938,14,0,21,4,56063580,3619,6037380,389,15539
1939,6,0,13,12,56106300,3618,6037380,389,15545
1940,4,0,14,11,56118060,3618,6037380,388,15549
1941,8,0,15,10,56136480,3618,6037380,388,15557
1942,6,0,19,6,56140260,3618,6037380,388,15563
1943,4,0,13,12,56175960,3618,6037380,388,15567
1944,8,0,15,10,56191620,3617,6037380,388,15575
1945,6,0,15,10,56204700,3617,6037380,388,15581
1946,5,0,15,10,56224860,3617,6037380,388,15586
1947,6,0,13,12,56250000,3617,6037380,387,15592
1948,10,0,18,7,56263320,3616,6037380,387,15602
1949,7,0,19,6,56284800,3616,6037380,387,15609
1950,9,0,18,7,56323200,3616,6037380,387,15618
1951,3,0,13,12,56345280,3616,6037380,387,15621
1952,10,0,17,8,56365080,3616,6037380,386,15631
1953,8,0,17,8,56382600,3615,6037380,386,15639
1954,11,0,19,6,56398860,3614,6037380,386,15650
1955,18,0,23,2,56434680,3613,6037620,386,15668
1956,12,3,22,3,56471640,3613,6037860,385,15680
1957,14,5,24,1,56521260,3614,6051600,386,15694
1958,8,0,22,3,56563560,3613,6059160,386,15702
1959,12,0,19,6,56617260,3613,6059160,386,15714
1960,4,0,20,5,56633340,3614,6059160,386,15718
1961,10,0,21,4,56668680,3614,6059220,385,15728
1962,11,0,21,4,56712060,3614,6059220,385,15739
1963,10,0,18,7,56752320,3614,6059220,385,15749
1964,5,0,17,8,56778660,3614,6059220,385,15754
1965,5,0,17,8,56796660,3614,6059220,385,15759
1966,5,0,16,9,56827080,3614,6059220,385,15764
1967,3,0,13,12,56845320,3614,6059220,384,15767
1968,3,0,12,13,56864160,3615,6059220,384,15770
1969,5,0,15,10,56865900,3614,6059220,384,15775
1970,3,0,15,10,56883180,3615,6059220,384,15778
1971,10,0,20,5,56898120,3614,6059220,384,15788
1972,5,0,16,9,56929200,3614,6059220,384,15793
1973,7,0,15,10,56953800,3614,6059220,384,15800
1974,7,0,15,10,56990160,3615,6059220,384,15807
1975,8,0,19,6,57002220,3615,6059220,383,15815
1976,10,0,21,4,57019080,3614,6059220,383,15825
1977,13,0,23,2,57049320,3613,6059220,383,15838
1978,10,0,21,4,57103080,3614,6059220,383,15848
1979,14,3,19,6,57131820,3613,6060300,382,15862
1980,11,11,15,10,57176580,3614,6062940,382,15873
1981,14,21,16,9,57193680,3614,6075840,383,15887
1982,5,26,16,9,57193680,3614,6075840,383,15892
1983,12,32,17,8,57237540,3616,6094500,383,15904
1984,12,33,25,0,57251820,3616,6149040,387,15916
1985,5,29,25,0,57299520,3617,6230880,392,15921
1986,8,21,25,0,57366900,3618,6405000,402,15929
1987,2,0,12,13,57435360,3614,6682920,420,15931
1988,2,0,13,12,57443040,3614,6682920,420,15933
1989,10,0,19,6,57448740,3614,6682920,419,15943
1990,7,0,17,8,57482700,3614,6682920,419,15950
1991,4,0,15,10,57507780,3614,6682920,419,15954
1992,4,0,13,12,57539520,3614,6682920,419,15958
1993,4,0,13,12,57551220,3614,6682920,419,15962
1994,4,0,14,11,57555780,3614,6682920,419,15966
1995,8,0,15,10,57572520,3613,6682920,419,15974
1996,10,0,17,8,57588600,3613,6682920,418,15984
1997,10,0,19,6,57609300,3612,6682920,418,15994
1998,7,0,19,6,57639720,3612,6682920,418,16001
1999,10,0,20,5,57670500,3612,6682920,418,16011
2000,10,0,21,4,57697200,3612,6682920,417,16021
2001,10,0,23,2,57731940,3612,6683160,417,16031
2002,9,0,19,6,57782940,3613,6683160,417,16040
2003,9,0,17,8,57816300,3612,6683160,417,16049
2004,14,0,19,6,57856020,3612,6683160,416,16063
2005,6,0,15,10,57893280,3612,6683160,416,16069
2006,11,0,16,9,57920820,3611,6683160,416,16080
2007,11,0,20,5,57944280,3611,6683160,416,16091
2008,7,0,20,5,57962760,3611,6683160,415,16098
2009,8,0,19,6,57995820,3611,6683160,415,16106
2010,11,0,16,9,58048440,3611,6683160,415,16117
2011,7,0,17,8,58066980,3611,6683160,415,16124
2012,9,0,18,7,58087920,3610,6683160,414,16133
2013,3,0,15,10,58110000,3610,6683160,414,16136
2014,7,0,16,9,58135200,3611,6683160,414,16143
2015,4,0,15,10,58148640,3610,6683160,414,16147
2016,3,0,13,12,58168440,3610,6683160,414,16150
2017,4,0,16,9,58173060,3610,6683160,414,16154
2018,5,0,20,5,58173840,3610,6683160,414,16159
2019,8,0,19,6,58206240,3610,6683160,414,16167
2020,4,0,18,7,58224480,3610,6683160,413,16171
2021,7,0,19,6,58239300,3610,6683160,413,16178
2022,4,0,17,8,58269480,3610,6683160,413,16182
2023,7,0,18,7,58292520,3611,6683160,413,16189
2024,13,5,19,6,58314240,3610,6683520,413,16202
2025,16,19,17,8,58339740,3611,6687780,413,16218
2026,10,28,16,9,58354920,3611,6691500,413,16228
2027,10,32,18,7,58383540,3612,6704760,413,16238
2028,11,34,24,1,58395900,3612,6756660,416,16249
2029,11,34,25,0,58451280,3614,6811500,419,16260
2030,0,25,25,0,58485900,3614,6943800,427,16260
2031,14,23,25,0,58553940,3614,7071360,435,16274
2032,13,28,25,0,58579920,3614,7093620,436,16287
2033,10,27,25,0,58641360,3616,7123620,437,16297
2034,10,21,25,0,58689300,3615,7221060,443,16307
2035,9,21,18,7,58722000,3613,7338300,450,16316
2036,5,24,17,8,58744440,3614,7343100,450,16321
2037,5,25,19,6,58760520,3615,7349160,450,16326
2038,7,31,16,9,58786200,3615,7350900,450,16333
2039,2,31,16,9,58808340,3616,7360620,451,16335
2040,4,32,18,7,58817460,3617,7364820,451,16339
2041,2,29,19,6,58843260,3617,7411560,454,16341
2042,3,21,22,3,58880760,3618,7562700,463,16344
2043,4,2,25,0,58919520,3616,8417700,515,16348
2044,11,0,21,4,58946520,3614,8464140,518,16359
2045,7,0,22,3,58966740,3614,8464140,518,16366
2046,2,0,16,9,59002260,3614,8464140,518,16368
2047,11,0,21,4,59027400,3614,8464140,517,16379
2048,6,0,19,6,59053680,3614,8464140,517,16385
2049,12,0,22,3,59085120,3614,8464140,517,16397
2050,11,2,25,0,59111220,3614,8464380,516,16408
2051,9,0,25,0,59153760,3614,8473620,517,16417
2052,13,3,22,3,59202360,3614,8475240,516,16430
2053,9,0,24,1,59234460,3614,8479620,516,16439
2054,17,4,25,0,59279460,3614,8482020,516,16456
2055,10,5,22,3,59320080,3614,8488200,516,16466
2056,11,14,17,8,59359380,3615,8492820,516,16477
2057,14,25,17,8,59385000,3616,8501040,516,16491
2058,5,27,18,7,59396400,3616,8508660,516,16496
2059,8,25,25,0,59423280,3617,8567700,520,16504
2060,5,24,25,0,59455920,3618,8599920,521,16509
2061,5,18,25,0,59511300,3619,8688000,526,16514
2062,12,4,25,0,59577840,3617,8995860,545,16526
2063,3,0,14,11,59606940,3615,8997480,545,16529
2064,7,0,15,10,59614380,3614,8997480,545,16536
2065,4,0,15,10,59630280,3614,8997480,544,16540
2066,7,0,20,5,59632380,3614,8997480,544,16547
2067,7,0,18,7,59655960,3613,8997480,544,16554
2068,6,0,18,7,59678160,3613,8997480,544,16560
2069,4,0,18,7,59695140,3613,8997480,544,16564
2070,10,0,20,5,59721180,3613,8997480,543,16574
2071,7,0,20,5,59742840,3613,8997480,543,16581
2072,7,0,18,7,59784900,3614,8997480,543,16588
2073,9,4,20,5,59789100,3613,8997600,543,16597
2074,9,11,16,9,59822580,3614,9003180,543,16606
2075,15,24,17,8,59829840,3614,9005820,543,16621
2076,8,32,17,8,59829840,3614,9005820,543,16629
2077,13,40,17,8,59874420,3616,9031140,543,16642
2078,10,40,17,8,59874420,3616,9031140,543,16652
2079,10,40,16,9,59889780,3616,9047280,544,16662
2080,7,38,20,5,59911680,3617,9116760,548,16669
2081,7,36,25,0,59945880,3618,9225480,554,16676
2082,6,32,25,0,59989980,3619,9355560,562,16682
2083,7,24,25,0,60045540,3619,9583020,575,16689
2084,11,25,21,4,60090240,3619,9725220,584,16700
2085,12,36,16,9,60122040,3619,9728160,584,16712
2086,5,39,16,9,60136380,3620,9737400,584,16717
2087,3,40,16,9,60136380,3620,9737400,584,16720
2088,1,36,17,8,60178620,3621,9784320,586,16721
2089,6,36,23,2,60178620,3621,9832800,589,16727
2090,4,31,25,0,60202920,3621,9904740,593,16731
2091,6,17,25,0,60282960,3622,10478520,628,16737
2092,5,0,19,6,60316860,3618,11082840,664,16742
2093,12,0,20,5,60352860,3617,11082840,663,16754
2094,9,0,21,4,60385680,3618,11082840,663,16763
2095,11,0,19,6,60416580,3617,11082900,662,16774
2096,12,0,21,4,60449460,3616,11082900,662,16786
2097,12,0,22,3,60475500,3616,11083560,661,16798
2098,3,0,15,10,60514800,3616,11083560,661,16801
2099,14,0,21,4,60533280,3615,11083560,661,16815
2100,6,0,19,6,60559380,3615,11085000,661,16821
2101,7,0,22,3,60579360,3615,11085000,660,16828
2102,12,2,21,4,60624180,3616,11085720,660,16840
2103,7,9,19,6,60630480,3616,11085720,660,16847
2104,12,13,21,4,60674700,3617,11103360,660,16859
2105,14,26,18,7,60701160,3618,11104740,660,16873
2106,12,35,17,8,60726420,3618,11117640,660,16885
2107,1,33,18,7,60737760,3619,11127180,660,16886
2108,11,30,25,0,60781980,3620,11223720,666,16897
2109,5,20,25,0,60820560,3619,11353680,673,16902
2110,4,0,21,4,60866580,3615,11672040,692,16906
2111,7,1,18,7,60901620,3616,11673300,692,16913
2112,6,0,16,9,60935400,3616,11673600,692,16919
2113,7,0,21,4,60942120,3616,11673600,691,16926
2114,8,0,20,5,60974760,3616,11673600,691,16934
2115,5,0,17,8,61005720,3616,11673600,691,16939
2116,7,0,19,6,61028700,3616,11673600,690,16946
2117,7,0,21,4,61044900,3616,11673600,690,16953
2118,9,1,19,6,61076220,3616,11674560,690,16962
2119,2,0,17,8,61107540,3616,11676360,690,16964
2120,11,0,20,5,61129320,3616,11676360,689,16975
2121,4,0,20,5,61150440,3616,11676360,689,16979
2122,7,0,19,6,61174980,3616,11676360,689,16986
2123,10,0,21,4,61214340,3617,11676360,689,16996
2124,7,0,21,4,61239600,3617,11676360,688,17003
2125,11,3,21,4,61273020,3617,11678880,688,17014
2126,12,12,20,5,61292040,3617,11682600,688,17026
2127,13,23,18,7,61320060,3618,11689260,688,17039
2128,10,29,18,7,61353420,3619,11703780,688,17049
2129,6,33,18,7,61369860,3620,11712480,688,17055
2130,5,35,18,7,61392000,3620,11736360,690,17060
2131,5,34,23,2,61403040,3621,11781600,692,17065
2132,5,30,25,0,61445040,3622,11862120,697,17070
2133,7,28,25,0,61491180,3623,11935560,701,17077
2134,12,22,25,0,61560180,3623,12133080,712,17089
2135,7,22,19,6,61590540,3622,12169860,714,17096
2136,2,19,21,4,61607220,3622,12200940,715,17098
2137,4,0,19,6,61669620,3621,12733320,746,17102
2138,6,0,17,8,61680660,3619,12733320,746,17108
2139,3,0,15,10,61700040,3620,12733320,746,17111
2140,9,0,19,6,61709580,3619,12733320,746,17120
2141,7,0,18,7,61736760,3619,12733320,745,17127
2142,4,0,17,8,61762920,3619,12733320,745,17131
2143,4,0,15,10,61786440,3620,12733320,745,17135
2144,7,0,19,6,61793400,3619,12733320,745,17142
2145,8,0,22,3,61809840,3619,12733320,744,17150
2146,9,0,22,3,61845120,3619,12733620,744,17159
2147,8,0,22,3,61870980,3619,12733620,744,17167
2148,17,5,24,1,61905840,3619,12734940,743,17184
2149,7,11,18,7,61943160,3620,12736620,743,17191
2150,11,9,25,0,61987080,3621,12777300,745,17202
2151,11,14,24,1,62008740,3621,12780720,744,17213
2152,10,17,23,2,62057880,3622,12802020,745,17223
2153,10,12,25,0,62103000,3622,12852180,748,17233
2154,6,0,20,5,62154120,3620,12982320,755,17239
2155,6,0,20,5,62171040,3620,12982320,755,17245
2156,2,0,17,8,62198820,3620,12982320,755,17247
2157,4,0,16,9,62227860,3621,12982320,754,17251
2158,8,0,16,9,62251500,3621,12982320,754,17259
2159,8,1,17,8,62264940,3620,12982320,754,17267
2160,5,2,19,6,62280180,3621,12987300,754,17272
2161,3,0,18,7,62312760,3621,12992400,754,17275
2162,5,0,15,10,62340180,3621,12992400,754,17280
2163,4,0,17,8,62351880,3621,12992400,753,17284
2164,4,0,14,11,62372160,3621,12992400,753,17288
2165,3,0,16,9,62379300,3621,12992400,753,17291
2166,2,0,14,11,62391600,3621,12992400,753,17293
2167,9,0,20,5,62402280,3621,12992400,753,17302
2168,7,0,21,4,62415300,3621,12992400,752,17309
2169,5,0,19,6,62439840,3621,12992400,752,17314
2170,10,0,22,3,62475660,3621,12992760,752,17324
2171,8,0,20,5,62505660,3621,12992760,751,17332
2172,15,0,25,0,62533560,3620,12993600,751,17347
2173,12,10,18,7,62571420,3621,12996840,750,17359
2174,11,17,18,7,62603160,3622,13001040,750,17370
2175,5,19,17,8,62629980,3622,13009740,751,17375
2176,16,33,17,8,62646000,3623,13012920,750,17391
2177,8,40,17,8,62652240,3623,13016760,750,17399
2178,17,40,16,9,62677680,3624,13030680,751,17416
2179,9,40,16,9,62677680,3624,13030680,751,17425
2180,12,38,18,7,62712000,3625,13118580,755,17437
2181,5,37,23,2,62722800,3625,13188660,759,17442
2182,7,33,25,0,62767620,3626,13325340,767,17449
2183,6,23,25,0,62827080,3626,13666020,786,17455
2184,3,0,20,5,62881020,3623,14190840,816,17458
2185,3,0,16,9,62892060,3622,14190840,816,17461
2186,1,0,12,13,62906400,3622,14190840,816,17462
2187,9,0,17,8,62912820,3621,14190840,816,17471
2188,6,0,17,8,62928180,3621,14190840,815,17477
2189,3,0,14,11,62942580,3620,14190840,815,17480
2190,10,0,20,5,62951460,3620,14190840,815,17490
2191,8,0,21,4,62975280,3620,14190840,814,17498
2192,7,1,23,2,62995260,3620,14190840,814,17505
2193,13,12,17,8,63036420,3621,14192340,814,17518
2194,11,20,18,7,63053040,3622,14201460,814,17529
2195,13,28,18,7,63084420,3622,14213520,814,17542
2196,15,40,18,7,63094500,3622,14216400,814,17557
2197,14,40,16,9,63115920,3623,14220660,813,17571
2198,8,39,16,9,63144060,3624,14241840,814,17579
2199,17,40,25,0,63144060,3624,14309100,818,17596
2200,12,37,25,0,63197100,3625,14460180,826,17608
2201,6,37,25,0,63227700,3626,14495100,828,17614
2202,16,38,25,0,63299220,3627,14604960,833,17630
2203,11,40,25,0,63326460,3627,14625000,834,17641
2204,2,28,25,0,63378360,3627,14853300,847,17643
2205,5,3,25,0,63447060,3625,15530640,885,17648
2206,8,0,16,9,63476760,3622,15623340,890,17656
2207,3,0,17,8,63487740,3622,15623340,890,17659
2208,5,0,16,9,63517500,3623,15623340,890,17664
2209,4,0,17,8,63523920,3623,15623340,890,17668
2210,3,0,13,12,63546660,3622,15623340,890,17671
2211,9,0,17,8,63552420,3622,15623340,889,17680
2212,4,0,17,8,63561420,3621,15623340,889,17684
2213,7,0,19,6,63578640,3621,15623340,889,17691
2214,9,0,19,6,63618780,3622,15623340,888,17700
2215,6,0,18,7,63637560,3621,15623340,888,17706
2216,5,0,19,6,63653040,3622,15623340,888,17711
2217,7,0,16,9,63688920,3621,15623340,887,17718
2218,9,0,20,5,63710880,3622,15623340,887,17727
2219,7,0,18,7,63733740,3621,15623340,886,17734
2220,11,0,22,3,63755820,3621,15623340,886,17745
2221,15,2,25,0,63788700,3621,15625980,885,17760
2222,8,0,21,4,63828900,3620,15630000,885,17768
2223,5,0,14,11,63873420,3620,15630000,885,17773
2224,9,0,17,8,63882900,3620,15630000,884,17782
2225,11,0,20,5,63899760,3619,15630000,884,17793
2226,7,0,19,6,63925980,3619,15630000,883,17800
2227,5,0,18,7,63956640,3619,15630060,883,17805
2228,4,0,17,8,63977880,3619,15630060,883,17809
2229,5,0,18,7,63987240,3619,15630060,883,17814
2230,7,0,19,6,64012740,3619,15630060,882,17821
2231,6,4,17,8,64031400,3620,15631860,882,17827
2232,6,4,19,6,64059120,3620,15646560,883,17833
2233,3,0,15,10,64092540,3620,15665760,884,17836
2234,3,0,16,9,64099980,3620,15665760,884,17839
2235,3,0,15,10,64115820,3620,15665760,883,17842
2236,5,0,15,10,64133520,3620,15665760,883,17847
2237,4,0,16,9,64139760,3620,15665760,883,17851
2238,8,0,18,7,64157820,3620,15665760,883,17859
2239,12,0,23,2,64178040,3619,15665760,882,17871
2240,5,0,19,6,64206360,3619,15665760,882,17876
2241,11,0,19,6,64235040,3618,15665760,881,17887
2242,14,0,24,1,64258920,3618,15665760,880,17901
2243,13,0,23,2,64288500,3617,15665760,880,17914
2244,7,0,23,2,64327260,3617,15666180,879,17921
2245,13,8,19,6,64360020,3617,15667560,879,17934
2246,6,10,21,4,64375260,3618,15676320,879,17940
2247,6,8,22,3,64424640,3619,15702480,880,17946
2248,12,6,25,0,64462020,3619,15733620,881,17958
2249,7,0,23,2,64491780,3618,15776760,884,17965
2250,3,0,16,9,64537140,3618,15776760,883,17968
2251,12,0,23,2,64558320,3618,15776760,883,17980
2252,11,3,17,8,64596660,3618,15777540,882,17991
2253,9,2,25,0,64610520,3618,15786900,882,18000
2254,7,0,20,5,64661040,3618,15789840,882,18007
2255,4,0,14,11,64700160,3618,15789840,882,18011
2256,4,0,13,12,64707900,3618,15789840,882,18015
2257,3,0,14,11,64718340,3618,15789840,882,18018
2258,3,0,16,9,64723620,3618,15789840,881,18021
2259,5,0,18,7,64731660,3618,15789840,881,18026
2260,5,0,18,7,64759500,3618,15789840,881,18031
2261,5,0,18,7,64769280,3618,15789840,881,18036
2262,5,0,17,8,64787220,3618,15789840,880,18041
2263,4,0,15,10,64809480,3618,15789840,880,18045
2264,7,0,16,9,64814760,3617,15789840,880,18052
2265,11,0,24,1,64828740,3617,15789840,879,18063
2266,13,4,22,3,64855860,3616,15790740,879,18076
2267,15,18,17,8,64891200,3617,15792300,879,18091
2268,10,25,18,7,64907940,3618,15797460,878,18101
2269,11,33,18,7,64932240,3618,15811860,879,18112
2270,11,34,25,0,64951800,3619,15877740,881,18123
2271,7,33,25,0,64998660,3620,15905580,883,18130
2272,12,34,25,0,65048040,3620,15948960,885,18142
2273,11,31,25,0,65095860,3620,16005600,887,18153
2274,8,28,25,0,65140680,3620,16115400,893,18161
2275,7,19,25,0,65185020,3620,16334280,904,18168
2276,5,0,15,10,65254260,3617,16690380,924,18173
2277,5,0,19,6,65256540,3617,16690380,924,18178
2278,6,0,18,7,65274960,3616,16690380,923,18184
2279,6,0,18,7,65298420,3616,16690380,923,18190
2280,2,0,15,10,65319360,3616,16690380,923,18192
2281,6,0,16,9,65341800,3617,16690380,923,18198
2282,6,0,19,6,65349120,3617,16690380,922,18204
2283,4,0,18,7,65365260,3616,16690380,922,18208
2284,8,0,19,6,65391300,3616,16690380,922,18216
2285,5,0,16,9,65418720,3616,16690380,921,18221
2286,5,0,16,9,65436360,3616,16690380,921,18226
2287,15,1,25,0,65453460,3616,16690380,921,18241
2288,12,3,24,1,65486100,3616,16695420,920,18253
2289,6,7,19,6,65525400,3617,16698480,920,18259
2290,15,14,22,3,65558880,3618,16707600,920,18274
2291,15,28,16,9,65598180,3618,16709340,920,18289
2292,7,33,16,9,65613960,3619,16717740,919,18296
2293,13,40,17,8,65632560,3619,16729800,919,18309
2294,6,38,17,8,65655600,3620,16750500,920,18315
2295,7,38,21,4,65679120,3621,16815060,924,18322
2296,9,38,22,3,65691720,3621,16841940,925,18331
2297,6,30,25,0,65738820,3622,17031420,935,18337
2298,4,18,25,0,65803200,3622,17285880,949,18341
2299,12,0,23,2,65840340,3618,17739420,973,18353
2300,11,1,21,4,65866680,3617,17739420,973,18364
2301,5,0,18,7,65907360,3617,17739720,972,18369
2302,11,7,18,7,65916480,3617,17739780,972,18380
2303,3,5,19,6,65949960,3618,17751180,972,18383
2304,6,0,19,6,65986200,3618,17780940,973,18389
2305,4,0,17,8,66002100,3617,17780940,973,18393
2306,4,0,16,9,66026340,3618,17780940,973,18397
2307,8,0,18,7,66044340,3618,17780940,973,18405
2308,7,1,23,2,66049620,3618,17782500,972,18412
2309,5,0,20,5,66094380,3618,17786940,972,18417
2310,5,0,19,6,66121020,3619,17786940,972,18422
2311,5,0,19,6,66146880,3619,17788200,972,18427
2312,12,10,18,7,66161580,3619,17788620,971,18439
2313,6,5,24,1,66192420,3620,17811600,972,18445
2314,9,0,20,5,66237540,3619,17841240,973,18454
2315,13,0,21,4,66274200,3618,17841240,973,18467
2316,12,0,23,2,66306720,3618,17841240,972,18479
2317,10,4,20,5,66335280,3618,17842860,972,18489
2318,13,14,18,7,66358680,3618,17845920,971,18502
2319,11,16,25,0,66375060,3619,17869200,972,18513
2320,13,21,25,0,66415140,3619,17878320,972,18526
2321,7,21,25,0,66451320,3620,17895840,972,18533
2322,5,22,18,7,66504120,3621,17918460,973,18538
2323,7,17,25,0,66528600,3621,18014880,978,18545
2324,9,16,25,0,66572160,3621,18076680,981,18554
2325,7,12,25,0,66613320,3622,18151440,984,18561
2326,4,0,18,7,66663660,3620,18361080,996,18565
2327,3,0,16,9,66686520,3620,18361080,995,18568
2328,4,0,17,8,66706380,3621,18361080,995,18572
2329,4,0,16,9,66718680,3620,18361080,995,18576
2330,5,0,15,10,66736380,3620,18361080,995,18581
2331,7,0,17,8,66754260,3620,18361080,994,18588
2332,5,0,18,7,66757560,3619,18361080,994,18593
2333,5,0,17,8,66787800,3620,18361080,994,18598
2334,10,0,17,8,66811860,3619,18361080,993,18608
2335,6,0,19,6,66830340,3619,18361080,993,18614
2336,9,0,22,3,66837900,3619,18361080,993,18623
2337,13,2,25,0,66873960,3619,18361200,992,18636
2338,9,4,25,0,66907800,3619,18368400,992,18645
2339,10,4,25,0,66959760,3620,18376800,992,18655
2340,5,0,16,9,67014900,3620,18400680,993,18660
2341,16,0,23,2,67039680,3619,18400680,992,18676
2342,11,0,24,1,67072440,3619,18400680,991,18687
2343,12,1,25,0,67113540,3619,18403860,991,18699
2344,11,0,24,1,67167420,3620,18404040,990,18710
2345,9,0,20,5,67203900,3619,18409140,990,18719
2346,7,0,20,5,67237020,3620,18409140,990,18726
2347,5,0,16,9,67271760,3620,18409140,989,18731
2348,5,0,18,7,67283640,3620,18409140,989,18736
2349,5,2,17,8,67299600,3620,18409560,989,18741
2350,9,0,24,1,67323780,3620,18411540,988,18750
2351,6,4,18,7,67357500,3621,18412080,988,18756
2352,9,11,17,8,67379340,3621,18417720,988,18765
2353,3,8,19,6,67414740,3622,18436920,989,18768
2354,9,6,25,0,67429500,3622,18480540,991,18777
2355,9,0,21,4,67474920,3621,18502080,991,18786
2356,7,0,20,5,67505880,3621,18502080,991,18793
2357,5,0,19,6,67537440,3622,18502080,991,18798
2358,7,0,21,4,67556820,3622,18502080,990,18805
2359,11,0,22,3,67599600,3622,18502080,990,18816
2360,11,0,24,1,67632720,3622,18502140,989,18827
2361,9,0,22,3,67666740,3622,18502140,989,18836
2362,5,0,18,7,67697760,3622,18502140,988,18841
2363,12,0,22,3,67723920,3621,18502140,988,18853
2364,23,14,21,4,67748340,3621,18502800,987,18876
2365,8,18,18,7,67791720,3622,18509880,987,18884
2366,13,26,20,5,67808820,3622,18527820,987,18897
2367,6,24,25,0,67832700,3623,18553740,988,18903
2368,17,25,25,0,67893300,3623,18666480,993,18920
2369,12,25,25,0,67934520,3623,18678000,993,18932
2370,8,23,25,0,67973700,3623,18739260,996,18940
2371,3,0,22,3,68037420,3621,19062900,1013,18943
2372,10,0,17,8,68071380,3620,19062900,1012,18953
2373,10,0,23,2,68076660,3619,19062900,1012,18963
2374,8,0,20,5,68120220,3619,19062900,1011,18971
2375,7,0,20,5,68139180,3619,19062900,1011,18978
2376,6,0,18,7,68169480,3619,19063140,1011,18984
2377,8,0,22,3,68193300,3620,19063140,1010,18992
2378,3,0,18,7,68230740,3620,19063140,1010,18995
2379,8,0,21,4,68253720,3621,19063140,1010,19003
2380,10,5,17,8,68294040,3621,19063380,1009,19013
2381,4,9,16,9,68299500,3621,19063380,1009,19017
2382,6,8,19,6,68334480,3622,19090380,1010,19023
2383,9,8,25,0,68345160,3622,19116480,1011,19032
2384,13,8,25,0,68397600,3622,19139100,1012,19045
2385,7,0,21,4,68446080,3621,19189620,1014,19052
2386,7,0,19,6,68478780,3621,19189620,1013,19059
2387,12,0,24,1,68506680,3622,19189620,1013,19071
2388,9,2,18,7,68545200,3621,19189620,1012,19080
2389,15,13,18,7,68561520,3621,19197180,1012,19095
2390,13,23,18,7,68584980,3622,19206300,1012,19108
2391,6,27,18,7,68600280,3622,19213740,1012,19114
2392,7,30,18,7,68625960,3623,19243260,1013,19121
2393,11,31,25,0,68649960,3624,19318620,1016,19132
2394,7,32,25,0,68682600,3624,19325040,1016,19139
2395,8,39,18,7,68724240,3625,19326180,1016,19147
2396,6,36,22,3,68761500,3626,19362300,1017,19153
2397,5,31,25,0,68798040,3626,19531860,1026,19158
2398,6,22,25,0,68851980,3626,19734060,1036,19164
2399,4,10,25,0,68895660,3626,20029500,1052,19168

